,Player,Tkl,TklW,Def 3rd,Mid 3rd,Att 3rd,TklDribblers,Att,Tkl%,Lost,Blocks,Sh,Pass,Int,Clr,Err
0,Max Aarons,29,19,20,7,2,20,34,58.8,14,9,5,4,8,27,0
1,Brenden Aaronson,32,18,13,13,6,16,32,50.0,16,26,1,25,2,4,0
2,Paxten Aaronson,2,2,1,1,0,1,1,100.0,0,2,0,2,0,0,0
3,Keyliane Abdallah,0,0,0,0,0,0,0,,0,0,0,0,0,0,0
4,Yunis Abdelhamid,64,35,36,23,5,26,45,57.8,19,51,32,19,39,109,2
5,Salis Abdul Samed,21,14,8,10,3,8,18,44.4,10,12,1,11,12,18,0
6,Nabil Aberdin,0,0,0,0,0,0,1,0.0,1,0,0,0,0,4,0
7,Laurent Abergel,85,52,43,34,8,38,96,39.6,58,29,6,23,61,61,3
8,Matthis Abline,9,4,4,3,2,3,8,37.5,5,3,0,3,3,5,0
9,Abner,25,19,15,9,1,17,34,50.0,17,23,5,18,15,62,0
10,Zakaria Aboukhlal,9,8,1,5,3,3,12,25.0,9,9,1,8,1,2,0
11,Abdel Abqar,35,19,28,5,2,21,35,60.0,14,31,26,5,23,115,0
12,Tammy Abraham,3,1,0,1,2,0,0,,0,1,0,1,0,4,0
13,Francesco Acerbi,22,13,16,6,0,11,14,78.6,3,20,13,7,32,77,1
14,Joshua Acheampong,0,0,0,0,0,0,0,,0,3,3,0,0,0,0
15,Marcos Acuña,33,21,20,12,1,9,14,64.3,5,12,2,10,4,25,0
16,Bénie Adama Traore,4,2,1,2,1,0,4,0.0,4,4,1,3,1,1,0
17,Bénie Adama Traore,8,4,2,5,1,3,7,42.9,4,3,0,3,1,1,0
18,Akor Adams,12,4,3,4,5,3,7,42.9,4,9,2,7,5,11,0
19,Tyler Adams,4,3,1,3,0,2,3,66.7,1,2,0,2,4,2,0
20,Junior Adamu,5,1,1,2,2,1,2,50.0,1,1,0,1,0,2,0
21,Sargis Adamyan,14,9,2,9,3,6,11,54.5,5,16,1,15,5,7,0
22,Tosin Adarabioyo,21,11,16,5,0,12,21,57.1,9,16,11,5,25,80,0
23,Elijah Adebayo,4,1,1,0,3,1,12,8.3,11,13,2,11,6,25,0
24,Karim Adeyemi,16,14,9,4,3,8,20,40.0,12,11,0,11,3,5,0
25,Simon Adingra,45,20,23,11,11,19,42,45.2,23,31,1,30,19,22,0
26,Nathaniel Adjei,13,9,8,3,2,6,7,85.7,1,15,8,7,18,64,1
27,Amine Adli,16,7,2,10,4,7,17,41.2,10,10,2,8,6,5,0
28,Yacine Adli,34,17,17,13,4,13,35,37.1,22,22,8,14,20,15,1
29,Adryelson,0,0,0,0,0,0,0,,0,0,0,0,1,3,0
30,Adson,7,6,1,6,0,2,2,100.0,0,5,0,5,2,2,0
31,Michel Aebischer,35,20,9,20,6,15,34,44.1,19,28,6,22,12,22,0
32,Emmanuel Agbadou,65,41,38,23,4,44,64,68.8,20,47,25,22,55,116,1
33,Julen Agirrezabala,0,0,0,0,0,0,0,,0,0,0,0,0,0,0
34,Lucien Agoume,0,0,0,0,0,0,0,,0,0,0,0,0,0,0
35,Lucien Agoume,23,18,7,14,2,9,12,75.0,3,6,1,5,7,8,0
36,Felix Agu,45,29,28,13,4,29,41,70.7,12,27,7,20,13,41,0
37,Nayef Aguerd,26,14,19,7,0,16,22,72.7,6,33,24,9,17,85,2
38,Ruben Aguilar,53,31,27,23,3,27,45,60.0,18,35,5,30,26,46,0
39,Brandon Aguilera,0,0,0,0,0,0,0,,0,0,0,0,0,0,0
40,Naouirou Ahamada,13,9,5,6,2,8,17,47.1,9,3,0,3,2,4,0
41,Anel Ahmedhodžić,64,36,48,14,2,30,49,61.2,19,43,26,17,35,137,2
42,Joseph Aidoo,8,3,6,2,0,4,8,50.0,4,3,1,2,4,28,0
43,Ola Aina,47,31,31,12,4,29,41,70.7,12,19,3,16,18,51,1
44,Rayan Aït-Nouri,71,44,41,23,7,28,49,57.1,21,32,6,26,15,38,0
45,Tosin Aiyegun,6,4,2,3,1,3,9,33.3,6,4,1,3,2,8,0
46,Kristoffer Ajer,38,21,25,9,4,23,36,63.9,13,26,11,15,25,79,1
47,Ludovic Ajorque,3,2,1,2,0,2,11,18.2,9,6,2,4,4,11,0
48,Manuel Akanji,42,28,16,18,8,22,39,56.4,17,28,12,16,23,70,3
49,Marley Aké,0,0,0,0,0,0,0,,0,0,0,0,0,0,0
50,Nathan Aké,26,16,15,8,3,13,20,65.0,7,17,2,15,14,54,0
51,Ilias Akhomach,36,21,11,16,9,10,20,50.0,10,10,2,8,13,13,0
52,Sergio Akieme,27,15,18,7,2,13,16,81.3,3,14,4,10,10,34,0
53,Sergio Akieme,11,5,6,3,2,8,11,72.7,3,9,3,6,10,25,0
54,Ebenezer Akinsanmiro,0,0,0,0,0,0,1,0.0,1,0,0,0,0,0,0
55,Maghnes Akliouche,37,23,12,20,5,12,36,33.3,24,21,0,21,9,3,0
56,Paul Akouokou,5,3,0,2,3,3,3,100.0,0,3,1,2,1,1,0
57,Paul Akouokou,14,9,2,10,2,6,7,85.7,1,5,1,4,6,11,0
58,Jean-Daniel Akpa-Akpro,20,11,14,4,2,3,9,33.3,6,10,4,6,12,15,1
59,David Akpan Ankeye,1,0,0,1,0,0,1,0.0,1,1,0,1,0,0,0
60,Kevin Akpoguma,35,18,22,12,1,26,35,74.3,9,28,8,20,18,32,0
61,David Alaba,13,9,7,5,1,4,8,50.0,4,10,7,3,15,34,0
62,Luis Alberto,35,20,16,12,7,15,53,28.3,38,34,4,30,7,13,0
63,Raúl Albiol,25,14,15,9,1,18,27,66.7,9,31,24,7,16,102,0
64,Thiago Alcántara,0,0,0,0,0,0,0,,0,0,0,0,0,0,0
65,Carlos Alcaraz,6,6,0,6,0,5,10,50.0,5,5,2,3,5,4,0
66,Rubén Alcaraz,97,59,39,52,6,50,121,41.3,71,60,14,46,33,55,2
67,Omar Alderete,28,21,15,13,0,19,35,54.3,16,30,18,12,13,111,0
68,Iván Alejo,40,23,23,11,6,17,57,29.8,40,20,0,20,7,17,0
69,Carles Aleñá,24,8,7,14,3,10,24,41.7,14,14,3,11,4,13,0
70,Trent Alexander-Arnold,39,26,26,11,2,27,87,31.0,60,22,2,20,31,48,5
71,Aboubacar Ali,2,0,0,2,0,0,0,,0,1,0,1,1,2,0
72,Mohamed Ali Cho,4,3,3,1,0,2,7,28.6,5,6,0,6,1,1,0
73,Mohamed Ali Cho,12,9,4,7,1,3,11,27.3,8,10,0,10,3,6,0
74,Faride Alidou,10,4,3,6,1,4,18,22.2,14,23,2,21,8,15,1
75,Nabil Alioui,3,2,2,1,0,2,4,50.0,2,6,1,5,3,4,0
76,Alisson,0,0,0,0,0,0,1,0.0,1,0,0,0,0,11,4
77,Tadeo Allende,6,1,3,2,1,4,6,66.7,2,3,0,3,3,3,0
78,Jim Allevinah,30,18,11,14,5,14,35,40.0,21,20,3,17,13,30,0
79,Domingos André Ribeiro Almeida,25,15,9,12,4,9,19,47.4,10,13,1,12,6,5,0
80,Miguel Almirón,36,24,13,15,8,11,29,37.9,18,29,2,27,10,13,0
81,Pontus Almqvist,45,29,16,22,7,23,51,45.1,28,21,2,19,14,10,0
82,Marcos Alonso,5,3,2,3,0,3,4,75.0,1,2,0,2,4,6,0
83,Adrià Altimira,16,7,9,6,1,9,24,37.5,15,18,5,13,5,18,0
84,Sergi Altimira,15,8,8,6,1,11,23,47.8,12,12,1,11,9,10,0
85,Edson Álvarez,80,39,47,26,7,31,66,47.0,35,59,20,39,42,81,0
86,Gastón Álvarez,68,37,43,20,5,37,57,64.9,20,40,11,29,35,80,0
87,Hugo Álvarez,14,9,8,3,3,9,20,45.0,11,4,1,3,5,9,0
88,Julián Álvarez,24,13,5,8,11,8,32,25.0,24,30,0,30,2,14,1
89,Yeray Álvarez,18,9,15,3,0,12,19,63.2,7,8,5,3,11,34,1
90,Skelly Alvero,8,7,5,2,1,2,9,22.2,7,5,1,4,2,5,0
91,Skelly Alvero,6,4,1,5,0,3,3,100.0,0,3,1,2,1,1,0
92,Papa Amadou Diallo,18,8,10,7,1,7,21,33.3,14,11,1,10,11,16,0
93,Selim Amallah,17,12,7,7,3,3,9,33.3,6,13,0,13,11,6,0
94,Amath,9,6,7,2,0,2,10,20.0,8,2,0,2,3,6,0
95,Lorenzo Amatucci,0,0,0,0,0,0,0,,0,0,0,0,0,0,0
96,Jordan Amavi,1,1,0,1,0,1,3,33.3,2,2,1,1,3,2,0
97,Zeki Amdouni,27,18,1,15,11,7,25,28.0,18,23,10,13,9,10,0
98,Kelvin Amian,16,7,12,4,0,11,15,73.3,4,6,0,6,7,28,0
99,Bruno Amione,11,3,9,2,0,4,5,80.0,1,4,2,2,9,19,2
100,Michael Amir Murillo,23,11,13,6,4,15,23,65.2,8,9,2,7,11,34,2
101,Nadiem Amiri,22,14,8,10,4,13,19,68.4,6,16,2,14,14,18,0
102,Nadiem Amiri,4,2,0,3,1,0,3,0.0,3,0,0,0,0,1,0
103,Kofi Amoako,0,0,0,0,0,0,0,,0,0,0,0,0,0,0
104,Sofyan Amrabat,27,16,17,8,2,17,31,54.8,14,20,7,13,8,19,2
105,Joachim Andersen,56,35,33,21,2,29,39,74.4,10,33,18,15,41,207,1
106,Elliot Anderson,24,18,12,9,3,15,29,51.7,14,23,4,19,8,23,0
107,Felipe Anderson,78,45,32,33,13,34,90,37.8,56,45,3,42,27,23,0
108,Benjamin André,89,49,39,45,5,43,81,53.1,38,34,5,29,35,60,0
109,Komnen Andrić,2,1,0,1,1,0,4,0.0,4,2,0,2,0,1,0
110,Robert Andrich,30,18,8,14,8,13,24,54.2,11,15,4,11,20,17,0
111,Miguel Ángel Rubio,20,12,14,6,0,14,21,66.7,7,31,18,13,28,74,2
112,Angeliño,21,11,12,6,3,11,19,57.9,8,11,5,6,12,37,1
113,Fabrizio Angileri,1,1,1,0,0,1,3,33.3,2,0,0,0,4,8,0
114,Jaidon Anthony,3,1,1,0,2,1,7,14.3,6,3,0,3,1,3,0
115,Waldemar Anton,39,25,21,16,2,23,42,54.8,19,33,20,13,40,150,1
116,Michail Antonio,15,8,5,6,4,3,11,27.3,8,16,3,13,4,4,0
117,Antony,40,21,15,19,6,20,40,50.0,20,29,1,28,12,9,0
118,Christopher Antwi-Adjei,21,12,10,6,5,12,22,54.5,10,13,2,11,2,11,1
119,Houssem Aouar,16,11,4,10,2,3,12,25.0,9,5,0,5,4,2,1
120,Stredair Appuah,0,0,0,0,0,0,3,0.0,3,0,0,0,1,1,0
121,Mauro Arambarri,6,2,3,2,1,1,6,16.7,5,1,0,1,2,7,0
122,Jon Aramburu,24,15,12,10,2,15,25,60.0,10,8,3,5,7,17,0
123,Asaf Arania,0,0,0,0,0,0,0,,0,0,0,0,0,0,0
124,Julian Araujo,41,22,29,7,5,23,33,69.7,10,23,16,7,10,52,1
125,Ronald Araújo,27,22,11,15,1,12,17,70.6,5,20,11,9,12,66,2
126,Oliver Arblaster,23,14,11,8,4,7,15,46.7,8,17,7,10,15,9,0
127,Cameron Archer,18,13,6,6,6,8,18,44.4,10,22,3,19,1,11,0
128,Cameron Archer,0,0,0,0,0,0,0,,0,0,0,0,0,0,0
129,Alphonse Areola,1,1,1,0,0,1,3,33.3,2,0,0,0,1,16,0
130,Adu Ares,8,4,4,2,2,2,3,66.7,1,1,0,1,1,0,0
131,Jesús Areso,45,24,25,13,7,31,38,81.6,7,36,15,21,18,58,0
132,Simone Aresti,0,0,0,0,0,0,0,,0,0,0,0,0,0,0
133,Matias Arezo,7,3,2,5,0,1,5,20.0,4,4,1,3,1,4,0
134,Iñigo Arguibide,1,0,0,1,0,0,0,,0,0,0,0,0,1,0
135,Yoël Armougom,3,3,2,0,1,2,3,66.7,1,1,0,1,1,3,0
136,José Arnaiz,14,8,6,4,4,6,21,28.6,15,11,2,9,3,2,0
137,Hákon Arnar Haraldsson,12,8,4,7,1,5,21,23.8,16,7,2,5,3,5,0
138,Marko Arnautović,10,4,3,5,2,4,7,57.1,3,8,1,7,5,5,0
139,Maximilian Arnold,51,31,15,27,9,28,57,49.1,29,23,4,19,24,60,0
140,Mohamed El Arouch,0,0,0,0,0,0,0,,0,0,0,0,0,0,0
141,Sergio Arribas,34,17,16,17,1,14,31,45.2,17,20,1,19,16,8,1
142,Kepa Arrizabalaga,0,0,0,0,0,0,1,0.0,1,0,0,0,0,4,0
143,Arthur,4,3,2,0,2,2,2,100.0,0,1,1,0,0,7,0
144,Takuma Asano,17,6,2,9,6,7,23,30.4,16,17,3,14,4,11,0
145,Marco Asensio,12,10,4,7,1,4,13,30.8,9,7,0,7,5,2,0
146,Kristjan Asllani,7,2,3,4,0,2,11,18.2,9,9,3,6,11,8,0
147,Joel Asoro,13,9,7,6,0,3,10,30.0,7,7,1,6,6,9,0
148,Jonathan Asp Jensen,0,0,0,0,0,0,0,,0,0,0,0,0,1,0
149,Iago Aspas,11,6,4,6,1,1,15,6.7,14,23,3,20,10,8,0
150,Lorenz Assignon,35,17,18,13,4,14,27,51.9,13,22,7,15,19,43,1
151,Lorenz Assignon,24,12,12,8,4,9,24,37.5,15,9,4,5,9,27,1
152,Youcef Atal,9,3,6,2,1,6,8,75.0,2,7,1,6,4,1,0
153,Valentin Atangana Edoa,19,13,6,9,4,5,13,38.5,8,5,1,4,6,9,0
154,Arthur Atta,18,14,8,7,3,8,19,42.1,11,13,3,10,10,23,0
155,Noah Atubolu,0,0,0,0,0,0,1,0.0,1,0,0,0,0,8,1
156,Pierre-Emerick Aubameyang,22,14,4,11,7,7,26,26.9,19,30,5,25,9,26,0
157,Emil Audero,0,0,0,0,0,0,0,,0,0,0,0,0,1,0
158,Tommaso Augello,26,19,18,6,2,16,25,64.0,9,21,10,11,17,89,0
159,Carlos Augusto,29,21,20,9,0,15,22,68.2,7,20,8,12,16,52,0
160,Yann Aurel Bisseck,14,6,10,3,1,6,9,66.7,3,10,7,3,5,23,0
161,Serge Aurier,20,14,9,11,0,5,11,45.5,6,10,3,7,9,36,1
162,Ezequiel Ávila,3,2,1,1,1,3,11,27.3,8,14,0,14,4,8,0
163,Ezequiel Ávila,2,1,0,2,0,1,3,33.3,2,2,0,2,1,4,0
164,Taiwo Awoniyi,9,7,1,4,4,1,2,50.0,1,7,2,5,1,9,0
165,André Ayew,15,11,7,6,2,6,9,66.7,3,8,3,5,2,11,0
166,Jordan Ayew,65,36,23,28,14,21,42,50.0,21,43,2,41,16,15,0
167,Neil El Aynaoui,37,20,13,20,4,20,46,43.5,26,20,6,14,32,21,1
168,Sardar Azmoun,8,5,2,5,1,4,8,50.0,4,4,1,3,3,6,1
169,César Azpilicueta,25,14,15,9,1,12,19,63.2,7,25,6,19,16,46,0
170,Paulo Azzi,19,11,10,6,3,9,18,50.0,9,11,2,9,16,23,0
171,Oussama El Azzouzi,12,7,4,5,3,7,14,50.0,7,8,2,6,6,12,0
172,Abdellah Baallal,0,0,0,0,0,0,0,,0,1,0,1,0,0,0
173,Iddrisu Baba,46,26,27,18,1,17,39,43.6,22,20,6,14,11,27,2
174,Srđan Babić,2,2,0,2,0,1,1,100.0,0,1,1,0,0,2,0
175,Shavy Babicka,11,8,2,7,2,2,5,40.0,3,6,1,5,0,2,0
176,Aliou Badara Baldé,4,1,0,3,1,1,1,100.0,0,2,1,1,3,0,0
177,Loïc Bade,65,41,53,12,0,30,49,61.2,19,23,15,8,38,116,2
178,Milan Badelj,51,27,23,24,4,24,61,39.3,37,45,13,32,50,54,1
179,Matthias Bader,51,25,32,11,8,33,65,50.8,32,22,4,18,25,20,0
180,Benoît Badiashile,21,15,12,9,0,9,14,64.3,5,21,14,7,18,66,2
181,Alex Baena,34,21,10,16,8,20,47,42.6,27,23,2,21,13,17,1
182,Jaime Báez,4,1,0,2,2,0,7,0.0,7,5,0,5,4,1,0
183,Nicola Bagnolini,0,0,0,0,0,0,0,,0,0,0,0,0,0,0
184,Leon Bailey,13,7,7,4,2,5,20,25.0,15,18,1,17,9,6,0
185,Eric Bailly,5,3,4,1,0,2,2,100.0,0,8,8,0,9,38,2
186,Stefan Bajcetic,4,1,3,1,0,3,5,60.0,2,0,0,0,0,0,0
187,Nedim Bajrami,13,6,6,3,4,5,13,38.5,8,5,1,4,6,8,0
188,Cédric Bakambu,1,0,0,1,0,0,0,,0,2,0,2,0,0,0
189,Tiemoué Bakayoko,34,17,14,17,3,15,28,53.6,13,10,4,6,26,15,1
190,Mitchel Bakker,7,3,6,1,0,2,12,16.7,10,5,0,5,3,6,0
191,Ridle Baku,37,20,24,7,6,21,46,45.7,25,27,1,26,21,45,1
192,Dilane Bakwa,30,22,12,13,5,11,40,27.5,29,26,1,25,20,11,0
193,Tommaso Baldanzi,4,2,1,1,2,3,10,30.0,7,7,0,7,2,0,0
194,Tommaso Baldanzi,9,5,3,4,2,1,1,100.0,0,2,0,2,0,4,0
195,Alejandro Balde,20,11,11,6,3,7,11,63.6,4,14,1,13,5,21,1
196,George Baldock,18,10,10,7,1,6,15,40.0,9,14,8,6,10,33,0
197,Carlos Baleba,40,20,17,19,4,23,46,50.0,23,35,7,28,18,30,3
198,Carlos Baleba,6,2,1,4,1,3,4,75.0,1,0,0,0,2,0,0
199,Leonardo Balerdi,79,50,55,23,1,49,67,73.1,18,38,15,23,51,91,0
200,Iván Balliu,44,31,20,24,0,22,39,56.4,17,27,11,16,29,66,1
201,Fodé Ballo-Touré,4,2,1,3,0,1,2,50.0,1,1,0,1,3,2,0
202,Folarin Balogun,12,4,3,8,1,5,13,38.5,8,10,0,10,3,4,0
203,Jonathan Bamba,14,9,4,8,2,2,17,11.8,15,20,0,20,18,12,0
204,Mohamed Bamba,14,9,3,8,3,4,10,40.0,6,7,1,6,2,3,0
205,Samuel Bamba,1,1,1,0,0,1,2,50.0,1,0,0,0,0,1,0
206,Lameck Banda,27,23,11,12,4,7,21,33.3,14,18,0,18,3,7,0
207,Daniel Bandeira,6,5,1,4,1,3,7,42.9,4,3,0,3,3,9,0
208,Mamady Bangré,4,2,2,2,0,3,4,75.0,1,0,0,0,4,3,0
209,Mattia Bani,26,10,18,7,1,11,22,50.0,11,51,31,20,22,116,1
210,Léo Baptistão,25,16,12,8,5,9,25,36.0,16,13,1,12,11,22,0
211,Shandon Baptiste,4,4,2,2,0,1,5,20.0,4,5,1,4,3,6,0
212,Antonín Barák,6,2,1,3,2,3,7,42.9,4,5,0,5,2,4,0
213,Valentín Barco,11,5,4,5,2,6,8,75.0,2,3,0,3,4,3,1
214,Bradley Barcola,5,2,0,2,3,1,7,14.3,6,4,0,4,2,0,0
215,Bradley Barcola,34,16,12,13,9,7,25,28.0,18,27,2,25,10,13,1
216,Melvin Bard,69,38,28,30,11,37,63,58.7,26,46,12,34,42,46,0
217,Nicolò Barella,46,30,17,20,9,19,63,30.2,44,31,1,30,10,12,1
218,Kike Barja,6,2,2,2,2,3,8,37.5,5,2,1,1,2,2,0
219,Ross Barkley,47,19,16,21,10,11,48,22.9,37,25,9,16,25,51,2
220,Aymen Barkok,9,5,2,6,1,3,6,50.0,3,7,0,7,2,1,0
221,Harvey Barnes,6,1,3,2,1,1,2,50.0,1,1,0,1,5,3,0
222,Leandro Barreiro Martins,65,40,19,37,9,30,50,60.0,20,45,16,29,36,53,0
223,Enzo Barrenechea,65,42,28,29,8,28,70,40.0,42,47,12,35,27,61,2
224,Ander Barrenetxea,32,21,7,16,9,10,26,38.5,16,18,1,17,6,5,0
225,Pablo Barrios,45,25,15,29,1,19,40,47.5,21,20,3,17,28,24,2
226,Davide Bartesaghi,2,0,1,1,0,2,4,50.0,2,1,1,0,0,7,0
227,Marc Bartra,4,3,3,1,0,4,5,80.0,1,3,1,2,3,10,0
228,Federico Baschirotto,21,12,16,5,0,8,15,53.3,7,42,26,16,23,144,1
229,Steven Baseya,2,1,1,1,0,1,1,100.0,0,0,0,0,0,1,0
230,Chris Basham,7,2,4,3,0,2,9,22.2,7,9,4,5,5,17,0
231,Toma Bašić,20,13,10,9,1,10,27,37.0,17,18,6,12,14,29,0
232,Calvin Bassey,49,29,33,15,1,21,29,72.4,8,32,11,21,28,84,4
233,Alessandro Bastoni,46,33,31,12,3,26,40,65.0,14,25,11,14,23,48,1
234,Simone Bastoni,22,13,12,7,3,11,22,50.0,11,8,0,8,11,18,0
235,Augusto Batalla,0,0,0,0,0,0,1,0.0,1,0,0,0,0,10,2
236,Daniel Batz,0,0,0,0,0,0,0,,0,0,0,0,0,3,0
237,Maximilian Bauer,19,12,13,4,2,9,17,52.9,8,14,8,6,11,30,1
238,Elias Baum,1,0,0,0,1,0,0,,0,3,2,1,0,1,0
239,Oliver Baumann,1,1,1,0,0,1,2,50.0,1,0,0,0,0,19,2
240,Christoph Baumgartner,26,13,10,12,4,14,38,36.8,24,20,1,19,5,14,0
241,Bebé,2,2,1,1,0,1,5,20.0,4,1,0,1,0,0,0
242,Ihlas Bebou,22,12,10,8,4,8,16,50.0,8,13,2,11,14,15,0
243,Mohamed Bechikh,0,0,0,0,0,0,0,,0,0,0,0,0,0,0
244,Adrian Beck,22,13,8,12,2,9,24,37.5,15,17,0,17,4,15,0
245,Owen Beck,2,1,1,1,0,0,0,,0,0,0,0,0,1,0
246,Sheraldo Becker,2,2,0,2,0,0,1,0.0,1,3,0,3,1,0,0
247,Sheraldo Becker,3,3,0,2,1,0,2,0.0,2,2,0,2,0,2,0
248,Chris Bedia,2,1,0,2,0,0,1,0.0,1,3,0,3,0,2,0
249,Donny van de Beek,0,0,0,0,0,0,0,,0,1,0,1,0,0,0
250,Donny van de Beek,8,3,3,3,2,3,7,42.9,4,5,1,4,3,1,0
251,Yanis Begraoui,5,3,1,3,1,3,9,33.3,6,4,0,4,5,5,0
252,Kevin Behrens,2,1,0,1,1,0,2,0.0,2,9,0,9,3,6,0
253,Kevin Behrens,13,10,3,7,3,1,4,25.0,3,7,2,5,6,19,0
254,Maximilian Beier,20,12,5,11,4,4,19,21.1,15,21,1,20,9,12,0
255,Jérémie Bela,1,1,0,1,0,1,3,33.3,2,1,0,1,0,1,0
256,Reda Belahyane,1,1,0,1,0,1,1,100.0,0,0,0,0,1,0,0
257,Reda Belahyane,1,0,0,1,0,1,1,100.0,0,0,0,0,0,0,0
258,Amari'i Bell,50,33,30,19,1,22,35,62.9,13,33,15,18,25,60,1
259,Stefan Bell,8,8,7,1,0,4,8,50.0,4,7,5,2,6,30,0
260,Alaa Bellaarouch,0,0,0,0,0,0,0,,0,0,0,0,1,11,2
261,Raoul Bellanova,36,26,15,17,4,18,31,58.1,13,21,4,17,15,36,3
262,Jean-Ricner Bellegarde,17,10,9,6,2,7,15,46.7,8,18,2,16,8,14,0
263,Jean-Ricner Bellegarde,5,3,3,2,0,3,6,50.0,3,4,0,4,4,0,0
264,Héctor Bellerín,34,22,14,16,4,20,53,37.7,33,13,5,8,22,40,1
265,Jude Bellingham,42,34,14,18,10,12,36,33.3,24,55,5,50,21,17,0
266,Jeanuël Belocian,32,22,23,8,1,22,28,78.6,6,18,10,8,13,49,0
267,Andrea Belotti,8,3,1,5,2,5,12,41.7,7,8,1,7,2,3,0
268,Andrea Belotti,8,4,2,3,3,3,6,50.0,3,7,0,7,2,3,0
269,Fran Beltrán,56,32,22,23,11,24,63,38.1,39,28,2,26,18,34,0
270,Lucas Beltrán,27,14,4,18,5,11,20,55.0,9,29,3,26,2,11,0
271,Eliesse Ben Seghir,9,6,2,5,2,3,7,42.9,4,6,0,6,2,2,0
272,Anis Ben Slimane,11,6,5,2,4,4,10,40.0,6,7,1,6,5,7,0
273,Wissam Ben Yedder,4,3,1,2,1,1,11,9.1,10,18,0,18,8,1,0
274,Carlos Benavídez,56,35,19,26,11,19,34,55.9,15,13,5,8,19,31,0
275,Ismaël Bennacer,29,19,11,16,2,11,22,50.0,11,12,4,8,12,9,2
276,Saïd Benrahma,8,4,5,3,0,4,15,26.7,11,8,0,8,5,7,0
277,Saïd Benrahma,9,7,1,6,2,5,7,71.4,2,7,0,7,1,3,0
278,Ramy Bensebaini,34,21,21,11,2,24,34,70.6,10,22,7,15,16,37,0
279,Nabil Bentaleb,49,32,29,18,2,22,43,51.2,21,33,12,21,37,33,0
280,Rodrigo Bentancur,23,15,10,11,2,10,24,41.7,14,15,4,11,17,16,1
281,Daniel Bentley,0,0,0,0,0,0,1,0.0,1,0,0,0,0,1,0
282,Lucas Beraldo,22,14,14,8,0,10,25,40.0,15,15,6,9,20,25,0
283,Domenico Berardi,17,8,7,9,1,2,21,9.5,19,17,0,17,13,9,0
284,Yuri Berchiche,33,25,13,14,6,19,33,57.6,14,28,9,19,20,62,0
285,Álex Berenguer,23,14,9,9,5,7,24,29.2,17,23,0,23,5,13,0
286,Bartosz Bereszyński,41,25,25,13,3,24,40,60.0,16,22,10,12,21,52,0
287,Jóhann Berg Guðmundsson,13,4,6,5,2,7,16,43.8,9,14,0,14,16,16,0
288,Sander Berge,76,46,35,36,5,34,58,58.6,24,49,20,29,23,60,2
289,Etrit Berisha,0,0,0,0,0,0,1,0.0,1,0,0,0,0,7,1
290,Medon Berisha,3,1,3,0,0,0,2,0.0,2,2,2,0,1,0,0
291,Mergim Berisha,0,0,0,0,0,0,0,,0,2,1,1,0,0,0
292,Mergim Berisha,0,0,0,0,0,0,0,,0,1,0,1,0,3,0
293,Isaac Bernal,6,3,2,2,2,5,9,55.6,4,12,0,12,0,11,0
294,Bernardo,99,58,56,35,8,45,69,65.2,24,66,30,36,55,120,1
295,Victor Bernth Kristiansen,52,34,23,22,7,20,35,57.1,15,35,8,27,12,45,1
296,Matúš Bero,32,22,13,12,7,13,32,40.6,19,24,3,21,12,26,0
297,Luke Berry,7,2,2,4,1,2,3,66.7,1,6,1,5,0,3,0
298,Dimitry Bertaud,0,0,0,0,0,0,0,,0,0,0,0,0,0,0
299,Jan-Niklas Beste,77,49,35,24,18,28,55,50.9,27,48,1,47,18,31,0
300,Beto,14,6,1,6,7,4,12,33.3,8,11,0,11,1,14,0
301,Beto,1,0,0,0,1,0,0,,0,0,0,0,0,0,0
302,Davide Bettella,0,0,0,0,0,0,0,,0,0,0,0,0,0,0
303,Sam Beukema,27,11,14,11,2,16,25,64.0,9,35,21,14,15,99,2
304,Jordan Beyer,35,20,22,12,1,14,24,58.3,10,22,15,7,16,68,1
305,Pep Biel,4,3,0,2,2,1,3,33.3,2,2,1,1,2,2,0
306,Jaka Bijol,43,27,34,9,0,22,35,62.9,13,36,21,15,23,140,1
307,El Bilal Touré,1,1,0,1,0,0,1,0.0,1,0,0,0,1,2,0
308,Philip Billing,33,16,7,22,4,9,27,33.3,18,31,5,26,20,28,1
309,Cristiano Biraghi,47,28,20,24,3,28,52,53.8,24,30,5,25,14,43,0
310,Davide Biraschi,3,3,1,2,0,1,3,33.3,2,0,0,0,2,5,0
311,Samuele Birindelli,28,19,16,7,5,14,25,56.0,11,30,11,19,18,48,0
312,Tom Bischof,8,4,6,1,1,2,9,22.2,7,3,0,3,1,2,0
313,Yves Bissouma,80,52,32,36,12,41,61,67.2,20,28,5,23,37,43,3
314,Leonardo Bittencourt,42,18,20,17,5,15,39,38.5,24,18,1,17,13,6,0
315,Marco Bizot,0,0,0,0,0,0,1,0.0,1,0,0,0,0,18,3
316,Antonio Blanco,61,36,29,27,5,31,86,36.0,55,25,2,23,35,30,0
317,Rubén Blanco,0,0,0,0,0,0,0,,0,0,0,0,0,0,0
318,Hendry Blank,1,0,1,0,0,1,1,100.0,0,1,0,1,0,4,0
319,Ludovic Blas,30,14,16,13,1,12,28,42.9,16,13,1,12,6,9,0
320,Janis Blaswich,1,1,1,0,0,0,0,,0,0,0,0,0,7,3
321,Alexis Blin,33,19,11,19,3,15,43,34.9,28,16,2,14,22,39,0
322,Daley Blind,47,21,33,13,1,29,47,61.7,18,37,19,18,21,113,0
323,Myron Boadu,2,2,0,1,1,1,2,50.0,1,2,0,2,0,0,0
324,Benicio Boaitey,0,0,0,0,0,0,1,0.0,1,1,0,1,0,2,0
325,Jérôme Boateng,0,0,0,0,0,0,0,,0,6,5,1,4,21,0
326,Oscar Bobb,7,3,1,2,4,2,4,50.0,2,4,0,4,5,1,0
327,Sacha Boey,2,0,2,0,0,1,2,50.0,1,1,0,1,1,2,0
328,Jeremie Boga,18,7,6,10,2,10,20,50.0,10,26,2,24,8,4,0
329,Jayden Bogle,66,36,43,21,2,35,70,50.0,35,42,11,31,32,97,0
330,Emil Bohinen,1,1,0,1,0,0,0,,0,1,0,1,0,3,0
331,Emil Bohinen,8,6,5,3,0,2,10,20.0,8,8,2,6,14,6,1
332,Adama Bojang,2,1,1,0,1,0,0,,0,2,1,1,1,0,0
333,Daniel Boloca,48,33,18,25,5,27,46,58.7,19,23,13,10,14,33,2
334,Willy Boly,46,29,36,9,1,22,40,55.0,18,32,21,11,25,90,0
335,Giacomo Bonaventura,26,13,6,10,10,9,21,42.9,12,16,1,15,14,10,0
336,Federico Bonazzoli,4,1,1,3,0,1,8,12.5,7,9,1,8,3,3,0
337,Warren Bondo,29,22,16,10,3,13,17,76.5,4,13,3,10,6,13,0
338,Giovanni Bonfanti,4,2,2,2,0,2,3,66.7,1,1,1,0,1,1,0
339,Victor Boniface,6,4,0,1,5,1,4,25.0,3,6,1,5,0,13,0
340,Kevin Bonifazi,4,0,0,4,0,1,2,50.0,1,0,0,0,0,7,1
341,Kevin Bonifazi,5,3,2,3,0,2,3,66.7,1,1,0,1,3,9,0
342,Leonardo Bonucci,6,5,2,4,0,4,4,100.0,0,5,3,2,7,16,0
343,Ângelo Borges,24,11,9,7,8,11,31,35.5,20,18,0,18,9,2,0
344,Neto Borges,48,24,25,18,5,28,63,44.4,35,28,6,22,57,84,0
345,Yvandro Borges Sanches,0,0,0,0,0,0,0,,0,0,0,0,0,0,0
346,Sebastiaan Bornauw,26,12,19,7,0,13,19,68.4,6,21,12,9,18,81,0
347,Rafael Borré,10,7,2,4,4,5,16,31.3,11,8,2,6,2,10,0
348,Gennaro Borrelli,0,0,0,0,0,0,0,,0,0,0,0,0,0,0
349,Adri Bosch,1,1,1,0,0,0,0,,0,0,0,0,0,1,0
350,Erik Botheim,2,0,2,0,0,0,1,0.0,1,3,0,3,0,2,0
351,Sven Botman,20,13,14,6,0,8,13,61.5,5,20,16,4,9,61,3
352,Saïmon Bouabré,2,2,0,2,0,1,2,50.0,1,1,0,1,0,0,0
353,Ayyoub Bouaddi,6,2,6,0,0,2,5,40.0,3,2,0,2,1,3,0
354,Badredine Bouanani,3,2,1,1,1,3,4,75.0,1,5,0,5,3,0,0
355,Badredine Bouanani,4,2,1,1,2,2,4,50.0,2,3,0,3,2,3,0
356,Mohamed Bouchenna,1,0,1,0,0,0,0,,0,0,0,0,0,0,0
357,Hicham Boudaoui,41,19,16,22,3,21,30,70.0,9,15,1,14,11,15,0
358,Yassine Bounou,0,0,0,0,0,0,0,,0,0,0,0,0,0,0
359,Mehdi Bourabia,5,4,1,4,0,2,4,50.0,2,3,0,3,0,4,0
360,Benjamin Bourigeaud,31,18,14,9,8,13,44,29.5,31,31,2,29,22,39,2
361,Bilal Boutobba,22,12,6,10,6,10,23,43.5,13,9,0,9,8,3,0
362,Hugo Boutsingkham,0,0,0,0,0,0,0,,0,0,0,0,0,1,0
363,Edoardo Bove,60,31,16,31,13,27,46,58.7,19,21,1,20,11,11,1
364,Jarrod Bowen,42,28,14,14,14,13,35,37.1,22,37,5,32,19,14,0
365,Lucas Boyé,50,25,14,25,11,14,34,41.2,20,35,5,30,10,46,0
366,Domagoj Bradarić,29,20,13,10,6,15,25,60.0,10,22,7,15,32,62,1
367,Conor Bradley,33,25,14,12,7,24,38,63.2,14,17,1,16,10,14,0
368,Bilal Brahimi,0,0,0,0,0,0,1,0.0,1,0,0,0,0,0,0
369,Bilal Brahimi,0,0,0,0,0,0,3,0.0,3,3,0,3,0,0,0
370,Juan Brandáriz,34,22,22,12,0,16,26,61.5,10,38,23,15,14,107,3
371,Julian Brandt,17,14,8,8,1,10,27,37.0,17,20,3,17,8,18,0
372,Jarrad Branthwaite,66,32,42,22,2,45,62,72.6,17,51,36,15,50,163,2
373,Darko Brašanac,1,0,1,0,0,1,1,100.0,0,1,0,1,0,0,0
374,Lilian Brassier,31,18,18,13,0,12,24,50.0,12,28,21,7,41,93,0
375,Brau,1,0,1,0,0,1,1,100.0,0,0,0,0,0,2,0
376,Claudio Bravo,0,0,0,0,0,0,1,0.0,1,0,0,0,0,2,0
377,Fabian Bredlow,0,0,0,0,0,0,1,0.0,1,0,0,0,0,3,0
378,Tim Breithaupt,20,11,11,9,0,13,21,61.9,8,15,3,12,8,10,0
379,Josip Brekalo,8,6,6,2,0,2,11,18.2,9,7,0,7,1,0,0
380,Gleison Bremer,58,42,32,21,5,21,29,72.4,8,45,27,18,40,147,0
381,Brenner,8,7,1,5,2,4,7,57.1,3,2,0,2,0,2,0
382,Ben Brereton,9,4,4,4,1,4,10,40.0,6,9,3,6,3,12,0
383,Ben Brereton,2,2,1,0,1,0,2,0.0,2,0,0,0,0,0,0
384,Marco Brescianini,28,13,13,12,3,9,25,36.0,16,22,5,17,10,37,0
385,Maximilian Breunig,0,0,0,0,0,0,0,,0,1,0,1,0,0,0
386,Rhian Brewster,5,1,1,2,2,0,2,0.0,2,2,0,2,1,2,0
387,Bennit Bröger,0,0,0,0,0,0,0,,0,0,0,0,0,0,0
388,Armando Broja,3,0,0,1,2,1,2,50.0,1,5,1,4,0,3,0
389,Armando Broja,0,0,0,0,0,0,0,,0,1,0,1,0,0,0
390,Dylan Bronn,0,0,0,0,0,0,1,0.0,1,2,0,2,0,4,0
391,Andre Brooks,22,13,7,11,4,9,21,42.9,12,13,1,12,14,20,0
392,David Brooks,5,4,2,1,2,2,4,50.0,2,3,0,3,2,2,0
393,John Brooks,28,15,17,10,1,15,30,50.0,15,29,17,12,27,109,1
394,Moritz Broschinski,11,7,2,5,4,2,8,25.0,6,11,2,9,0,6,0
395,Jacob Brown,19,12,7,7,5,7,18,38.9,11,20,1,19,8,22,0
396,Josh Brownhill,61,35,23,28,10,27,37,73.0,10,33,8,25,34,40,1
397,Alexander Brunst,0,0,0,0,0,0,2,0.0,2,0,0,0,0,2,1
398,Jacob Bruun Larsen,9,4,4,3,2,7,21,33.3,14,16,2,14,7,23,0
399,Tajon Buchanan,1,1,0,0,1,1,2,50.0,1,1,0,1,0,4,0
400,Ante Budimir,21,15,2,11,8,5,14,35.7,9,19,5,14,5,18,0
401,Hugo Bueno,21,14,12,7,2,12,19,63.2,7,17,4,13,6,24,0
402,Santiago Bueno,13,7,5,7,1,5,11,45.5,6,22,12,10,6,33,0
403,Marius Bülter,18,11,9,5,4,12,23,52.2,11,17,3,14,10,20,0
404,Facundo Buonanotte,42,22,13,22,7,14,44,31.8,30,22,3,19,8,5,0
405,Alessandro Buongiorno,70,39,43,24,3,24,34,70.6,10,20,12,8,69,131,0
406,Jonathan Burkardt,12,8,2,6,4,4,11,36.4,7,16,3,13,3,2,0
407,Oliver Burke,0,0,0,0,0,0,2,0.0,2,0,0,0,0,0,0
408,Reece Burke,37,23,17,14,6,12,26,46.2,14,25,18,7,18,78,1
409,Dan Burn,61,33,37,20,4,26,61,42.6,35,55,25,30,37,124,1
410,Rareș-Cătălin Burnete,0,0,0,0,0,0,0,,0,0,0,0,0,0,0
411,Mason Burstow,0,0,0,0,0,0,0,,0,0,0,0,0,0,0
412,Marnon Busch,11,9,6,3,2,7,12,58.3,5,9,2,7,10,12,0
413,Maxime Busi,2,0,0,1,1,0,2,0.0,2,6,1,5,4,5,0
414,Pablo Busto,1,1,0,0,1,1,1,100.0,0,0,0,0,1,3,0
415,Aurélio Buta,40,25,19,16,5,21,38,55.3,17,24,5,19,15,36,0
416,Marcin Bułka,0,0,0,0,0,0,2,0.0,2,0,0,0,0,9,3
417,Jamie Bynoe-Gittens,14,7,6,7,1,2,17,11.8,15,11,2,9,4,7,0
418,Rémy Cabella,54,36,19,20,15,20,54,37.0,34,32,0,32,5,5,0
419,Jovane Cabral,13,9,4,7,2,3,9,33.3,6,3,0,3,1,4,0
420,Liberato Cacace,40,24,24,13,3,24,38,63.2,14,23,6,17,19,56,0
421,Anthony Caci,56,23,30,25,1,27,44,61.4,17,43,7,36,32,45,0
422,Moisés Caicedo,91,46,38,42,11,36,60,60.0,24,59,25,34,37,44,4
423,Tom Cairney,24,16,10,12,2,13,25,52.0,12,16,4,12,13,6,0
424,Jens Cajuste,36,24,13,17,6,20,37,54.1,17,20,3,17,4,15,0
425,Davide Calabria,70,38,38,25,7,44,72,61.1,28,26,7,19,24,49,1
426,Riccardo Calafiori,47,32,28,16,3,22,32,68.8,10,38,13,25,50,74,3
427,Mattia Caldara,1,1,1,0,0,1,1,100.0,0,1,1,0,1,1,0
428,Luca Caldirola,25,14,19,4,2,13,22,59.1,9,26,17,9,29,53,0
429,Duje Ćaleta-Car,26,11,19,6,1,18,22,81.8,4,27,14,13,18,94,1
430,Hakan Çalhanoğlu,66,33,29,29,8,32,49,65.3,17,29,13,16,24,22,0
431,José Callejón,13,6,10,3,0,8,22,36.4,14,7,1,6,5,10,0
432,Dominic Calvert-Lewin,13,6,2,6,5,2,15,13.3,13,14,4,10,4,38,0
433,Lamine Camara,62,42,26,30,6,24,49,49.0,25,35,2,33,28,34,0
434,Mahdi Camara,55,39,8,40,7,20,49,40.8,29,24,1,23,27,19,0
435,Mohamed Camara,35,21,10,20,5,15,29,51.7,14,8,2,6,11,7,0
436,Francesco Camarda,0,0,0,0,0,0,2,0.0,2,0,0,0,0,0,0
437,Eduardo Camavinga,76,47,39,29,8,23,39,59.0,16,36,8,28,29,29,1
438,Nicolò Cambiaghi,51,39,15,20,16,16,35,45.7,19,26,1,25,14,8,0
439,Andrea Cambiaso,47,30,23,15,9,25,43,58.1,18,28,3,25,11,26,1
440,Axel Camblan,3,1,0,2,1,2,4,50.0,2,2,0,2,0,0,0
441,Sergio Camello,16,5,3,10,3,6,15,40.0,9,10,2,8,3,15,0
442,José Campaña,2,2,1,1,0,0,2,0.0,2,3,2,1,2,3,0
443,Emre Can,63,45,37,23,3,28,48,58.3,20,30,7,23,22,41,2
444,Matteo Cancellieri,35,22,12,16,7,13,36,36.1,23,19,0,19,6,18,0
445,João Cancelo,64,44,35,21,8,38,58,65.5,20,35,6,29,29,59,1
446,Fali Candé,40,19,31,9,0,20,35,57.1,15,41,28,13,20,107,1
447,Antonio Candreva,18,13,8,8,2,9,25,36.0,16,9,0,9,7,23,0
448,Thomas Cannon,0,0,0,0,0,0,0,,0,0,0,0,0,0,0
449,Sergi Canós,23,13,7,11,5,10,24,41.7,14,14,2,12,11,9,0
450,Luigi Canotto,0,0,0,0,0,0,0,,0,0,0,0,0,0,0
451,Gino Caoki,0,0,0,0,0,0,1,0.0,1,0,0,0,0,0,0
452,Étienne Capoue,32,18,17,12,3,15,22,68.2,7,20,4,16,22,24,1
453,Gianluca Caprari,2,1,1,1,0,0,1,0.0,1,0,0,0,2,0,0
454,Elia Caprile,1,0,1,0,0,1,1,100.0,0,0,0,0,0,16,2
455,Francesco Caputo,2,0,0,0,2,0,1,0.0,1,4,0,4,1,3,0
456,Maxence Caqueret,91,64,39,37,15,38,107,35.5,69,40,9,31,48,26,2
457,Andrea Carboni,38,22,24,12,2,20,31,64.5,11,23,13,10,17,56,1
458,Valentin Carboni,25,15,10,12,3,8,26,30.8,18,12,1,11,7,4,0
459,Isaac Carcelen,50,31,30,15,5,25,45,55.6,20,24,7,17,27,87,2
460,Cárdenas,0,0,0,0,0,0,0,,0,0,0,0,0,1,0
461,Irvin Cardona,1,1,0,0,1,1,3,33.3,2,1,0,1,0,1,0
462,Marc Cardona,9,8,3,4,2,1,12,8.3,11,5,0,5,2,7,0
463,Sergi Cardona,90,55,52,29,9,55,96,57.3,41,45,7,38,46,102,0
464,Johnny Cardoso,48,29,19,24,5,22,33,66.7,11,20,5,15,32,31,0
465,Igor Carioca,8,6,6,1,1,4,6,66.7,2,0,0,0,3,6,0
466,Diego Carlos,27,16,22,4,1,13,21,61.9,8,24,19,5,13,78,3
467,Carmona,30,21,13,14,3,9,28,32.1,19,15,2,13,21,25,0
468,Marco Carnesecchi,0,0,0,0,0,0,0,,0,0,0,0,0,22,3
469,Yannick Carrasco,4,4,3,1,0,2,7,28.6,5,2,0,2,1,6,0
470,Álvaro Carreras,13,8,8,4,1,5,11,45.5,6,5,1,4,7,9,1
471,Rasmus Carstensen,47,22,23,20,4,31,56,55.4,25,38,9,29,20,50,2
472,Antonin Cartillier,0,0,0,0,0,0,0,,0,1,0,1,0,0,0
473,Dani Carvajal,47,32,28,15,4,23,42,54.8,19,28,9,19,22,54,4
474,Fabio Carvalho,3,1,0,2,1,1,3,33.3,2,8,0,8,0,1,0
475,William Carvalho,20,12,11,7,2,10,16,62.5,6,8,1,7,8,9,1
476,Cesare Casadei,5,3,2,1,2,2,5,40.0,3,1,0,1,0,4,0
477,Marc Casado,1,1,1,0,0,1,1,100.0,0,0,0,0,1,2,0
478,Nicolò Casale,15,9,13,2,0,6,15,40.0,9,19,16,3,12,61,0
479,Casemiro,83,56,43,32,8,51,106,48.1,55,74,33,41,18,71,1
480,Kaelan Casey,0,0,0,0,0,0,0,,0,0,0,0,0,1,0
481,Matty Cash,54,31,24,24,6,29,59,49.2,30,35,14,21,18,59,0
482,Josué Casimir,31,18,14,14,3,7,18,38.9,11,23,2,21,13,25,0
483,Giuseppe Caso,4,3,2,0,2,2,3,66.7,1,0,0,0,0,0,0
484,Cristian Cásseres Jr.,70,34,31,33,6,29,61,47.5,32,34,4,30,27,33,1
485,Timothy Castagne,49,24,23,16,10,26,44,59.1,18,38,10,28,38,69,1
486,Koen Casteels,2,1,2,0,0,2,3,66.7,1,0,0,0,0,16,5
487,Valentín Castellanos,22,10,1,12,9,6,20,30.0,14,22,2,20,2,18,0
488,Jean-Charles Castelletto,34,26,22,10,2,18,29,62.1,11,19,10,9,32,81,0
489,Samu Castillejo,12,10,5,5,2,7,19,36.8,12,16,1,15,1,3,0
490,Jonny Castro,0,0,0,0,0,0,1,0.0,1,1,1,0,0,0,0
491,Santiago Castro,2,1,0,1,1,1,3,33.3,2,1,0,1,1,1,0
492,Gaetano Castrovilli,3,2,1,2,0,1,8,12.5,7,4,0,4,2,3,0
493,Danilo Cataldi,24,12,7,16,1,8,18,44.4,10,15,7,8,17,19,1
494,Catena,33,18,26,6,1,19,35,54.3,16,24,15,9,15,119,3
495,Maximiliano Caufriez,38,28,31,5,2,19,29,65.5,10,18,12,6,18,69,2
496,Ivan Cavaleiro,10,6,3,4,3,7,20,35.0,13,9,2,7,5,6,0
497,Dani Ceballos,10,5,4,5,1,5,14,35.7,9,9,2,7,0,4,1
498,Emil Ceide,2,2,1,1,0,1,1,100.0,0,6,1,5,0,0,0
499,Zeki Çelik,23,16,10,10,3,14,25,56.0,11,12,5,7,8,25,0
500,Álex Centelles,11,6,9,2,0,8,18,44.4,10,5,2,3,18,29,0
501,Fabien Centonze,14,8,10,4,0,5,10,50.0,5,14,2,12,10,18,0
502,Fabien Centonze,2,1,2,0,0,2,3,66.7,1,2,1,1,0,1,0
503,Václav Černý,8,3,3,4,1,2,14,14.3,12,13,0,13,8,6,0
504,Michele Cerofolini,0,0,0,0,0,0,0,,0,0,0,0,0,5,1
505,Alberto Cerri,3,3,1,1,1,2,5,40.0,3,3,1,2,3,7,0
506,Leonardo Cerri,0,0,0,0,0,0,0,,0,0,0,0,0,0,0
507,Franco Cervi,24,18,13,9,2,13,24,54.2,11,16,0,16,9,4,0
508,Julian Chabot,59,42,40,17,2,35,59,59.3,24,66,43,23,45,145,0
509,El Chadaille Bitshiabu,1,0,1,0,0,0,0,,0,0,0,0,1,4,0
510,Fares Chaïbi,0,0,0,0,0,0,0,,0,0,0,0,0,2,0
511,Fares Chaïbi,27,17,7,12,8,8,18,44.4,10,37,1,36,5,19,0
512,Trevoh Chalobah,16,12,10,2,4,10,15,66.7,5,8,7,1,8,51,0
513,Muhammed Cham,25,14,10,13,2,11,27,40.7,16,20,2,18,8,5,1
514,Calum Chambers,3,0,3,0,0,0,1,0.0,1,2,1,1,2,4,0
515,Timothy Chandler,0,0,0,0,0,0,0,,0,0,0,0,0,0,0
516,Brendan Chardonnet,57,34,33,22,2,32,63,50.8,31,58,34,24,53,139,3
517,Charlys,0,0,0,0,0,0,0,,0,0,0,0,1,0,0
518,Pep Chavarría,23,18,15,6,2,11,17,64.7,6,15,3,12,6,29,1
519,Jhoanner Chávez,6,5,2,2,2,3,9,33.3,6,2,0,2,5,11,0
520,Walid Cheddira,12,7,1,8,3,4,8,50.0,4,6,1,5,5,10,0
521,Rayan Cherki,28,15,4,16,8,17,46,37.0,29,13,3,10,7,1,0
522,Youssef Chermiti,3,2,2,1,0,1,5,20.0,4,4,1,3,1,2,0
523,Lucas Chevalier,3,0,3,0,0,3,4,75.0,1,1,0,1,0,11,2
524,Fabio Chiarodia,8,5,5,1,2,5,7,71.4,2,2,1,1,3,9,0
525,Federico Chiesa,20,10,7,6,7,3,13,23.1,10,17,1,16,6,4,0
526,Ben Chilwell,15,10,5,9,1,5,8,62.5,3,11,3,8,4,19,1
527,Tawanda Chirewa,7,3,3,3,1,2,3,66.7,1,0,0,0,1,0,0
528,Pedro Chirivella,50,28,20,29,1,30,76,39.5,46,22,5,17,31,28,0
529,Leon Chiwome,2,1,0,1,1,1,2,50.0,1,3,1,2,0,2,0
530,Tahith Chong,36,22,19,13,4,15,33,45.5,18,30,6,24,8,11,1
531,Joris Chotard,81,52,45,25,11,48,96,50.0,48,47,21,26,44,60,0
532,Andreas Christensen,23,14,7,14,2,16,28,57.1,12,23,10,13,21,41,0
533,Jacob Christensen,10,6,7,3,0,4,7,57.1,3,8,2,6,4,4,0
534,Oliver Christensen,0,0,0,0,0,0,0,,0,0,0,0,0,1,0
535,Ryan Christie,86,44,34,35,17,39,92,42.4,53,52,11,41,52,53,1
536,Carney Chukwuemeka,6,4,3,3,0,1,3,33.3,2,1,1,0,0,1,0
537,Samuel Chukwueze,18,7,11,5,2,9,17,52.9,8,3,1,2,6,3,0
538,Víctor Chust,29,18,23,5,1,18,32,56.3,14,27,21,6,11,92,1
539,Pathé Ciss,44,24,16,26,2,16,29,55.2,13,27,10,17,30,54,0
540,Alphadjo Cissè,0,0,0,0,0,0,0,,0,0,0,0,0,0,0
541,Djaoui Cissé,0,0,0,0,0,0,0,,0,0,0,0,0,0,0
542,Ibrahim Cissoko,4,3,3,1,0,1,3,33.3,2,3,0,3,1,0,0
543,Giorgio Cittadini,1,1,1,0,0,1,1,100.0,0,1,1,0,0,0,0
544,Giorgio Cittadini,5,4,4,1,0,3,3,100.0,0,1,0,1,3,5,0
545,Patrick Ciurria,30,18,13,13,4,13,21,61.9,8,20,5,15,9,28,0
546,Bobby Clark,2,1,1,1,0,1,5,20.0,4,6,2,4,1,1,0
547,Jordan Clark,30,17,14,11,5,11,39,28.2,28,24,3,21,11,15,1
548,Alexis Claude-Maurice,12,5,3,6,3,1,5,20.0,4,4,1,3,5,7,0
549,Jonathan Clauss,47,20,22,19,6,26,49,53.1,23,17,3,14,36,46,0
550,Silvi Clúa,2,0,2,0,0,2,2,100.0,0,1,0,1,0,0,0
551,Nathaniel Clyne,24,15,11,11,2,14,21,66.7,7,18,6,12,10,33,0
552,Marcus Coco,43,26,29,10,4,28,60,46.7,32,19,1,18,21,38,0
553,Saúl Coco,32,19,25,7,0,11,18,61.1,7,27,15,12,20,120,3
554,Séamus Coleman,17,14,10,3,4,11,16,68.8,5,12,4,8,7,26,1
555,Maxime Colin,39,23,25,7,7,16,29,55.2,13,22,7,15,20,71,0
556,Nathan Collins,38,20,24,12,2,19,29,65.5,10,46,30,16,44,141,4
557,Nnamdi Collins,0,0,0,0,0,0,0,,0,0,0,0,2,4,0
558,Lorenzo Colombo,17,12,3,9,5,8,14,57.1,6,18,5,13,0,14,0
559,Andrea Colpani,25,15,6,13,6,11,20,55.0,9,11,4,7,14,14,0
560,Levi Colwill,48,30,26,17,5,26,34,76.5,8,28,10,18,26,66,0
561,Kingsley Coman,12,7,5,3,4,9,17,52.9,8,15,1,14,2,5,0
562,Eray Cömert,42,28,28,13,1,28,38,73.7,10,35,18,17,36,77,1
563,Santi Comesaña,44,26,15,21,8,19,38,50.0,19,33,9,24,22,27,1
564,Pietro Comuzzo,1,1,1,0,0,1,1,100.0,0,1,0,1,1,2,0
565,Alois Confais,2,2,1,1,0,1,1,100.0,0,0,0,0,0,0,0
566,Andrea Consigli,0,0,0,0,0,0,0,,0,1,0,1,1,19,1
567,Bambasé Conté,3,3,2,0,1,1,1,100.0,0,0,0,0,0,0,0
568,Nikita Contini Baranovsky,0,0,0,0,0,0,0,,0,0,0,0,0,1,0
569,Lewis Cook,61,41,24,30,7,34,63,54.0,29,32,11,21,65,46,1
570,Copete,45,27,27,17,1,30,43,69.8,13,12,6,6,32,47,1
571,Diego Coppola,36,22,25,9,2,20,33,60.6,13,26,9,17,27,89,1
572,Francis Coquelin,20,12,8,10,2,5,13,38.5,8,14,4,10,16,15,0
573,Tommaso Corazza,10,4,9,1,0,4,9,44.4,5,2,0,2,5,3,0
574,Theo Corbeanu,5,2,2,3,0,1,3,33.3,2,3,0,3,3,2,0
575,Jeppe Corfitzen,1,0,0,1,0,1,1,100.0,0,0,0,0,0,0,0
576,Jack Cork,2,0,0,2,0,1,3,33.3,2,0,0,0,1,1,0
577,Maxwel Cornet,3,2,3,0,0,1,5,20.0,4,2,0,2,2,1,0
578,Giacomo Corona,0,0,0,0,0,0,0,,0,0,0,0,0,0,0
579,Jesús Corona,0,0,0,0,0,0,0,,0,0,0,0,1,0,0
580,Ángel Correa,22,15,3,11,8,5,17,29.4,12,13,0,13,2,6,0
581,Joaquín Correa,7,5,4,2,1,0,8,0.0,8,2,0,2,1,1,0
582,Thierry Correia,63,35,39,20,4,28,49,57.1,21,39,16,23,33,61,0
583,Oscar Cortés,0,0,0,0,0,0,0,,0,1,0,1,0,0,0
584,Danny da Costa,18,9,9,7,2,9,19,47.4,10,17,4,13,16,24,0
585,David Pereira da Costa,18,10,5,12,1,10,23,43.5,13,21,4,17,16,8,1
586,Jaume Costa,38,22,23,10,5,18,29,62.1,11,14,4,10,16,35,0
587,João Costa,0,0,0,0,0,0,0,,0,0,0,0,0,0,0
588,Logan Costa,40,24,31,9,0,15,24,62.5,9,42,27,15,23,120,1
589,Samu Costa,91,50,40,46,5,46,93,49.5,47,28,14,14,39,59,3
590,Benoît Costil,2,1,1,1,0,2,3,66.7,1,0,0,0,0,5,1
591,Grégoire Coudert,0,0,0,0,0,0,0,,0,0,0,0,0,0,0
592,Vladimír Coufal,64,41,50,12,2,38,75,50.7,37,49,15,34,43,97,0
593,Lassana Coulibaly,47,32,20,21,6,22,49,44.9,27,23,5,18,16,29,0
594,Mamadou Coulibaly,0,0,0,0,0,0,0,,0,0,0,0,0,0,0
595,Mamadou Coulibaly,7,4,2,3,2,3,8,37.5,5,4,0,4,0,0,0
596,Tanguy Coulibaly,13,11,8,4,1,4,9,44.4,5,11,1,10,2,2,0
597,Thibaut Courtois,1,0,1,0,0,0,0,,0,0,0,0,0,0,0
598,Philippe Coutinho,0,0,0,0,0,0,1,0.0,1,0,0,0,0,0,0
599,Yan Couto,45,34,25,14,6,20,40,50.0,20,14,2,12,10,31,1
600,Nicolas Cozza,35,23,23,10,2,17,24,70.8,7,7,0,7,14,32,0
601,Nicolas Cozza,8,6,4,4,0,2,7,28.6,5,3,0,3,4,6,0
602,Alessio Cragno,0,0,0,0,0,0,0,,0,0,0,0,0,3,1
603,Crespo,16,9,8,6,2,9,17,52.9,8,15,6,9,10,7,0
604,Aaron Cresswell,3,2,1,1,1,2,3,66.7,1,5,3,2,3,7,0
605,Bryan Cristante,72,41,33,28,11,28,50,56.0,22,36,6,30,25,55,2
606,Cristian,0,0,0,0,0,0,0,,0,0,0,0,0,0,0
607,Juan Cruz Armada,27,15,16,10,1,17,25,68.0,8,14,7,7,12,39,1
608,Juan Cruz,2,2,0,0,2,0,0,,0,1,0,1,1,0,0
609,Juan Cruz,0,0,0,0,0,0,1,0.0,1,0,0,0,0,0,0
610,Juan Cuadrado,4,3,2,2,0,3,5,60.0,2,6,1,5,1,2,0
611,Pau Cubarsí,22,14,18,3,1,13,18,72.2,5,20,16,4,12,65,0
612,Marc Cucurella,62,38,36,21,5,34,64,53.1,30,36,13,23,22,48,0
613,Iván Cuéllar,0,0,0,0,0,0,0,,0,0,0,0,0,0,0
614,Jorge Cuenca,42,29,26,10,6,19,30,63.3,11,26,15,11,21,114,0
615,Josh Cullen,42,29,15,22,5,26,46,56.5,20,31,19,12,15,26,1
616,Matheus Cunha,30,16,8,17,5,13,35,37.1,22,28,7,21,13,21,1
617,Marvin Cuni,8,3,1,3,4,3,4,75.0,1,10,1,9,1,0,0
618,Eric Curbelo,4,3,2,2,0,3,4,75.0,1,3,1,2,2,5,1
619,Sam Curtis,1,0,1,0,0,1,2,50.0,1,2,0,2,0,0,0
620,Tomáš Čvančara,4,3,0,2,2,1,3,33.3,2,5,1,4,2,8,0
621,Danilo D'Ambrosio,57,34,34,20,3,28,41,68.3,13,22,13,9,14,31,0
622,Alberto Dadie,2,1,2,0,0,0,0,,0,1,0,1,0,0,0
623,Trévis Dago,0,0,0,0,0,0,0,,0,0,0,0,1,0,0
624,Finn Dahmen,1,0,1,0,0,1,3,33.3,2,0,0,0,0,17,5
625,Mahmoud Dahoud,9,4,2,4,3,3,9,33.3,6,4,1,3,1,5,0
626,Mahmoud Dahoud,5,1,1,4,0,3,7,42.9,4,4,0,4,0,1,0
627,Ameen Al-Dakhil,12,5,4,7,1,1,10,10.0,9,13,6,7,12,38,2
628,Thijs Dallinga,29,15,6,11,12,9,15,60.0,6,11,4,7,3,35,0
629,Diogo Dalot,81,51,58,12,11,51,74,68.9,23,44,16,28,37,111,0
630,Mikkel Damsgaard,29,17,13,9,7,14,40,35.0,26,23,1,22,11,10,1
631,Flavius Daniliuc,19,11,12,5,2,9,19,47.4,10,13,4,9,8,15,0
632,Danilo,36,18,22,12,2,21,46,45.7,25,33,8,25,35,42,0
633,Danilo,60,36,38,18,4,32,48,66.7,16,34,15,19,37,94,0
634,Arnaut Danjuma,6,4,2,3,1,1,4,25.0,3,4,0,4,3,0,0
635,Jayden Danns,0,0,0,0,0,0,0,,0,0,0,0,0,0,0
636,Kevin Danso,24,14,12,11,1,15,30,50.0,15,43,30,13,23,115,1
637,Dante,62,30,44,16,2,38,52,73.1,14,43,22,21,37,77,2
638,Raimane Daou,1,1,1,0,0,1,2,50.0,1,0,0,0,0,2,0
639,Mohammed Daramy,10,9,4,4,2,6,16,37.5,10,5,1,4,4,4,0
640,Sergi Darder,39,26,13,21,5,12,31,38.7,19,20,4,16,16,16,0
641,Achraf Dari,1,1,1,0,0,0,2,0.0,2,2,0,2,5,9,1
642,Matteo Darmian,48,22,23,15,10,20,53,37.7,33,27,11,16,13,55,0
643,Lukas Daschner,9,4,2,3,4,4,9,44.4,5,7,0,7,2,2,0
644,Josh Dasilva,2,1,0,1,1,0,0,,0,0,0,0,0,0,0
645,David Datro Fofana,10,5,3,5,2,3,6,50.0,3,9,3,6,1,2,0
646,David Datro Fofana,10,7,3,5,2,4,9,44.4,5,4,0,4,0,5,0
647,Juan David Cabal,36,27,19,14,3,18,29,62.1,11,30,9,21,26,55,2
648,Jonathan David,26,15,6,13,7,8,26,30.8,18,16,0,16,9,4,0
649,Alphonso Davies,47,24,29,13,5,30,53,56.6,23,30,4,26,26,49,1
650,Ben Davies,24,17,13,8,3,16,21,76.2,5,17,15,2,10,35,0
651,Tom Davies,10,5,4,3,3,3,9,33.3,6,2,1,1,3,6,1
652,Keinan Davis,0,0,0,0,0,0,0,,0,0,0,0,0,3,0
653,Paweł Dawidowicz,53,30,33,18,2,17,29,58.6,12,17,9,8,24,114,1
654,Craig Dawson,30,20,23,6,1,22,34,64.7,12,51,39,12,16,120,1
655,Kevin De Bruyne,14,9,1,5,8,7,20,35.0,13,5,0,5,4,4,0
656,Charles De Ketelaere,33,21,3,12,18,10,20,50.0,10,30,2,28,7,6,0
657,Rodrigo De Paul,31,21,11,14,6,15,38,39.5,23,28,1,27,11,15,2
658,Mattia De Sciglio,0,0,0,0,0,0,0,,0,1,0,1,1,2,0
659,Lorenzo De Silvestri,10,8,5,2,3,4,7,57.1,3,9,4,5,6,27,0
660,Thibault De Smet,56,35,36,16,4,33,59,55.9,26,25,5,20,21,51,1
661,Koni De Winter,44,25,26,13,5,21,31,67.7,10,30,10,20,21,78,0
662,Grégoire Defrel,17,8,7,5,5,7,15,46.7,8,10,0,10,3,9,0
663,Alessandro Deiola,33,19,13,16,4,18,47,38.3,29,16,6,10,9,37,0
664,Romain Del Castillo,46,29,14,18,14,18,70,25.7,52,33,1,32,9,8,0
665,Thomas Delaine,38,19,29,8,1,20,42,47.6,22,18,2,16,17,51,0
666,Sacha Delaye,7,2,2,2,3,1,6,16.7,5,2,0,2,0,1,0
667,Hannes Delcroix,10,6,6,4,0,3,4,75.0,1,9,3,6,9,26,0
668,Alessandro Dellavalle,0,0,0,0,0,0,0,,0,1,1,0,1,0,0
669,Olivier Deman,28,15,21,4,3,18,38,47.4,20,24,8,16,14,49,1
670,Karamoko Dembele,0,0,0,0,0,0,0,,0,0,0,0,0,0,0
671,Ousmane Dembélé,19,14,2,7,10,6,13,46.2,7,11,0,11,5,4,1
672,Jessy Deminguet,14,9,6,8,0,6,18,33.3,12,8,0,8,9,5,1
673,Ermedin Demirović,24,14,5,16,3,12,40,30.0,28,28,2,26,11,26,0
674,Diego Demme,1,1,0,1,0,0,1,0.0,1,0,0,0,0,0,0
675,Sepp van den Berg,38,23,20,15,3,15,26,57.7,11,66,36,30,43,159,2
676,Leander Dendoncker,6,4,3,2,1,4,5,80.0,1,5,2,3,2,3,1
677,Leander Dendoncker,0,0,0,0,0,0,0,,0,1,1,0,0,0,0
678,Rémy Descamps,0,0,0,0,0,0,0,,0,0,0,0,0,7,0
679,Mikkel Desler,18,12,8,7,3,9,17,52.9,8,32,13,19,19,38,0
680,Arthur Desmas,0,0,0,0,0,0,2,0.0,2,0,0,0,0,13,1
681,Mattia Destro,2,1,0,2,0,1,1,100.0,0,4,0,4,2,3,0
682,Samuele Di Benedetto,0,0,0,0,0,0,0,,0,0,0,0,1,0,0
683,Federico Di Francesco,1,0,0,1,0,0,0,,0,0,0,0,0,0,0
684,Raffaele Di Gennaro,0,0,0,0,0,0,0,,0,0,0,0,0,0,0
685,Michele Di Gregorio,1,0,1,0,0,1,4,25.0,3,1,0,1,1,10,2
686,Giovanni Di Lorenzo,58,36,26,26,6,32,68,47.1,36,43,16,27,24,45,0
687,Alessandro Di Pardo,4,1,3,0,1,0,3,0.0,3,9,2,7,5,7,0
688,Boulaye Dia,4,2,2,2,0,1,3,33.3,2,5,0,5,3,7,0
689,Moussa Diaby,12,5,5,4,3,4,22,18.2,18,8,1,7,9,6,0
690,Lamine Diack,0,0,0,0,0,0,0,,0,0,0,0,0,0,0
691,Mouctar Diakhaby,18,11,9,9,0,11,13,84.6,2,17,7,10,11,62,0
692,Mamadou Diakhon,5,3,2,1,2,3,9,33.3,6,1,0,1,1,1,0
693,Bafodé Diakité,29,20,12,15,2,24,32,75.0,8,16,8,8,21,49,1
694,Ibrahim Diakité,1,0,0,1,0,0,1,0.0,1,3,0,3,2,5,0
695,Moussa Diakité,0,0,0,0,0,0,0,,0,0,0,0,0,0,0
696,Oumar Diakité,25,12,10,9,6,7,21,33.3,14,13,0,13,7,7,0
697,Amad Diallo,10,3,1,6,3,3,7,42.9,4,3,1,2,1,6,0
698,Amadou Diallo,0,0,0,0,0,0,0,,0,0,0,0,0,0,0
699,Assane Diao,20,12,5,9,6,6,17,35.3,11,22,4,18,7,7,0
700,Habib Diarra,30,23,8,20,2,9,33,27.3,24,23,4,19,17,15,0
701,Moussa Diarra,32,12,16,15,1,13,27,48.1,14,30,14,16,20,43,0
702,Rúben Dias,39,20,14,21,4,19,26,73.1,7,32,17,15,30,77,0
703,Krépin Diatta,37,20,17,16,4,27,49,55.1,22,17,2,15,16,22,0
704,Mory Diaw,1,1,1,0,0,1,2,50.0,1,0,0,0,1,13,5
705,Mahamadou Diawara,9,6,4,5,0,3,11,27.3,8,4,1,3,4,4,0
706,Brahim Díaz,29,19,4,16,9,6,13,46.2,7,16,1,15,5,2,0
707,Luis Díaz,35,25,5,17,13,7,30,23.3,23,15,0,15,3,8,0
708,Víctor Díaz,5,3,2,3,0,1,3,33.3,2,1,0,1,1,8,0
709,Famara Diedhiou,1,1,0,1,0,0,1,0.0,1,0,0,0,0,2,0
710,Justin Diehl,0,0,0,0,0,0,0,,0,1,1,0,0,0,1
711,Bamba Dieng,3,3,0,3,0,1,3,33.3,2,3,0,3,0,7,0
712,Eric Dier,2,1,2,0,0,2,2,100.0,0,3,3,0,2,12,0
713,Eric Dier,11,8,5,5,1,5,6,83.3,1,20,12,8,10,48,1
714,Guillaume Dietsch,0,0,0,0,0,0,0,,0,0,0,0,0,0,0
715,Florian Dietz,0,0,0,0,0,0,0,,0,1,0,1,0,0,0
716,Lucas Digne,47,19,35,9,3,25,44,56.8,19,20,2,18,26,67,0
717,Federico Dimarco,42,25,19,14,9,17,35,48.6,18,18,3,15,9,34,1
718,Stole Dimitrievski,1,1,1,0,0,1,1,100.0,0,0,0,0,0,17,3
719,Junior Dina Ebimbe,44,29,15,17,12,18,41,43.9,23,28,7,21,9,39,1
720,Eren Dinkçi,32,18,16,13,3,19,48,39.6,29,40,4,36,12,21,0
721,Sinaly Diomande,10,4,5,3,2,9,16,56.3,7,12,9,3,15,26,1
722,Edan Diop,10,8,6,3,1,7,9,77.8,2,3,0,3,1,5,0
723,Issa Diop,30,16,23,5,2,15,20,75.0,5,28,19,9,17,80,1
724,Sofiane Diop,8,6,3,4,1,4,10,40.0,6,4,0,4,3,3,0
725,Andy Diouf,28,19,12,11,5,14,22,63.6,8,13,3,10,3,5,1
726,Yehvann Diouf,0,0,0,0,0,0,1,0.0,1,0,0,0,1,19,3
727,Axel Disasi,33,19,20,10,3,23,30,76.7,7,26,19,7,18,102,2
728,Tiago Djaló,0,0,0,0,0,0,0,,0,1,0,1,0,1,0
729,Chaim El Djebali,0,0,0,0,0,0,0,,0,0,0,0,0,0,0
730,Djené,34,19,18,13,3,15,26,57.7,11,31,15,16,23,70,0
731,Koffi Djidji,14,9,9,5,0,3,4,75.0,1,10,5,5,10,20,0
732,Berat Djimsiti,42,24,29,12,1,19,31,61.3,12,53,33,20,57,100,0
733,Marko Dmitrović,1,1,1,0,0,1,2,50.0,1,0,0,0,1,5,0
734,Ben Doak,0,0,0,0,0,0,0,,0,0,0,0,0,0,0
735,Ritsu Doan,50,27,21,19,10,21,36,58.3,15,30,3,27,9,29,0
736,Lewis Dobbin,9,7,3,5,1,5,9,55.6,4,5,1,4,1,0,0
737,Dodô,5,3,1,4,0,2,5,40.0,3,2,0,2,5,11,0
738,Danilho Doekhi,34,23,18,16,0,15,21,71.4,6,46,25,21,38,111,1
739,Matt Doherty,31,18,17,10,4,12,23,52.2,11,15,5,10,7,47,0
740,Josh Doig,16,9,9,7,0,13,17,76.5,4,12,3,9,4,17,1
741,Josh Doig,25,17,16,9,0,15,27,55.6,12,31,10,21,16,38,0
742,Jeremy Doku,39,22,13,12,14,9,20,45.0,11,14,0,14,9,5,0
743,Jeremy Doku,2,2,1,0,1,1,1,100.0,0,0,0,0,0,0,0
744,Jaume Doménech,0,0,0,0,0,0,0,,0,0,0,0,0,0,0
745,Carlos Dominguez,33,21,17,9,7,23,37,62.2,14,24,12,12,22,78,0
746,Mario Dominguez,0,0,0,0,0,0,0,,0,0,0,0,0,0,0
747,Nicolás Domínguez,63,34,35,27,1,23,48,47.9,25,31,5,26,18,24,0
748,Nicolás Domínguez,1,0,1,0,0,0,2,0.0,2,3,0,3,0,2,0
749,Giulio Donati,0,0,0,0,0,0,0,,0,0,0,0,0,1,1
750,Jamie Donley,0,0,0,0,0,0,0,,0,0,0,0,0,3,0
751,Gianluigi Donnarumma,0,0,0,0,0,0,0,,0,0,0,0,1,9,4
752,Patrick Dorgu,43,22,22,17,4,22,34,64.7,12,16,5,11,9,45,2
753,Niklas Dorsch,35,24,13,21,1,13,33,39.4,20,15,9,6,16,27,0
754,Alberto Dossena,55,35,43,12,0,32,48,66.7,16,50,27,23,45,172,2
755,Carlos Dotor,14,7,3,8,3,4,13,30.8,9,12,2,10,4,4,0
756,Abdoulaye Doucouré,43,27,20,14,9,18,46,39.1,28,23,3,20,15,19,0
757,Cheick Doucouré,34,17,15,13,6,18,30,60.0,12,13,2,11,20,12,0
758,Siriné Doucouré,8,6,0,4,4,3,3,100.0,0,4,0,4,1,6,0
759,Désiré Doué,32,18,11,14,7,10,33,30.3,23,30,1,29,14,8,0
760,Guela Doué,28,21,14,12,2,22,32,68.8,10,12,1,11,15,65,1
761,Alfie Doughty,63,40,29,18,16,37,82,45.1,45,51,9,42,31,43,4
762,Douglas,70,42,34,30,6,30,59,50.8,29,22,8,14,26,30,0
763,Ismaël Doukouré,23,16,7,14,2,13,21,61.9,8,19,7,12,19,29,2
764,Kamory Doumbia,28,18,8,10,10,10,29,34.5,19,14,0,14,9,6,0
765,Anastasios Douvikas,15,7,2,6,7,3,8,37.5,5,6,3,3,2,9,0
766,Artem Dovbyk,4,3,2,1,1,0,2,0.0,2,8,1,7,0,17,0
767,Nikola Dovedan,14,9,2,10,2,5,25,20.0,20,9,0,9,1,3,0
768,Damion Downs,1,1,1,0,0,1,2,50.0,1,1,0,1,0,1,0
769,Tommy Doyle,26,13,11,10,5,14,23,60.9,9,22,9,13,12,18,0
770,Radu Drăgușin,5,3,5,0,0,3,3,100.0,0,5,4,1,8,19,0
771,Radu Drăgușin,16,11,9,6,1,8,9,88.9,1,18,12,6,21,87,3
772,Dion Drena Beljo,0,0,0,0,0,0,2,0.0,2,8,1,7,1,4,0
773,Tim Drexler,16,9,12,4,0,8,17,47.1,9,12,8,4,8,14,0
774,Domingos Duarte,7,4,6,0,1,5,7,71.4,2,7,5,2,8,27,0
775,Rubén Duarte,39,20,21,16,2,21,31,67.7,10,21,6,15,23,69,0
776,Martin Dúbravka,0,0,0,0,0,0,4,0.0,4,0,0,0,0,8,1
777,Marvin Ducksch,8,3,4,3,1,6,14,42.9,8,2,0,2,4,25,0
778,Ondrej Duda,59,39,17,35,7,31,52,59.6,21,29,12,17,26,21,0
779,Denzel Dumfries,22,13,9,11,2,9,23,39.1,14,15,6,9,12,33,1
780,Paul Dummett,1,0,1,0,0,1,1,100.0,0,0,0,0,0,1,0
781,Alfred Duncan,35,22,13,15,7,15,35,42.9,20,27,5,22,11,13,0
782,Lewis Dunk,27,14,17,9,1,13,36,36.1,23,49,37,12,31,90,1
783,Jhon Durán,6,5,3,1,2,1,6,16.7,5,6,0,6,1,10,0
784,Julien Duranville,1,0,0,1,0,1,1,100.0,0,0,0,0,0,0,0
785,Hugo Duro,16,8,5,8,3,9,29,31.0,20,24,5,19,5,27,0
786,Jean-Kevin Duverne,37,19,16,17,4,18,44,40.9,26,17,5,12,18,34,0
787,Paulo Dybala,22,13,3,10,9,2,18,11.1,16,12,0,12,3,6,1
788,Aron Dønnum,16,10,3,8,5,7,22,31.8,15,13,0,13,8,16,1
789,George Earthy,0,0,0,0,0,0,1,0.0,1,0,0,0,1,0,0
790,Simon Ebonog,1,1,0,1,0,1,1,100.0,0,1,1,0,0,1,0
791,Festy Ebosele,33,20,23,9,1,21,35,60.0,14,33,2,31,10,27,0
792,Enzo Ebosse,1,1,1,0,0,0,1,0.0,1,0,0,0,1,0,0
793,Tyronne Ebuehi,14,9,9,5,0,7,11,63.6,4,9,4,5,6,27,1
794,Ederson,0,0,0,0,0,0,1,0.0,1,0,0,0,0,10,1
795,Éderson,83,49,38,38,7,44,63,69.8,19,48,8,40,41,33,1
796,Odsonne Édouard,24,12,8,8,8,4,19,21.1,15,17,1,16,6,19,0
797,John Egan,6,4,4,2,0,4,11,36.4,7,10,4,6,13,39,1
798,Maximilian Eggestein,49,24,25,19,5,15,36,41.7,21,53,19,34,28,40,1
799,Lilian Egloff,4,1,3,1,0,2,4,50.0,2,3,1,2,1,0,0
800,Kingsley Ehizibue,22,14,16,4,2,11,18,61.1,7,21,3,18,8,36,0
801,Hjalmar Ekdal,4,2,2,2,0,2,4,50.0,2,10,5,5,6,21,0
802,Hugo Ekitike,0,0,0,0,0,0,0,,0,0,0,0,0,0,0
803,Hugo Ekitike,11,7,3,6,2,4,6,66.7,2,10,0,10,2,4,0
804,Emmanuel Ekong,0,0,0,0,0,0,0,,0,0,0,0,0,0,0
805,Caleb Ekuban,8,4,2,4,2,5,9,55.6,4,11,3,8,1,7,0
806,Anthony Elanga,33,19,20,6,7,17,36,47.2,19,22,2,20,8,20,1
807,Simon Elisor,9,2,3,2,4,2,6,33.3,4,6,1,5,0,9,0
808,Harvey Elliott,27,17,8,14,5,10,31,32.3,21,27,0,27,6,7,0
809,Elif Elmas,4,3,1,3,0,2,2,100.0,0,2,0,2,2,8,0
810,Elif Elmas,8,6,1,6,1,6,8,75.0,2,5,0,5,1,2,0
811,Mohamed Elneny,0,0,0,0,0,0,1,0.0,1,0,0,0,1,0,0
812,Aritz Elustondo,11,7,5,4,2,6,14,42.9,8,12,10,2,7,26,0
813,Nico Elvedi,33,18,22,10,1,18,24,75.0,6,40,25,15,43,150,2
814,Adri Embarba,55,37,29,15,11,26,53,49.1,27,37,1,36,15,12,0
815,Breel Embolo,3,3,0,2,1,1,4,25.0,3,1,0,1,1,2,0
816,Emanuel Emegha,8,5,2,4,2,4,9,44.4,5,13,3,10,2,25,0
817,Emerson,36,24,23,10,3,21,43,48.8,22,23,10,13,20,50,1
818,Youssef En-Nesyri,10,7,3,4,3,0,10,0.0,10,9,1,8,7,29,1
819,Julio Enciso,6,2,3,2,1,2,7,28.6,5,11,0,11,0,3,0
820,Wataru Endo,48,28,11,31,6,20,61,32.8,41,24,2,22,20,31,3
821,Arne Engels,33,18,15,14,4,12,29,41.4,17,23,1,22,15,21,0
822,Christian Eriksen,18,13,5,10,3,12,33,36.4,21,17,6,11,4,13,0
823,Martin Erlic,37,22,26,8,3,20,30,66.7,10,31,16,15,28,128,1
824,Gonzalo Escalante,39,24,16,14,9,20,55,36.4,35,23,5,18,26,33,2
825,Aarón Escandell,0,0,0,0,0,0,0,,0,0,0,0,0,1,1
826,Alfonso Espino,67,45,43,22,2,30,82,36.6,52,26,4,22,40,63,0
827,Bernardo Espinosa,1,1,1,0,0,1,1,100.0,0,0,0,0,0,2,0
828,Maxime Estève,27,10,15,12,0,18,32,56.3,14,21,10,11,27,56,0
829,Maxime Estève,16,12,11,5,0,10,15,66.7,5,13,9,4,18,50,0
830,Oscar Estupiñan,5,4,0,3,2,1,2,50.0,1,2,0,2,0,0,0
831,Pervis Estupiñán,26,13,12,11,3,14,30,46.7,16,14,4,10,21,20,0
832,Karl Etta,1,1,0,1,0,0,0,,0,0,0,0,0,0,0
833,Jonny Evans,22,14,20,2,0,12,21,57.1,9,25,18,7,23,76,0
834,Eberechi Eze,35,17,4,18,13,15,31,48.4,16,27,2,25,11,6,0
835,Abdessamad Ezzalzouli,1,1,0,0,1,0,1,0.0,1,1,0,1,0,0,0
836,Abdessamad Ezzalzouli,17,14,7,5,5,4,14,28.6,10,10,0,10,5,5,0
837,Giovanni Fabbian,17,10,9,7,1,7,12,58.3,5,5,2,3,7,11,0
838,Łukasz Fabiański,1,0,1,0,0,1,2,50.0,1,0,0,0,1,4,0
839,Nicolò Fagioli,5,3,1,3,1,3,7,42.9,4,3,0,3,4,1,0
840,Romain Faivre,1,1,0,1,0,0,3,0.0,3,0,0,0,0,0,0
841,Romain Faivre,13,6,5,4,4,6,15,40.0,9,6,1,5,7,3,1
842,Ilhan Fakili,0,0,0,0,0,0,1,0.0,1,1,0,1,1,0,0
843,Radamel Falcao,7,5,1,5,1,1,3,33.3,2,2,0,2,3,4,0
844,Wladimiro Falcone,0,0,0,0,0,0,0,,0,1,0,1,1,21,2
845,Fali,41,26,29,11,1,21,36,58.3,15,38,24,14,27,120,0
846,Davide Faraoni,13,10,5,6,2,7,10,70.0,3,9,5,4,6,21,0
847,Davide Faraoni,9,4,5,2,2,5,11,45.5,6,3,1,2,5,14,0
848,Ansu Fati,5,3,1,2,2,1,11,9.1,10,8,0,8,3,3,0
849,Ansu Fati,0,0,0,0,0,0,1,0.0,1,0,0,0,0,0,0
850,Khalil Fayad,28,15,17,7,4,9,22,40.9,13,15,3,12,14,6,0
851,Federico Fazio,18,11,14,4,0,8,14,57.1,6,22,19,3,17,99,1
852,Jacopo Fazzini,49,25,27,13,9,30,53,56.6,23,21,3,18,12,18,0
853,Nabil Fekir,15,10,5,7,3,5,10,50.0,5,9,0,9,7,3,0
854,Felipe,12,9,9,3,0,9,12,75.0,3,4,1,3,4,12,0
855,Luiz Felipe,7,3,5,2,0,4,5,80.0,1,10,4,6,4,16,0
856,João Félix,22,16,9,7,6,8,22,36.4,14,14,1,13,10,11,0
857,Ohis Felix Uduokhai,37,21,18,14,5,16,25,64.0,9,45,35,10,46,178,2
858,Kiko Femenía,35,25,19,13,3,19,34,55.9,15,21,6,15,31,45,0
859,Evan Ferguson,14,6,4,7,3,5,14,35.7,9,10,3,7,2,8,0
860,Lewis Ferguson,37,21,16,17,4,16,37,43.2,21,25,8,17,17,27,1
861,Bruno Fernandes,68,38,27,25,16,30,88,34.1,58,49,6,43,27,50,2
862,Edimilson Fernandes,25,16,15,9,1,16,24,66.7,8,14,6,8,22,52,0
863,Aitor Fernández,0,0,0,0,0,0,1,0.0,1,0,0,0,0,5,1
864,Álex Fernández,19,9,10,9,0,11,22,50.0,11,17,5,12,15,30,0
865,Carlos Fernández,11,7,3,6,2,0,2,0.0,2,4,0,4,0,5,0
866,Enzo Fernández,50,22,22,18,10,27,65,41.5,38,36,13,23,17,28,0
867,Raúl Fernández,0,0,0,0,0,0,1,0.0,1,0,0,0,0,1,2
868,Valery Fernández,11,9,4,7,0,6,8,75.0,2,6,1,5,1,4,0
869,Fernando,0,0,0,0,0,0,0,,0,1,0,1,0,2,0
870,Fernando,9,8,2,4,3,5,9,55.6,4,2,0,2,7,9,0
871,Ichem Ferrah,0,0,0,0,0,0,0,,0,0,0,0,0,0,0
872,Andrea Ferraris,1,1,1,0,0,0,0,,0,0,0,0,0,0,0
873,André Ferreira,0,0,0,0,0,0,1,0.0,1,0,0,0,0,9,2
874,João Ferreira,58,42,36,18,4,34,58,58.6,24,27,6,21,29,89,0
875,Jordan Ferri,36,22,16,17,3,20,67,29.9,47,19,1,18,13,23,0
876,Nacho Ferri,3,3,1,2,0,2,3,66.7,1,0,0,0,0,2,0
877,Rachad Fettal,1,1,1,0,0,0,0,,0,0,0,0,0,0,0
878,Seydou Fini,0,0,0,0,0,0,0,,0,0,0,0,0,0,0
879,Max Finkgräfe,65,39,40,25,0,39,74,52.7,35,35,10,25,22,39,0
880,Vincenzo Fiorillo,0,0,0,0,0,0,0,,0,0,0,0,0,0,1
881,Kilian Fischer,8,6,4,3,1,2,5,40.0,3,8,1,7,1,12,0
882,John Fleck,1,0,0,1,0,0,1,0.0,1,0,0,0,0,1,0
883,Mark Flekken,1,1,1,0,0,1,5,20.0,4,1,0,1,0,17,1
884,Alessandro Florenzi,43,21,26,12,5,26,48,54.2,22,16,9,7,20,25,1
885,Phil Foden,31,20,11,10,10,13,31,41.9,18,30,0,30,13,18,1
886,Wes Foderingham,5,3,5,0,0,5,6,83.3,1,0,0,0,0,18,6
887,Malick Fofana,5,4,3,1,1,4,9,44.4,5,3,0,3,5,9,0
888,Youssouf Fofana,61,39,19,36,6,30,66,45.5,36,35,7,28,37,31,1
889,Jonas Föhrenbach,44,24,24,14,6,19,36,52.8,17,34,19,15,31,70,0
890,Thomas Foket,32,17,21,8,3,20,45,44.4,25,34,12,22,25,36,0
891,Michael Folorunsho,50,28,21,22,7,23,57,40.4,34,45,12,33,17,44,2
892,Tiago Fonseca Morais,1,1,0,1,0,0,0,,0,0,0,0,1,0,0
893,Pablo Fornals,10,6,4,3,3,5,16,31.3,11,8,1,7,6,7,0
894,Pablo Fornals,24,16,8,11,5,12,22,54.5,10,14,0,14,22,10,2
895,Emil Forsberg,7,3,2,5,0,5,12,41.7,7,7,0,7,0,5,0
896,Omari Forson,2,0,0,2,0,1,1,100.0,0,0,0,0,0,0,0
897,Philipp Förster,9,5,3,4,2,2,6,33.3,4,3,0,3,7,3,0
898,Héctor Fort,6,5,5,1,0,4,10,40.0,6,0,0,0,2,4,0
899,Lyle Foster,19,10,5,6,8,6,17,35.3,11,13,3,10,3,34,0
900,Dimitri Foulquier,39,22,22,13,4,18,26,69.2,8,10,1,9,16,49,1
901,Juan Foyth,26,15,18,8,0,12,27,44.4,15,17,4,13,12,44,0
902,Matheus França,3,3,2,1,0,1,7,14.3,6,4,0,4,1,1,0
903,Bartol Franjić,15,12,4,10,1,7,28,25.0,21,12,4,8,30,29,2
904,Przemysław Frankowski,60,39,25,26,9,31,74,41.9,43,30,7,23,25,36,0
905,Nathan Fraser,5,2,2,1,2,1,3,33.3,2,2,1,1,1,2,0
906,Davide Frattesi,10,6,3,7,0,4,8,50.0,4,9,3,6,5,19,0
907,Jean Frederic N'Guessan,3,1,0,3,0,0,3,0.0,3,3,0,3,1,0,0
908,Morten Frendrup,133,72,47,70,16,55,91,60.4,36,55,14,41,51,42,1
909,Remo Freuler,78,50,41,32,5,38,69,55.1,31,37,9,28,36,53,2
910,Marco Friedl,53,32,38,15,0,36,48,75.0,12,45,29,16,35,129,0
911,Marvin Friedrich,23,15,16,6,1,12,20,60.0,8,28,20,8,17,87,0
912,Jeremie Frimpong,26,17,12,7,7,8,20,40.0,12,26,0,26,7,17,0
913,Jorge de Frutos,19,8,5,8,6,7,22,31.8,15,12,0,12,7,18,0
914,Chris Führich,30,19,6,14,10,16,37,43.2,21,31,0,31,7,7,0
915,Shiō Fukuda,2,0,1,1,0,1,2,50.0,1,0,0,0,1,0,0
916,Angelo Fulgini,23,14,6,13,4,11,19,57.9,8,22,1,21,8,11,0
917,Niclas Füllkrug,1,1,0,1,0,1,1,100.0,0,2,1,1,0,1,0
918,Niclas Füllkrug,7,2,1,6,0,2,8,25.0,6,17,4,13,2,25,0
919,Gerardo Fusco,0,0,0,0,0,0,0,,0,0,0,0,0,0,0
920,Daniel Fuzato,0,0,0,0,0,0,0,,0,0,0,0,0,1,0
921,Matteo Gabbia,29,20,15,13,1,18,24,75.0,6,11,6,5,10,48,0
922,Matteo Gabbia,10,6,4,6,0,5,8,62.5,3,5,2,3,8,36,1
923,Gianluca Gaetano,7,4,0,4,3,2,7,28.6,5,4,0,4,3,4,0
924,Gianluca Gaetano,4,1,0,4,0,2,4,50.0,2,5,2,3,1,4,0
925,Roberto Gagliardini,61,30,27,25,9,31,50,62.0,19,30,11,19,31,38,0
926,Cody Gakpo,27,17,8,14,5,8,25,32.0,17,21,4,17,14,7,0
927,Javi Galán,5,4,2,2,1,4,5,80.0,1,1,0,1,1,3,0
928,Javi Galán,38,22,15,19,4,15,30,50.0,15,24,1,23,14,17,1
929,Iñigo Ruiz de Galarreta,49,31,15,26,8,24,49,49.0,25,18,5,13,12,17,0
930,Pablo Galdames Millán,0,0,0,0,0,0,0,,0,1,0,1,0,0,0
931,Conor Gallagher,85,52,37,31,17,33,77,42.9,44,50,11,39,43,34,0
932,Antonino Gallo,43,27,31,11,1,31,49,63.3,18,34,9,25,25,67,0
933,Cristian Gamboa,24,18,12,11,1,14,33,42.4,19,20,7,13,15,34,1
934,Kévin Gameiro,10,10,5,3,2,2,17,11.8,15,9,0,9,3,7,0
935,Idrissa Gana Gueye,73,44,32,27,14,29,46,63.0,17,24,7,17,28,16,0
936,Ignatius Ganago,0,0,0,0,0,0,1,0.0,1,1,0,1,1,1,0
937,Aleix García,49,28,17,26,6,28,54,51.9,26,45,17,28,36,53,3
938,Álvaro García,34,25,15,10,9,7,34,20.6,27,35,0,35,36,33,0
939,Dani García,17,11,4,7,6,12,24,50.0,12,9,3,6,8,11,0
940,David García,29,18,19,9,1,16,26,61.5,10,40,19,21,18,115,2
941,Eric García,0,0,0,0,0,0,0,,0,1,1,0,0,0,0
942,Eric García,55,37,34,18,3,34,49,69.4,15,36,18,18,30,79,2
943,Fran Garcia,25,17,11,12,2,13,31,41.9,18,16,3,13,19,28,1
944,Francisco Jesús Crespo García,12,8,3,6,3,6,18,33.3,12,4,0,4,2,5,0
945,Gonzalo García,0,0,0,0,0,0,1,0.0,1,1,1,0,0,1,0
946,Jastin García,1,0,0,0,1,0,0,,0,0,0,0,0,1,0
947,Raúl García,9,6,2,4,3,4,9,44.4,5,10,1,9,3,9,0
948,Rubén García,32,18,8,17,7,13,33,39.4,20,23,3,20,12,23,0
949,Santiago García,1,0,0,0,1,1,1,100.0,0,0,0,0,0,0,0
950,Ulisses Garcia,21,16,6,13,2,13,20,65.0,7,8,3,5,7,13,2
951,Unai García,12,9,9,2,1,5,10,50.0,5,7,1,6,8,18,0
952,Alejandro Garnacho,22,15,7,6,9,12,45,26.7,33,26,2,24,18,18,0
953,James Garner,83,44,32,38,13,35,82,42.7,47,45,14,31,45,47,1
954,Luca Garritano,10,5,7,2,1,5,15,33.3,10,13,0,13,4,8,1
955,Johan Gastien,43,22,18,21,4,23,81,28.4,58,31,9,22,36,24,4
956,Federico Gatti,33,19,16,16,1,19,24,79.2,5,26,15,11,19,90,1
957,Federico Gattoni,1,0,1,0,0,1,1,100.0,0,0,0,0,0,1,0
958,Gavi,39,21,20,14,5,18,36,50.0,18,19,3,16,8,16,1
959,Paulo Gazzaniga,2,2,2,0,0,2,4,50.0,2,0,0,0,0,12,1
960,Yann Gboho,14,4,6,6,2,8,23,34.8,15,21,1,20,4,2,0
961,Dennis Geiger,1,0,1,0,0,0,0,,0,1,1,0,0,0,0
962,Gelabert,14,8,5,6,3,7,20,35.0,13,8,2,6,5,8,0
963,Francesco Gelli,19,13,8,4,7,10,24,41.7,14,19,3,16,11,27,1
964,Luca Gemello,0,0,0,0,0,0,1,0.0,1,0,0,0,0,1,1
965,Valentin Gendrey,55,33,35,16,4,30,46,65.2,16,40,11,29,35,99,0
966,Denis Genreau,12,9,6,6,0,8,15,53.3,7,8,1,7,6,8,0
967,Yannick Gerhardt,31,20,16,12,3,9,32,28.1,23,15,2,13,7,35,0
968,Anwar El Ghazi,0,0,0,0,0,0,1,0.0,1,0,0,0,0,0,0
969,Farés Ghedjemis,2,0,1,0,1,0,2,0.0,2,2,0,2,1,2,0
970,Saman Ghoddos,28,19,19,7,2,17,31,54.8,14,9,2,7,5,12,0
971,Lautaro Gianetti,9,4,7,2,0,4,5,80.0,1,10,6,4,19,39,0
972,Morgan Gibbs-White,36,24,6,20,10,14,33,42.4,19,31,8,23,17,21,0
973,Samuel Gigot,33,22,16,13,4,13,19,68.4,6,28,18,10,25,93,1
974,Bryan Gil,1,0,0,0,1,1,4,25.0,3,3,0,3,3,4,0
975,David Gil,0,0,0,0,0,0,1,0.0,1,0,0,0,0,3,0
976,Mario Gila,32,14,23,8,1,19,34,55.9,15,27,14,13,20,69,0
977,Alfie Gilchrist,4,0,4,0,0,2,5,40.0,3,6,3,3,3,11,0
978,Billy Gilmour,26,16,14,10,2,11,35,31.4,24,23,9,14,11,14,1
979,Benedikt Gimber,40,24,25,14,1,19,35,54.3,16,27,17,10,16,101,1
980,Gvidas Gineitis,11,7,3,8,0,4,7,57.1,3,10,4,6,4,9,1
981,Matthias Ginter,29,15,19,9,1,16,29,55.2,13,40,26,14,16,93,0
982,Olivier Giroud,17,11,6,6,5,2,14,14.3,12,14,3,11,6,22,0
983,Klaus Gjasula,44,22,18,25,1,17,30,56.7,13,26,14,12,19,42,2
984,Serge Gnabry,8,5,0,5,3,2,13,15.4,11,5,0,5,3,2,0
985,Ben Godfrey,30,20,17,8,5,15,28,53.6,13,14,8,6,16,57,0
986,Edoardo Goldaniga,12,7,9,3,0,4,10,40.0,6,11,7,4,15,37,1
987,Pierluigi Gollini,1,1,1,0,0,1,1,100.0,0,0,0,0,1,2,0
988,Aleksandr Golovin,42,30,14,22,6,15,42,35.7,27,37,3,34,21,14,0
989,André Gomes,7,4,2,3,2,3,13,23.1,10,10,1,9,3,4,1
990,Angel Gomes,26,13,4,15,7,14,32,43.8,18,23,6,17,18,28,1
991,João Gomes,128,74,67,49,12,44,99,44.4,55,51,8,43,18,29,2
992,Toti Gomes,44,25,32,8,4,24,37,64.9,13,40,19,21,26,93,2
993,Joe Gomez,47,31,24,16,7,30,63,47.6,33,26,4,22,19,50,2
994,Maxi Gómez,6,4,2,3,1,3,5,60.0,2,8,3,5,3,3,0
995,Moi Gómez,30,19,7,19,4,9,24,37.5,15,15,1,14,11,22,0
996,Papu Gómez,0,0,0,0,0,0,2,0.0,2,0,0,0,1,0,0
997,Sergio Gómez,1,0,0,1,0,1,2,50.0,1,0,0,0,1,0,0
998,Unai Gómez,12,10,2,6,4,5,10,50.0,5,13,2,11,2,9,0
999,Iron Gomis,4,1,2,2,0,0,1,0.0,1,2,0,2,2,2,0
1000,Maxime Gonalons,47,33,14,27,6,25,57,43.9,32,18,3,15,20,11,0
1001,Édgar González,45,21,22,20,3,25,49,51.0,24,48,28,20,38,130,3
1002,Enso Gonzalez,0,0,0,0,0,0,1,0.0,1,0,0,0,0,0,0
1003,Fabio González,2,2,2,0,0,1,2,50.0,1,2,0,2,0,0,0
1004,Giovanni González,73,45,37,32,4,40,81,49.4,41,24,3,21,31,60,2
1005,Hugo González,2,1,0,2,0,0,0,,0,0,0,0,0,0,0
1006,Iñaki González,1,0,1,0,0,0,0,,0,0,0,0,0,1,0
1007,Joan Gonzàlez,31,18,16,12,3,17,28,60.7,11,20,3,17,5,9,0
1008,Nicolás González,28,18,15,8,5,8,28,28.6,20,26,1,25,12,9,0
1009,Peter González,5,3,3,1,1,1,10,10.0,9,11,0,11,7,10,0
1010,Urko González,4,1,0,3,1,2,2,100.0,0,1,0,1,1,6,0
1011,Anthony Gordon,55,34,16,28,11,22,64,34.4,42,27,0,27,7,7,0
1012,Kaide Gordon,0,0,0,0,0,0,0,,0,0,0,0,0,0,0
1013,Daniel Gore,1,1,0,1,0,1,1,100.0,0,0,0,0,1,0,0
1014,Leon Goretzka,41,23,18,14,9,24,54,44.4,30,44,8,36,31,42,1
1015,Mathieu Gorgelin,0,0,0,0,0,0,0,,0,0,0,0,0,0,0
1016,Andoni Gorosabel,62,42,40,17,5,38,75,50.7,37,24,8,16,28,69,0
1017,Robin Gosens,63,44,25,31,7,30,44,68.2,14,52,9,43,36,75,0
1018,Mario Götze,51,34,18,25,8,28,62,45.2,34,19,3,16,14,10,0
1019,Amine Gouiri,20,10,4,11,5,8,19,42.1,11,18,1,17,14,12,0
1020,Jeffrey Gouweleeuw,35,23,13,17,5,16,25,64.0,9,44,24,20,35,108,0
1021,Pablo Gozalbez,1,0,0,0,1,1,6,16.7,5,0,0,0,1,2,0
1022,Jonathan Gradit,32,20,15,14,3,19,35,54.3,16,30,17,13,37,61,0
1023,Jens Grahl,0,0,0,0,0,0,0,,0,0,0,0,0,3,0
1024,Samuel Grandsir,16,12,5,9,2,8,18,44.4,10,4,0,4,3,3,1
1025,Alberto Grassi,30,18,13,13,4,10,26,38.5,16,26,11,15,41,37,0
1026,Ryan Gravenberch,26,12,5,13,8,12,29,41.4,17,20,2,18,14,11,0
1027,Ryan Gravenberch,0,0,0,0,0,0,0,,0,0,0,0,0,0,0
1028,Adrian Grbić,0,0,0,0,0,0,0,,0,0,0,0,0,0,0
1029,Ivo Grbić,0,0,0,0,0,0,1,0.0,1,1,0,1,0,9,1
1030,Jack Grealish,13,8,6,7,0,6,12,50.0,6,13,2,11,6,5,0
1031,Mason Greenwood,11,6,3,5,3,4,21,19.0,17,9,0,9,4,4,0
1032,Michael Gregoritsch,16,12,8,5,3,2,14,14.3,12,17,4,13,9,27,0
1033,Dominik Greif,0,0,0,0,0,0,0,,0,0,0,0,0,0,0
1034,Antoine Griezmann,33,19,14,14,5,15,41,36.6,26,34,3,31,10,23,1
1035,Vincenzo Grifo,31,20,14,11,6,14,31,45.2,17,22,1,21,15,20,0
1036,Florian Grillitsch,54,28,31,19,4,22,54,40.7,32,41,20,21,52,90,2
1037,Álex Grimaldo,45,24,26,10,9,30,55,54.5,25,32,7,25,22,41,0
1038,Christian Groß,21,16,11,9,1,11,25,44.0,14,17,6,11,13,28,1
1039,Pascal Groß,70,46,33,21,16,31,72,43.1,41,41,8,33,22,32,3
1040,Brajan Gruda,22,14,5,11,6,14,24,58.3,10,15,0,15,5,4,0
1041,Ilia Gruev,0,0,0,0,0,0,0,,0,0,0,0,0,0,0
1042,Vicente Guaita,1,1,1,0,0,1,2,50.0,1,0,0,0,0,9,1
1043,Andrés Guardado,17,12,5,9,3,7,14,50.0,7,4,2,2,6,5,0
1044,Sergi Guardiola,10,7,2,6,2,4,9,44.4,5,10,0,10,0,4,0
1045,Nemanja Gudelj,31,24,18,10,3,17,31,54.8,14,17,9,8,27,56,0
1046,Gabriel Gudmundsson,22,16,7,13,2,12,20,60.0,8,14,3,11,15,25,0
1047,Gonçalo Guedes,6,4,1,2,3,2,7,28.6,5,8,0,8,2,3,0
1048,Axel Gueguin,9,5,6,2,1,2,6,33.3,4,2,0,2,2,6,0
1049,Marc Guéhi,28,19,21,7,0,14,24,58.3,10,22,17,5,18,89,1
1050,Mattéo Guendouzi,34,15,11,18,5,21,49,42.9,28,24,6,18,21,24,1
1051,Mattéo Guendouzi,0,0,0,0,0,0,0,,0,1,1,0,0,0,0
1052,Javier Guerra,54,24,25,22,7,22,58,37.9,36,27,7,20,18,44,0
1053,Raphaël Guerreiro,19,16,6,9,4,9,15,60.0,6,7,1,6,15,5,1
1054,Axel Guessand,1,1,0,1,0,1,1,100.0,0,1,0,1,0,0,0
1055,Evann Guessand,16,7,2,7,7,6,7,85.7,1,12,1,11,12,7,0
1056,Ander Guevara,59,32,28,25,6,31,64,48.4,33,34,12,22,13,46,1
1057,Pape Gueye,33,21,11,19,3,13,19,68.4,6,17,3,14,13,12,0
1058,Josuha Guilavogui,15,10,10,5,0,6,7,85.7,1,13,7,6,13,21,0
1059,Morgan Guilavogui,21,10,4,12,5,5,11,45.5,6,11,2,9,4,7,0
1060,Frederic Guilbert,87,50,49,30,8,47,72,65.3,25,39,10,29,71,99,1
1061,Hugo Guillamón,24,15,7,14,3,11,17,64.7,6,8,3,5,12,25,2
1062,Bruno Guimarães,88,53,45,32,11,40,77,51.9,37,52,14,38,35,20,0
1063,Serhou Guirassy,6,3,1,4,1,2,5,40.0,3,8,1,7,6,29,0
1064,Marc Guiu,1,0,0,1,0,0,0,,0,0,0,0,0,0,0
1065,Péter Gulácsi,0,0,0,0,0,0,0,,0,0,0,0,0,8,1
1066,Manuel Gulde,37,23,23,13,1,17,23,73.9,6,24,14,10,25,82,0
1067,Arda Güler,6,4,1,3,2,5,8,62.5,3,0,0,0,2,5,0
1068,Gerard Gumbau,55,34,21,30,4,23,62,37.1,39,24,5,19,25,30,2
1069,Robert Gumny,6,5,1,3,2,1,5,20.0,4,13,5,8,7,15,0
1070,İlkay Gündoğan,32,22,14,16,2,12,39,30.8,27,19,4,15,21,18,1
1071,Christian Günter,20,12,9,11,0,7,18,38.9,11,9,3,6,2,16,0
1072,Jon Guridi,42,24,10,27,5,12,45,26.7,33,23,3,20,22,22,0
1073,Gorka Guruzeta,34,23,6,25,3,9,30,30.0,21,36,2,34,17,23,0
1074,Malo Gusto,55,27,34,15,6,35,52,67.3,17,28,4,24,17,43,1
1075,Miguel Gutiérrez,29,18,11,14,4,13,35,37.1,22,27,11,16,22,66,2
1076,Albert Guðmundsson,23,10,8,10,5,12,44,27.3,32,15,2,13,11,13,0
1077,Joško Gvardiol,55,33,21,24,10,21,38,55.3,17,36,12,24,27,37,3
1078,Emmanuel Gyasi,34,17,18,13,3,15,32,46.9,17,30,12,18,5,27,1
1079,Norbert Gyömbér,36,18,30,6,0,20,26,76.9,6,33,23,10,23,77,2
1080,Erling Haaland,6,3,0,3,3,2,3,66.7,1,11,1,10,2,16,0
1081,Nicolas Haas,5,3,1,2,2,3,3,100.0,0,1,0,1,1,1,0
1082,Janik Haberer,36,24,16,13,7,22,45,48.9,23,21,4,17,12,18,0
1083,Robin Hack,15,8,6,7,2,4,17,23.5,13,16,0,16,14,21,0
1084,Antwoine Hackford,0,0,0,0,0,0,0,,0,0,0,0,0,0,0
1085,Munir El Haddadi,40,27,18,17,5,17,38,44.7,21,27,1,26,11,16,0
1086,Jaouen Hadjam,6,4,5,1,0,1,2,50.0,1,0,0,0,3,2,0
1087,Ianis Hagi,17,12,2,14,1,5,12,41.7,7,8,0,8,5,4,0
1088,Amadou Haidara,42,27,24,16,2,23,41,56.1,18,28,6,22,21,37,0
1089,Massadio Haïdara,9,8,5,3,1,4,6,66.7,2,7,2,5,11,32,3
1090,Oualid El Hajjam,8,7,5,2,1,2,9,22.2,7,5,1,4,6,10,0
1091,Achraf Hakimi,29,19,14,9,6,17,34,50.0,17,28,4,24,12,28,2
1092,Lewis Hall,28,18,17,10,1,17,28,60.7,11,17,2,15,12,22,1
1093,Sébastien Haller,1,0,0,1,0,1,1,100.0,0,4,1,3,0,7,0
1094,Gustavo Hamer,39,21,17,15,7,16,59,27.1,43,33,9,24,29,35,0
1095,Andreas Hanche-Olsen,20,12,10,8,2,10,16,62.5,6,10,4,6,11,41,0
1096,Isak Hansen-Aarøen,0,0,0,0,0,0,1,0.0,1,1,0,1,1,0,0
1097,Ridgeciano Haps,7,6,3,2,2,5,8,62.5,3,3,0,3,6,11,1
1098,Genki Haraguchi,1,1,1,0,0,0,0,,0,0,0,0,0,1,0
1099,Amine Harit,28,16,8,17,3,13,37,35.1,24,31,4,27,12,4,0
1100,Luke Harris,1,1,1,0,0,0,1,0.0,1,0,0,0,0,0,0
1101,Jack Harrison,37,22,12,12,13,17,49,34.7,32,25,5,20,12,24,0
1102,Abdou Harroui,23,11,11,11,1,8,16,50.0,8,19,3,16,5,8,0
1103,Makoto Hasebe,4,2,2,2,0,3,6,50.0,3,2,1,1,2,5,0
1104,Daiki Hashioka,11,5,6,4,1,5,11,45.5,6,12,7,5,8,20,0
1105,Hans Hateboer,12,5,8,2,2,5,15,33.3,10,21,7,14,4,21,0
1106,Pantelis Hatzidiakos,22,10,12,10,0,10,17,58.8,7,14,5,9,13,30,1
1107,Kai Havertz,35,15,7,21,7,14,39,35.9,25,26,1,25,20,22,0
1108,Thorgan Hazard,0,0,0,0,0,0,0,,0,0,0,0,0,0,0
1109,Jan Paul van Hecke,47,26,25,19,3,27,45,60.0,18,49,27,22,30,76,4
1110,Hwang Hee-chan,20,10,11,8,1,9,24,37.5,15,19,1,18,10,9,0
1111,Silvan Hefti,6,1,2,3,1,4,7,57.1,3,2,0,2,0,1,0
1112,Silvan Hefti,21,15,10,7,4,15,29,51.7,14,7,2,5,8,11,0
1113,Dominique Heintz,12,5,6,6,0,8,12,66.7,4,6,1,5,3,28,0
1114,Dean Henderson,1,1,1,0,0,1,2,50.0,1,0,0,0,0,8,2
1115,Liam Henderson,0,0,0,0,0,0,0,,0,0,0,0,0,0,0
1116,Benjamin Henrichs,68,39,32,26,10,27,58,46.6,31,49,4,45,33,37,0
1117,Henrique,10,6,6,4,0,6,11,54.5,5,8,2,6,10,3,0
1118,Luis Henrique,8,7,4,1,3,4,7,57.1,3,9,0,9,8,3,0
1119,Luiz Henrique,15,11,4,10,1,9,14,64.3,5,11,0,11,5,8,0
1120,Matheus Henrique,43,29,21,18,4,18,43,41.9,25,18,8,10,25,31,6
1121,Rico Henry,7,5,3,3,1,6,7,85.7,1,8,3,5,5,5,1
1122,Thomas Henry,0,0,0,0,0,0,0,,0,0,0,0,0,5,0
1123,Christophe Hérelle,32,15,24,7,1,13,23,56.5,10,16,9,7,18,68,2
1124,Mario Hermoso,46,25,29,13,4,28,51,54.9,23,27,9,18,30,93,0
1125,Javi Hernández,43,24,26,12,5,25,46,54.3,21,34,9,25,19,72,1
1126,Aridane Hernández,10,8,5,4,1,4,11,36.4,7,19,14,5,14,98,1
1127,Lucas Hernández,52,36,28,15,9,29,50,58.0,21,21,5,16,27,38,0
1128,Luis Hernández,7,3,4,3,0,4,8,50.0,4,3,2,1,8,25,0
1129,Theo Hernández,30,17,19,11,0,11,22,50.0,11,33,13,20,23,42,1
1130,Yarek Hernandis,22,12,14,5,3,13,19,68.4,6,15,8,7,15,50,1
1131,Jorge Herrando,29,19,23,6,0,12,19,63.2,7,20,11,9,15,69,1
1132,Ander Herrera,44,32,11,26,7,20,36,55.6,16,16,6,10,15,18,1
1133,Cristian Herrera,1,1,0,1,0,1,2,50.0,1,1,0,1,0,2,0
1134,Sergio Herrera,2,2,2,0,0,2,3,66.7,1,0,0,0,0,22,3
1135,Yangel Herrera,64,37,28,30,6,30,56,53.6,26,30,8,22,24,45,1
1136,Patrick Herrmann,4,4,2,1,1,2,2,100.0,0,1,0,1,1,2,0
1137,Juan Herzog,6,5,5,1,0,3,6,50.0,3,4,1,3,2,17,0
1138,Son Heung-min,21,13,6,7,8,10,21,47.6,11,4,1,3,8,4,0
1139,Aaron Hickey,16,9,9,3,4,7,7,100.0,0,7,3,4,3,10,0
1140,Isak Hien,17,10,10,7,0,10,19,52.6,9,12,5,7,7,33,1
1141,Isak Hien,18,12,8,10,0,7,15,46.7,8,12,5,7,14,33,0
1142,James Hill,3,2,1,2,0,1,1,100.0,0,3,2,1,3,8,0
1143,Piero Hincapié,35,22,14,17,4,13,17,76.5,4,18,7,11,13,43,0
1144,Jack Hinshelwood,14,5,7,4,3,5,13,38.5,8,6,2,4,14,18,0
1145,Adam Hložek,10,4,2,4,4,3,7,42.9,4,4,1,3,2,1,0
1146,Nicolas Höfler,63,40,36,20,7,22,49,44.9,27,30,16,14,31,45,0
1147,Jonas Hofmann,20,14,6,9,5,10,24,41.7,14,18,0,18,8,6,0
1148,Philipp Hofmann,10,5,4,5,1,4,7,57.1,3,11,2,9,4,17,0
1149,Lucas Höler,32,24,14,10,8,4,23,17.4,19,19,4,15,15,35,0
1150,Mason Holgate,12,7,5,6,1,5,12,41.7,7,12,5,7,11,40,0
1151,Fabian Holland,47,26,18,21,8,20,37,54.1,17,22,12,10,24,29,0
1152,Benedict Hollerbach,17,11,5,7,5,7,22,31.8,15,28,0,28,4,3,0
1153,Emil Holm,28,19,17,9,2,16,36,44.4,20,25,3,22,7,25,0
1154,Gerrit Holtmann,8,5,3,4,1,7,10,70.0,3,7,0,7,2,4,1
1155,Martin Hongla,24,13,9,13,2,8,11,72.7,3,8,3,5,7,24,0
1156,Martin Hongla,7,3,2,5,0,3,9,33.3,6,6,3,3,6,13,1
1157,Franck Honorat,25,13,13,10,2,11,20,55.0,9,22,3,19,9,35,1
1158,Mathias Honsak,14,7,7,6,1,6,20,30.0,14,14,2,12,8,25,0
1159,Sydney van Hooijdonk,3,0,0,2,1,1,2,50.0,1,1,1,0,1,4,0
1160,Fraser Hornby,0,0,0,0,0,0,1,0.0,1,2,1,1,0,4,0
1161,Lukáš Hrádecký,0,0,0,0,0,0,1,0.0,1,1,0,1,0,10,2
1162,Xabier Huarte Armendáriz,0,0,0,0,0,0,0,,0,0,0,0,0,0,0
1163,Timo Hübers,68,47,51,14,3,49,80,61.3,31,54,28,26,63,168,1
1164,Callum Hudson-Odoi,18,8,4,5,9,7,28,25.0,21,16,1,15,7,12,1
1165,Will Hughes,61,33,30,20,11,24,48,50.0,24,36,14,22,21,25,0
1166,Dean Huijsen,10,5,5,5,0,1,4,25.0,3,7,4,3,4,26,2
1167,Dean Huijsen,0,0,0,0,0,0,0,,0,0,0,0,0,1,0
1168,Mats Hummels,52,34,34,12,6,30,53,56.6,23,33,11,22,33,82,0
1169,Denis Huseinbasic,38,18,17,15,6,20,31,64.5,11,26,1,25,13,14,0
1170,Elseid Hysaj,24,14,8,13,3,15,24,62.5,9,16,6,10,17,31,0
1171,Pierre Højbjerg,32,18,13,17,2,13,34,38.2,21,21,7,14,19,30,3
1172,Rasmus Højlund,11,7,2,3,6,5,13,38.5,8,9,1,8,1,19,0
1173,Iago,36,17,22,10,4,17,33,51.5,16,39,8,31,18,43,0
1174,Pablo Ibáñez,18,9,5,7,6,5,21,23.8,16,26,3,23,9,17,0
1175,Arijon Ibrahimović,7,6,4,2,1,1,9,11.1,8,4,0,4,1,3,0
1176,Iglesias,41,22,25,11,5,21,33,63.6,12,18,7,11,16,53,0
1177,Borja Iglesias,0,0,0,0,0,0,3,0.0,3,0,0,0,2,2,0
1178,Borja Iglesias,1,0,0,1,0,0,1,0.0,1,2,0,2,1,1,0
1179,Igor,25,18,7,16,2,17,29,58.6,12,22,9,13,14,52,1
1180,Jonathan Ikone,22,11,7,9,6,10,17,58.8,7,12,0,12,3,8,0
1181,Chukwubuikem Ikwuemesi,3,1,0,2,1,2,6,33.3,4,1,1,0,1,8,0
1182,Andrej Ilic,0,0,0,0,0,0,0,,0,0,0,0,0,0,0
1183,Ivan Ilić,22,8,9,10,3,13,27,48.1,14,20,7,13,20,31,0
1184,Samuel Iling-Junior,23,13,9,11,3,11,18,61.1,7,17,5,12,6,19,0
1185,Imanol,7,5,1,5,1,5,18,27.8,13,6,0,6,7,15,0
1186,Joel Imasuen,0,0,0,0,0,0,0,,0,0,0,0,0,0,0
1187,Ciro Immobile,11,9,2,5,4,3,14,21.4,11,9,3,6,5,11,0
1188,Gino Infantino,1,1,0,1,0,0,1,0.0,1,4,0,4,3,1,0
1189,Danny Ings,6,2,0,6,0,4,13,30.8,9,4,1,3,3,7,0
1190,Bonke Innocent,6,4,2,2,2,2,9,22.2,7,2,1,1,4,2,0
1191,Tim Iroegbunam,7,5,4,2,1,4,9,44.4,5,3,0,3,2,3,0
1192,Alexander Isak,5,0,2,1,2,2,8,25.0,6,16,1,15,6,13,0
1193,Gustav Isaksen,4,3,2,1,1,1,9,11.1,8,11,1,10,4,4,0
1194,Isco,41,27,15,21,5,14,38,36.8,24,19,1,18,10,7,0
1195,Thomas Isherwood,11,5,7,3,1,5,9,55.6,4,10,7,3,10,34,0
1196,Ismaily,72,47,34,25,13,31,60,51.7,29,33,6,27,32,77,0
1197,Ardian Ismajli,26,16,18,6,2,18,23,78.3,5,28,17,11,23,126,1
1198,Yanis Issoufou,0,0,0,0,0,0,0,,0,0,0,0,0,0,0
1199,Ko Itakura,34,21,17,15,2,16,26,61.5,10,32,18,14,22,62,0
1200,Hiroki Ito,19,18,13,6,0,11,26,42.3,15,29,17,12,29,86,2
1201,Junya Ito,33,15,11,14,8,10,36,27.8,26,23,1,22,14,7,0
1202,Diego Iturralde,0,0,0,0,0,0,0,,0,1,1,0,0,2,0
1203,Alex Iwobi,2,0,1,0,1,2,3,66.7,1,2,0,2,1,0,0
1204,Alex Iwobi,29,18,12,15,2,12,25,48.0,13,16,0,16,14,9,0
1205,Armando Izzo,27,17,17,9,1,16,27,59.3,11,20,16,4,27,49,1
1206,Nicolas Jackson,21,13,5,8,8,5,24,20.8,19,20,5,15,4,17,0
1207,Jérémy Jacquet,1,1,1,0,0,0,1,0.0,1,0,0,0,1,0,0
1208,Jérémy Jacquet,4,3,4,0,0,3,3,100.0,0,7,3,4,6,10,0
1209,Lee Jae-sung,33,20,11,16,6,13,39,33.3,26,22,2,20,27,23,0
1210,Paul Jaeckel,7,2,4,3,0,5,9,55.6,4,3,2,1,4,7,0
1211,Filip Jagiełło,0,0,0,0,0,0,1,0.0,1,1,1,0,1,0,0
1212,Kristijan Jakić,28,14,14,10,4,15,33,45.5,18,13,1,12,20,15,0
1213,Kristijan Jakić,3,3,1,2,0,1,3,33.3,2,1,0,1,2,2,0
1214,Ismail Jakobs,57,41,27,21,9,29,47,61.7,18,19,2,17,11,40,0
1215,Ablie Jallow,8,5,2,3,3,3,5,60.0,2,4,0,4,8,3,0
1216,Reece James,14,9,10,3,1,8,10,80.0,2,4,4,0,3,7,1
1217,Vitaly Janelt,63,38,29,25,9,32,64,50.0,32,35,9,26,36,64,3
1218,Jakub Jankto,12,9,9,1,2,8,20,40.0,12,5,1,4,5,20,0
1219,Tony Jantschke,1,1,1,0,0,1,1,100.0,0,2,2,0,1,4,0
1220,Adnan Januzaj,3,3,2,0,1,0,1,0.0,1,2,0,2,1,0,0
1221,Nuha Jatta,0,0,0,0,0,0,0,,0,0,0,0,0,0,0
1222,Mikel Jauregizar,0,0,0,0,0,0,6,0.0,6,5,0,5,0,2,0
1223,Luis Javier Suárez,7,5,2,5,0,2,6,33.3,4,11,0,11,0,13,0
1224,Danley Jean-Jacques,54,28,24,21,9,19,56,33.9,37,48,7,41,44,44,0
1225,Salim El Jebari,1,0,0,1,0,0,0,,0,0,0,0,0,1,0
1226,Daniel Jebbison,0,0,0,0,0,0,0,,0,1,0,1,0,0,0
1227,Jeffinho,11,4,3,5,3,4,11,36.4,7,1,0,1,0,0,0
1228,Fredrik Jensen,23,11,9,8,6,14,28,50.0,14,30,1,29,12,21,0
1229,Mathias Jensen,54,32,25,22,7,26,95,27.4,69,41,6,35,23,25,1
1230,Moritz Jenz,34,24,21,11,2,14,21,66.7,7,29,17,12,26,94,0
1231,Gabriel Jesus,24,17,11,5,8,5,18,27.8,13,23,1,22,13,12,0
1232,Juan Jesus,42,19,28,12,2,23,33,69.7,10,23,12,11,23,67,1
1233,Alejandro Jiménez,2,1,2,0,0,2,5,40.0,3,0,0,0,0,4,0
1234,Raúl Jiménez,18,12,4,8,6,7,20,35.0,13,11,3,8,4,13,0
1235,João Pedro,31,14,10,13,8,14,24,58.3,10,15,2,13,11,28,0
1236,Joelinton,39,27,21,15,3,14,38,36.8,24,23,7,16,19,11,1
1237,Ryan John Giles,8,6,4,3,1,2,7,28.6,5,2,0,2,4,22,0
1238,Ben Johnson,11,7,7,3,1,9,14,64.3,5,2,1,1,5,14,0
1239,Brennan Johnson,26,15,14,5,7,12,31,38.7,19,37,1,36,10,12,1
1240,Brennan Johnson,4,1,1,1,2,2,4,50.0,2,4,1,3,0,0,0
1241,Joseph Johnson,0,0,0,0,0,0,1,0.0,1,0,0,0,0,0,0
1242,Sam Johnstone,1,0,1,0,0,1,1,100.0,0,0,0,0,1,5,0
1243,Curtis Jones,27,14,12,12,3,10,23,43.5,13,22,0,22,7,8,0
1244,Frenkie de Jong,43,26,14,23,6,8,19,42.1,11,18,8,10,14,28,1
1245,Joan Jordán,8,7,3,3,2,7,15,46.7,8,4,2,2,4,2,0
1246,Jordi,16,11,3,11,2,7,15,46.7,8,7,2,5,8,7,0
1247,Jeremy Jorge,0,0,0,0,0,0,0,,0,0,0,0,0,0,0
1248,Kaio Jorge,6,4,0,1,5,3,4,75.0,1,6,0,6,1,0,0
1249,Jorginho,24,10,6,10,8,11,23,47.8,12,17,1,16,12,7,1
1250,Willian José,7,3,1,2,4,2,5,40.0,3,8,2,6,2,15,0
1251,Joselu,6,3,1,4,1,0,7,0.0,7,11,1,10,6,11,0
1252,Diogo Jota,23,13,6,13,4,10,23,43.5,13,9,1,8,7,4,0
1253,Antoine Joujou,20,12,7,7,6,11,21,52.4,10,11,2,9,7,5,0
1254,Luka Jović,6,4,0,3,3,4,6,66.7,2,3,0,3,1,9,0
1255,Kamil Jóźwiak,13,10,4,6,3,9,17,52.9,8,4,0,4,2,6,0
1256,Juanmi,9,4,2,7,0,2,9,22.2,7,6,0,6,6,3,0
1257,Juanpe,11,8,8,3,0,9,10,90.0,1,17,11,6,7,50,1
1258,Mads Juel Andersen,6,5,4,2,0,4,4,100.0,0,9,6,3,8,29,0
1259,Christopher Jullien,16,12,11,5,0,6,17,35.3,11,25,20,5,12,106,2
1260,Anthony Jung,37,23,21,14,2,18,33,54.5,15,39,17,22,24,102,0
1261,Eli Junior Kroupi,7,4,2,2,3,1,9,11.1,8,6,0,6,10,5,0
1262,Hamed Junior Traorè,1,0,1,0,0,1,3,33.3,2,3,0,3,0,0,0
1263,Hamed Junior Traorè,4,2,2,0,2,1,6,16.7,5,3,0,3,2,1,1
1264,Vinicius Júnior,18,13,5,5,8,3,12,25.0,9,13,0,13,1,3,2
1265,Josip Juranović,20,14,11,7,2,10,21,47.6,11,17,3,14,12,27,1
1266,David Jurásek,14,11,13,1,0,7,17,41.2,10,7,2,5,3,22,1
1267,Julian Justvan,1,0,1,0,0,1,2,50.0,1,1,0,1,0,0,0
1268,Julian Justvan,10,4,2,7,1,3,17,17.6,14,12,2,10,11,6,1
1269,Filip Jørgensen,3,1,3,0,0,3,4,75.0,1,0,0,0,2,10,3
1270,Mathias Jørgensen,17,12,15,1,1,11,19,57.9,8,9,5,4,12,40,0
1271,Mohamed Kaba,39,23,15,16,8,17,34,50.0,17,22,4,18,12,13,0
1272,Sory Kaba,2,0,0,2,0,0,5,0.0,5,6,0,6,0,9,0
1273,Ozan Kabak,48,35,32,14,2,19,33,57.6,14,43,21,22,46,106,2
1274,Christian Kabasele,10,7,4,5,1,2,11,18.2,9,15,9,6,12,56,0
1275,Issa Kaboré,52,28,23,21,8,24,45,53.3,21,22,11,11,16,56,2
1276,Abdoul Kader Bamba,10,7,2,5,3,5,15,33.3,10,4,0,4,4,4,1
1277,Yaya Kader Fofana,3,3,1,1,1,0,1,0.0,1,0,0,0,1,0,0
1278,Pavel Kadeřábek,31,19,10,15,6,18,40,45.0,22,22,8,14,23,68,0
1279,Tino Kadewere,1,1,0,1,0,1,5,20.0,4,3,1,2,5,7,0
1280,Tino Kadewere,9,4,3,3,3,6,11,54.5,5,10,1,9,10,8,0
1281,Kaiky,7,4,6,0,1,3,6,50.0,3,9,7,2,3,29,1
1282,Florian Kainz,28,20,8,13,7,17,39,43.6,22,20,6,14,13,23,1
1283,Sasa Kalajdzic,6,2,3,2,1,1,2,50.0,1,3,0,3,1,6,0
1284,Sasa Kalajdzic,2,2,0,2,0,0,0,,0,2,2,0,2,6,0
1285,Arnaud Kalimuendo,5,4,2,2,1,2,5,40.0,3,13,2,11,4,4,0
1286,Yayah Kallon,0,0,0,0,0,0,0,,0,0,0,0,0,0,0
1287,Gedeon Kalulu,23,17,13,8,2,12,22,54.5,10,18,2,16,5,30,0
1288,Pierre Kalulu,5,1,2,3,0,1,2,50.0,1,4,3,1,1,12,1
1289,Daichi Kamada,53,36,22,22,9,28,52,53.8,24,24,5,19,18,7,0
1290,Waren Kamanzi,36,24,16,16,4,13,23,56.5,10,11,3,8,9,35,0
1291,Boubacar Kamara,43,29,16,21,6,24,47,51.1,23,21,7,14,21,16,0
1292,Hassane Kamara,45,32,26,13,6,25,38,65.8,13,29,2,27,26,66,0
1293,Willy Kambwala,3,1,1,2,0,1,3,33.3,2,6,3,3,4,14,1
1294,Jakub Kamiński,14,5,12,2,0,3,6,50.0,3,3,0,3,2,5,0
1295,Thomas Kaminski,2,1,2,0,0,2,6,33.3,4,1,0,1,0,14,2
1296,Kevin Kampl,19,8,8,9,2,10,21,47.6,11,19,7,12,11,14,1
1297,Harry Kane,13,9,4,4,5,6,18,33.3,12,12,4,8,6,14,0
1298,Lee Kang-in,26,13,7,9,10,15,36,41.7,21,7,0,7,6,3,0
1299,Yann Karamoh,1,0,0,0,1,0,0,,0,0,0,0,0,1,0
1300,Yann Karamoh,1,0,0,0,1,1,2,50.0,1,3,0,3,0,0,0
1301,Atakan Karazor,72,44,23,38,11,29,60,48.3,31,37,8,29,27,43,0
1302,Ayman Kari,18,14,9,9,0,12,19,63.2,7,19,2,17,6,9,1
1303,Emir Karic,45,27,23,14,8,21,33,63.6,12,42,11,31,13,43,0
1304,Loris Karius,0,0,0,0,0,0,0,,0,0,0,0,0,1,0
1305,Jesper Karlsson,3,3,2,1,0,2,8,25.0,6,4,0,4,4,1,0
1306,Jon Karrikaburu,0,0,0,0,0,0,0,,0,0,0,0,0,0,0
1307,Rick Karsdorp,25,18,11,8,6,16,24,66.7,8,13,4,9,9,16,0
1308,Grigoris Kastanos,23,14,8,9,6,9,20,45.0,11,13,4,9,8,9,0
1309,Silas Katompa,5,3,3,2,0,3,12,25.0,9,9,0,9,0,4,0
1310,Panos Katseris,26,20,16,8,2,16,25,64.0,9,20,4,16,8,18,0
1311,Mikkel Kaufmann,6,3,2,3,1,3,10,30.0,7,12,0,12,1,4,0
1312,Michael Kayode,53,30,27,15,11,35,48,72.9,13,25,12,13,18,46,2
1313,Moise Kean,7,4,3,2,2,1,3,33.3,2,4,1,3,2,5,0
1314,Michael Keane,7,3,3,3,1,1,7,14.3,6,5,4,1,5,18,1
1315,Ibrahima Kebe,1,1,0,1,0,0,0,,0,1,0,1,1,0,0
1316,Kévin Keben Biakolo,4,2,4,0,0,3,6,50.0,3,7,0,7,8,17,0
1317,Yassine Kechta,46,24,24,19,3,31,73,42.5,42,20,3,17,23,16,1
1318,Thilo Kehrer,1,1,0,1,0,0,0,,0,2,2,0,0,0,0
1319,Thilo Kehrer,32,22,22,7,3,22,39,56.4,17,18,6,12,30,55,0
1320,Habib Keita,34,19,14,15,5,17,28,60.7,11,27,10,17,29,30,0
1321,Naby Keïta,1,1,1,0,0,0,1,0.0,1,2,0,2,2,1,0
1322,Yannik Keitel,20,15,14,5,1,10,15,66.7,5,17,8,9,12,44,3
1323,Caoimhín Kelleher,0,0,0,0,0,0,0,,0,0,0,0,0,4,1
1324,Thomas Keller,0,0,0,0,0,0,0,,0,0,0,0,0,0,0
1325,Lloyd Kelly,24,19,10,9,5,14,25,56.0,11,22,12,10,13,67,0
1326,Omari Kellyman,1,0,0,1,0,1,2,50.0,1,0,0,0,0,0,0
1327,Aljoscha Kemlein,0,0,0,0,0,0,3,0.0,3,1,0,1,0,0,0
1328,Tobias Kempe,20,13,9,8,3,8,24,33.3,16,16,4,12,9,12,0
1329,Milos Kerkez,47,26,31,13,3,30,42,71.4,12,31,11,20,20,60,2
1330,Kaine Kesler-Hayden,0,0,0,0,0,0,0,,0,0,0,0,0,0,0
1331,Reda Khadra,16,10,5,4,7,8,20,40.0,12,8,2,6,3,13,0
1332,Wahbi Khazri,24,17,8,12,4,14,35,40.0,21,10,0,10,3,7,0
1333,Rani Khedira,35,22,15,19,1,17,26,65.4,9,12,5,7,22,38,0
1334,Kiké,8,4,2,3,3,4,9,44.4,5,16,5,11,1,12,0
1335,Luca Kilian,16,9,15,1,0,9,14,64.3,5,12,5,7,7,28,0
1336,Max Kilman,47,21,40,6,1,24,32,75.0,8,64,37,27,39,182,4
1337,Joshua Kimmich,45,33,25,15,5,26,39,66.7,13,32,4,28,14,28,1
1338,Jakub Kiwior,20,12,11,8,1,14,19,73.7,5,11,3,8,8,28,1
1339,Simon Kjær,24,15,11,11,2,14,22,63.6,8,22,16,6,14,46,2
1340,Davy Klaassen,4,2,0,4,0,1,3,33.3,2,5,1,4,3,4,0
1341,Christoph Klarer,37,22,30,4,3,24,36,66.7,12,31,20,11,21,94,1
1342,Tim Kleindienst,21,12,6,11,4,7,25,28.0,18,32,8,24,12,58,0
1343,Lukas Klostermann,15,10,7,7,1,4,13,30.8,9,25,12,13,13,64,1
1344,Justin Kluivert,28,14,5,12,11,8,30,26.7,22,16,1,15,8,11,0
1345,Ansgar Knauff,43,26,17,16,10,17,31,54.8,14,40,3,37,20,15,0
1346,Robin Knoche,34,22,27,7,0,19,30,63.3,11,27,19,8,13,73,0
1347,Gregor Kobel,0,0,0,0,0,0,1,0.0,1,0,0,0,0,11,0
1348,Robin Koch,38,23,26,12,0,17,27,63.0,10,33,24,9,32,136,2
1349,Philipp Köhn,1,1,1,0,0,1,1,100.0,0,0,0,0,1,5,3
1350,Dominik Kohr,65,42,36,25,4,36,57,63.2,21,27,6,21,43,58,0
1351,Koke,66,44,27,32,7,36,79,45.6,43,37,12,25,16,34,1
1352,Sead Kolašinac,44,32,23,19,2,30,49,61.2,19,22,9,13,21,47,0
1353,Luca Koleosho,7,4,2,5,0,2,10,20.0,8,13,0,13,2,0,0
1354,Randal Kolo Muani,10,8,5,3,2,5,13,38.5,8,5,0,5,4,10,0
1355,Randal Kolo Muani,0,0,0,0,0,0,0,,0,0,0,0,0,1,0
1356,Mert Kömür,3,3,3,0,0,3,5,60.0,2,0,0,0,0,1,0
1357,Cheick Konaté,26,15,17,9,0,20,36,55.6,16,16,2,14,13,21,0
1358,Ibrahima Konaté,36,22,22,13,1,18,24,75.0,6,18,12,6,20,51,1
1359,Geoffrey Kondogbia,48,31,18,25,5,13,32,40.6,19,21,4,17,30,25,0
1360,Abdoul Koné,7,7,5,2,0,4,11,36.4,7,2,0,2,2,9,0
1361,Amadou Koné,13,8,11,2,0,6,10,60.0,4,8,3,5,10,10,0
1362,Ibrahima Koné,1,0,1,0,0,1,1,100.0,0,1,0,1,0,4,0
1363,Ibrahima Koné,0,0,0,0,0,0,1,0.0,1,0,0,0,0,0,0
1364,Manu Koné,45,26,20,20,5,17,25,68.0,8,22,1,21,15,16,1
1365,Ezri Konsa,54,32,28,23,3,23,27,85.2,4,36,20,16,28,73,3
1366,Teun Koopmeiners,39,24,12,22,5,17,50,34.0,33,33,3,30,10,35,0
1367,Odilon Kossonou,30,20,11,12,7,15,26,57.7,11,27,3,24,27,43,1
1368,Filip Kostić,37,23,20,13,4,17,33,51.5,16,29,8,21,9,43,0
1369,Christian Kouamé,13,4,7,6,0,6,10,60.0,4,16,0,16,2,10,0
1370,Rominigue Kouamé,14,9,6,7,1,7,15,46.7,8,10,2,8,13,10,1
1371,Koffi Kouao,20,13,12,7,1,11,17,64.7,6,9,6,3,13,38,1
1372,Tomáš Koubek,0,0,0,0,0,0,0,,0,0,0,0,0,1,1
1373,Therence Koudou,2,2,1,1,0,0,2,0.0,2,4,3,1,4,9,0
1374,Jules Koundé,37,23,22,10,5,28,51,54.9,23,32,12,20,25,83,5
1375,Boubakar Kouyaté,49,30,39,8,2,28,51,54.9,23,31,20,11,29,123,1
1376,Cheikhou Kouyaté,8,5,3,3,2,1,4,25.0,3,4,1,3,2,10,0
1377,Mateo Kovačić,36,25,16,15,5,18,28,64.3,10,23,1,22,10,10,0
1378,Viktor Kovalenko,5,2,2,2,1,2,8,25.0,6,12,2,10,1,7,0
1379,Matej Kovar,0,0,0,0,0,0,0,,0,0,0,0,0,0,0
1380,Dawid Kownacki,1,1,1,0,0,1,4,25.0,3,3,1,2,0,1,0
1381,Emil Krafth,21,14,10,7,4,12,25,48.0,13,8,3,5,9,21,0
1382,Alex Král,19,14,7,10,2,8,20,40.0,12,15,4,11,11,30,0
1383,Andrej Kramarić,11,2,5,4,2,6,13,46.2,7,14,2,12,10,12,2
1384,Christoph Kramer,10,5,5,5,0,2,14,14.3,12,7,1,6,4,6,0
1385,Frans Krätzig,2,0,2,0,0,1,2,50.0,1,0,0,0,0,0,0
1386,Tom Krauß,57,33,22,31,4,21,58,36.2,37,33,4,29,17,28,0
1387,Rasmus Kristensen,36,19,25,8,3,28,50,56.0,22,27,7,20,8,50,0
1388,Thomas Kristensen,35,24,25,10,0,21,33,63.6,12,29,20,9,29,118,0
1389,Toni Kroos,53,34,19,25,9,24,59,40.7,35,22,4,18,17,11,1
1390,Nikola Krstović,17,6,3,9,5,6,10,60.0,4,12,4,8,4,22,0
1391,Rade Krunić,10,8,3,6,1,4,9,44.4,5,7,3,4,11,14,0
1392,Lukas Kübler,50,24,35,13,2,26,42,61.9,16,36,14,22,37,57,1
1393,Takefusa Kubo,26,17,15,6,5,9,23,39.1,14,21,2,19,11,8,1
1394,Mahmut Kücüksahin,0,0,0,0,0,0,0,,0,0,0,0,0,0,0
1395,Mohammed Kudus,65,47,27,27,11,20,40,50.0,20,25,0,25,11,9,1
1396,Christian Kühlwetter,0,0,0,0,0,0,0,,0,0,0,0,0,0,0
1397,Dejan Kulusevski,62,33,19,20,23,25,67,37.3,42,24,1,23,18,2,1
1398,Sael Kumbedi,30,20,14,12,4,9,22,40.9,13,12,3,9,14,18,2
1399,Marash Kumbulla,3,2,2,1,0,1,2,50.0,1,8,6,2,0,22,0
1400,Justin Kumi,0,0,0,0,0,0,0,,0,0,0,0,0,0,0
1401,Layvin Kurzawa,0,0,0,0,0,0,0,,0,0,0,0,0,0,0
1402,Berkan Kutlu,6,4,5,1,0,3,6,50.0,3,3,0,3,4,5,0
1403,Daler Kuzyaev,34,19,11,13,10,15,43,34.9,28,18,5,13,22,18,1
1404,Khvicha Kvaratskhelia,42,21,11,19,12,15,49,30.6,34,15,1,14,13,9,0
1405,Giorgi Kvernadze,3,0,2,0,1,2,2,100.0,0,1,0,1,1,0,0
1406,Moritz-Broni Kwarteng,3,0,0,3,0,1,7,14.3,6,4,0,4,2,0,0
1407,Grejohn Kyei,6,4,2,2,2,2,3,66.7,1,5,1,4,1,10,0
1408,Giorgos Kyriakopoulos,19,10,16,3,0,11,24,45.8,13,18,1,17,13,28,0
1409,Luca de la Torre,39,21,12,22,5,22,43,51.2,21,23,4,19,12,17,0
1410,Gaëtan Laborde,18,12,8,4,6,11,30,36.7,19,20,2,18,6,8,1
1411,Alexandre Lacazette,19,12,8,9,2,5,17,29.4,12,22,3,19,8,9,0
1412,Maxence Lacroix,48,29,28,18,2,29,41,70.7,12,35,12,23,24,121,0
1413,Alban Lafont,0,0,0,0,0,0,2,0.0,2,0,0,0,0,14,0
1414,Yoel Lago,2,0,2,0,0,0,0,,0,1,0,1,0,2,0
1415,Aïssa Laïdouni,21,12,4,12,5,4,12,33.3,8,26,2,24,12,14,2
1416,Konrad Laimer,56,36,25,20,11,22,52,42.3,30,42,6,36,18,13,2
1417,Stefan Lainer,23,16,15,8,0,14,24,58.3,10,13,6,7,5,28,0
1418,Kenny Lala,78,51,39,28,11,30,56,53.6,26,27,6,21,28,75,1
1419,Adam Lallana,8,3,4,4,0,0,4,0.0,4,2,1,1,3,1,0
1420,Mathis Lambourde,0,0,0,0,0,0,1,0.0,1,1,0,1,0,1,0
1421,Érik Lamela,21,14,4,10,7,10,15,66.7,5,12,0,12,1,5,0
1422,Mohamed Lamine Bayo,13,5,2,5,6,2,10,20.0,8,8,1,7,2,11,0
1423,Didier Lamkel Zé,7,2,2,4,1,2,5,40.0,3,4,0,4,0,11,0
1424,Tariq Lamptey,21,14,14,5,2,13,22,59.1,9,7,3,4,6,6,0
1425,Bruno Langa,17,12,10,5,2,6,14,42.9,8,11,4,7,4,33,2
1426,Gianluca Lapadula,1,1,0,0,1,1,10,10.0,9,2,1,1,2,5,0
1427,Aymeric Laporte,0,0,0,0,0,0,0,,0,1,1,0,0,1,0
1428,Julien Laporte,23,14,15,7,1,16,36,44.4,20,36,26,10,11,116,1
1429,Cyle Larin,17,8,6,4,7,2,7,28.6,5,16,5,11,3,17,0
1430,Yasser Larouci,17,9,10,5,2,10,14,71.4,4,6,1,5,7,20,1
1431,Hugo Larsson,32,18,18,10,4,15,28,53.6,13,34,7,27,29,30,1
1432,Jamaal Lascelles,14,9,7,7,0,6,11,54.5,5,17,12,5,5,42,0
1433,Juanmi Latasa,9,7,0,6,3,1,11,9.1,10,9,0,9,4,21,0
1434,Toni Lato,38,23,19,13,6,16,27,59.3,11,17,3,14,17,27,0
1435,Armand Lauriente,31,20,8,14,9,13,44,29.5,31,29,4,25,15,11,0
1436,Roméo Lavia,1,0,0,1,0,0,0,,0,0,0,0,0,1,0
1437,Lázaro,4,1,2,0,2,2,8,25.0,6,4,0,4,1,1,0
1438,Valentino Lazaro,18,11,7,9,2,13,19,68.4,6,14,1,13,8,29,0
1439,Darko Lazović,26,16,11,6,9,16,31,51.6,15,10,1,9,6,14,0
1440,Manuel Lazzari,26,18,13,10,3,18,28,64.3,10,20,4,16,12,37,1
1441,Théo Le Bris,35,22,25,7,3,19,40,47.5,21,24,3,21,12,42,0
1442,Julien Le Cardinal,19,11,11,7,1,8,12,66.7,4,6,3,3,13,26,0
1443,Julien Le Cardinal,6,2,4,2,0,4,9,44.4,5,2,1,1,0,0,0
1444,Jérémy Le Douaron,21,10,7,9,5,11,26,42.3,15,14,1,13,2,10,0
1445,Enzo Le Fée,50,35,23,17,10,23,47,48.9,24,17,3,14,19,20,0
1446,Vincent Le Goff,5,0,4,0,1,4,8,50.0,4,11,3,8,3,10,0
1447,Robin Le Normand,31,22,16,15,0,17,30,56.7,13,26,15,11,28,96,1
1448,Nicola Leali,0,0,0,0,0,0,0,,0,0,0,0,0,0,0
1449,Rafael Leão,16,10,3,8,5,8,13,61.5,5,15,1,14,9,19,0
1450,Adrien Lebeau,0,0,0,0,0,0,3,0.0,3,2,1,1,0,1,0
1451,Jean-Louis Leca,0,0,0,0,0,0,0,,0,0,0,0,0,1,0
1452,Benjamin Lecomte,0,0,0,0,0,0,1,0.0,1,0,0,0,0,16,1
1453,Jeremías Ledesma,1,1,1,0,0,1,4,25.0,3,0,0,0,0,15,3
1454,Pierre Lees-Melou,96,67,51,41,4,49,129,38.0,80,61,11,50,43,64,3
1455,Diogo Leite,52,36,31,15,6,25,51,49.0,26,48,22,26,47,155,1
1456,Maxim Leitsch,6,3,5,1,0,3,6,50.0,3,2,0,2,4,13,0
1457,Florian Lejeune,39,25,26,11,2,19,30,63.3,11,33,18,15,23,155,1
1458,Stefan Lekovic,0,0,0,0,0,0,0,,0,1,1,0,0,1,0
1459,Iñigo Lekue,40,22,25,10,5,27,53,50.9,26,24,6,18,15,50,0
1460,Thomas Lemar,3,1,2,1,0,1,2,50.0,1,0,0,0,0,0,0
1461,Mario Lemina,90,58,46,33,11,25,47,53.2,22,36,9,27,41,64,0
1462,Álvaro Lemos,4,1,1,3,0,0,2,0.0,2,3,1,2,2,4,0
1463,Ruben Lendinez,2,2,0,2,0,1,1,100.0,0,0,0,0,0,1,0
1464,Clément Lenglet,13,9,7,5,1,7,13,53.8,6,19,11,8,7,47,1
1465,Bernd Leno,0,0,0,0,0,0,0,,0,0,0,0,0,14,1
1466,Christopher Lenz,2,1,2,0,0,1,1,100.0,0,0,0,0,2,2,0
1467,Christopher Lenz,1,1,0,1,0,1,1,100.0,0,0,0,0,0,1,0
1468,Johann Lepenant,4,3,2,2,0,1,8,12.5,7,5,0,5,4,0,0
1469,Jefferson Lerma,42,25,15,23,4,19,40,47.5,21,31,12,19,36,72,0
1470,Léo Leroy,19,10,8,8,3,6,21,28.6,15,12,3,9,7,8,0
1471,Robert Lewandowski,8,5,0,6,2,4,12,33.3,8,13,4,9,9,18,0
1472,Jamie Leweling,18,10,4,6,8,5,17,29.4,12,21,1,20,5,13,0
1473,Rico Lewis,10,7,4,4,2,3,7,42.9,4,7,1,6,4,6,0
1474,Keane Lewis-Potter,17,7,5,11,1,7,15,46.7,8,10,2,8,7,23,0
1475,Philipp Lienhart,20,13,14,5,1,13,23,56.5,10,18,11,7,14,51,0
1476,Matthijs de Ligt,15,12,4,8,3,6,11,54.5,5,14,10,4,19,52,0
1477,Victor Lindelöf,15,10,8,7,0,5,13,38.5,8,18,9,9,12,40,1
1478,Jesper Lindstrøm,8,3,2,3,3,4,8,50.0,4,3,0,3,2,6,0
1479,Jesper Lindstrøm,1,1,1,0,0,0,0,,0,0,0,0,0,0,0
1480,Karol Linetty,30,21,9,20,1,9,29,31.0,20,24,8,16,23,27,1
1481,Samuel Lino,61,34,32,17,12,35,70,50.0,35,37,1,36,14,27,0
1482,Luca Lipani,9,7,4,3,2,3,11,27.3,8,9,2,7,6,7,0
1483,Pol Lirola,30,18,14,15,1,17,35,48.6,18,12,1,11,19,41,1
1484,Marcin Listkowski,0,0,0,0,0,0,0,,0,0,0,0,0,0,0
1485,Valentino Livramento,23,13,15,6,2,10,21,47.6,11,16,7,9,25,41,1
1486,Dejan Ljubicic,43,27,20,18,5,20,43,46.5,23,22,2,20,18,11,0
1487,Javier Llabrés,3,1,1,1,1,1,2,50.0,1,1,0,1,3,4,0
1488,Diego Llorente,31,19,20,10,1,11,24,45.8,13,40,27,13,22,79,0
1489,Marcos Llorente,40,23,18,17,5,16,44,36.4,28,36,11,25,14,35,0
1490,Gautier Lloris,50,28,40,9,1,28,42,66.7,14,50,30,20,32,142,1
1491,Abou Lô,3,1,2,1,0,1,4,25.0,3,5,2,3,4,8,0
1492,Giovani Lo Celso,22,13,10,8,4,9,14,64.3,5,4,1,3,5,2,0
1493,Stanislav Lobotka,61,39,18,30,13,24,60,40.0,36,30,8,22,30,29,0
1494,Manuel Locatelli,69,43,24,35,10,31,58,53.4,27,43,17,26,25,65,0
1495,Bradley Locko,97,55,57,34,6,47,80,58.8,33,28,1,27,40,69,0
1496,Tom Lockyer,25,16,17,6,2,15,22,68.2,7,23,13,10,23,68,0
1497,Renan Lodi,24,16,8,13,3,13,21,61.9,8,7,2,5,16,35,0
1498,Ruben Loftus-Cheek,28,18,7,14,7,15,27,55.6,12,24,12,12,9,10,1
1499,Andy Logbo,0,0,0,0,0,0,3,0.0,3,7,3,4,0,2,0
1500,Enzo Loiodice,62,35,15,34,13,20,42,47.6,22,20,2,18,12,16,1
1501,Sean Longstaff,54,30,17,29,8,24,63,38.1,39,43,7,36,17,23,0
1502,Ademola Lookman,20,15,2,11,7,8,22,36.4,14,19,0,19,9,0,1
1503,Noah Loosli,10,7,6,4,0,7,14,50.0,7,7,1,6,7,18,0
1504,Anthony Lopes,0,0,0,0,0,0,0,,0,0,0,0,0,16,0
1505,David López,33,20,21,12,0,17,22,77.3,5,28,19,9,20,63,4
1506,Diego López,37,25,14,16,7,13,56,23.2,43,23,1,22,20,12,0
1507,Fermin López,41,21,15,18,8,14,40,35.0,26,14,1,13,4,9,0
1508,Javi López,23,12,11,9,3,15,26,57.7,11,25,9,16,10,77,1
1509,Maxime Lopez,18,9,5,10,3,6,12,50.0,6,3,1,2,7,6,0
1510,Maxime Lopez,2,1,1,1,0,1,2,50.0,1,1,1,0,2,0,0
1511,Pau López,0,0,0,0,0,0,2,0.0,2,0,0,0,0,10,1
1512,Unai López,48,24,18,23,7,21,53,39.6,32,24,3,21,16,15,2
1513,Dion Lopy,62,37,36,20,6,17,44,38.6,27,23,5,18,15,22,2
1514,Anthony Losilla,63,37,15,40,8,23,51,45.1,28,37,8,29,25,51,0
1515,Jordan Lotomba,36,28,18,9,9,25,35,71.4,10,30,9,21,16,26,1
1516,Tom Louchet,14,5,6,6,2,7,11,63.6,4,7,3,4,3,9,0
1517,Imran Louza,13,7,2,8,3,2,8,25.0,6,8,1,7,9,4,0
1518,Matteo Lovato,10,7,5,5,0,4,5,80.0,1,9,5,4,13,10,0
1519,Matteo Lovato,27,14,17,8,2,16,24,66.7,8,14,7,7,18,41,1
1520,Dejan Lovren,9,7,6,3,0,3,7,42.9,4,6,5,1,12,37,0
1521,Sandi Lovrić,25,12,9,11,5,9,23,39.1,14,21,2,19,21,24,0
1522,Max Lowe,21,10,13,5,3,8,15,53.3,7,10,4,6,5,15,0
1523,Anthony Lozano,0,0,0,0,0,0,1,0.0,1,0,0,0,0,1,0
1524,Anthony Lozano,7,5,2,5,0,4,7,57.1,3,6,1,5,2,12,0
1525,Lucas,47,27,32,11,4,32,55,58.2,23,27,4,23,17,45,0
1526,Lorenzo Lucca,19,11,4,11,4,5,20,25.0,15,18,3,15,3,36,1
1527,Jhon Lucumí,48,29,31,17,0,27,36,75.0,9,32,17,15,16,68,2
1528,José Luis Gayà,71,36,44,23,4,43,67,64.2,24,18,3,15,11,42,0
1529,José Luis Morales,5,3,1,4,0,3,13,23.1,10,9,1,8,7,4,0
1530,José Luis Palomino,2,1,1,1,0,1,1,100.0,0,2,1,1,1,6,0
1531,Douglas Luiz,58,38,21,27,10,25,53,47.2,28,32,8,24,23,18,2
1532,Romelu Lukaku,6,5,1,2,3,2,4,50.0,2,7,1,6,0,19,1
1533,Castello Lukeba,19,12,10,9,0,10,12,83.3,2,35,13,22,12,94,2
1534,Dodi Lukebakio,5,2,2,2,1,1,6,16.7,5,9,2,7,2,5,0
1535,Saša Lukić,33,19,9,17,7,18,39,46.2,21,18,5,13,16,19,1
1536,Karlo Lulić,0,0,0,0,0,0,0,,0,1,0,1,1,0,0
1537,Andriy Lunin,0,0,0,0,0,0,1,0.0,1,0,0,0,0,15,1
1538,Sebastiano Luperto,37,26,25,10,2,15,24,62.5,9,46,35,11,32,157,1
1539,Mateus Lusuardi,2,1,1,1,0,1,3,33.3,2,4,2,2,4,8,0
1540,Andreas Luthe,0,0,0,0,0,0,0,,0,0,0,0,0,1,0
1541,Zito Luvumbo,9,6,5,2,2,4,15,26.7,11,19,0,19,1,2,0
1542,Charalambos Lykogiannis,10,6,5,4,1,5,10,50.0,5,15,5,10,5,30,0
1543,Senne Lynen,64,38,33,27,4,30,70,42.9,40,41,8,33,41,56,0
1544,Joshua M'Bahia,0,0,0,0,0,0,0,,0,0,0,0,0,0,0
1545,Othmane Maamma,3,3,2,0,1,1,1,100.0,0,3,0,3,0,0,0
1546,Ian Maatsen,3,2,1,1,1,0,4,0.0,4,4,0,4,3,10,0
1547,Ian Maatsen,30,22,15,9,6,16,30,53.3,14,22,4,18,13,26,0
1548,Alexis Mac Allister,99,55,35,50,14,59,125,47.2,66,65,8,57,35,25,1
1549,Deiver Machado,24,18,10,10,4,15,20,75.0,5,13,2,11,7,8,0
1550,Darwin Machís,23,14,7,9,7,13,24,54.2,11,8,1,7,4,2,0
1551,James Maddison,33,19,5,18,10,15,29,51.7,14,15,3,12,13,10,1
1552,Noni Madueke,16,10,8,4,4,11,34,32.4,23,11,0,11,4,14,0
1553,Pablo Maffeo,35,22,18,13,4,23,40,57.5,17,12,2,10,10,23,0
1554,Gabriel Magalhães,48,28,24,22,2,17,22,77.3,5,44,33,11,31,100,1
1555,Soungoutou Magassa,56,26,22,32,2,26,48,54.2,22,21,4,17,21,36,2
1556,Giulio Maggiore,49,29,26,22,1,20,42,47.6,22,27,5,22,24,38,0
1557,Matej Maglica,35,21,25,10,0,22,36,61.1,14,29,11,18,22,92,5
1558,Giangiacomo Magnani,33,18,23,10,0,15,25,60.0,10,50,28,22,45,118,0
1559,Hugo Magnetti,49,27,18,26,5,24,58,41.4,34,19,1,18,18,18,0
1560,Yohann Magnin,49,31,12,32,5,22,47,46.8,25,38,13,25,19,26,1
1561,Frank Magri,22,14,5,12,5,15,21,71.4,6,16,4,12,4,17,0
1562,Harry Maguire,24,17,14,10,0,12,22,54.5,10,33,24,9,25,83,1
1563,Jon Magunacelaya,5,3,2,3,0,4,8,50.0,4,3,0,3,0,2,0
1564,Adel Mahamoud,0,0,0,0,0,0,1,0.0,1,0,0,0,0,0,0
1565,Arne Maier,14,9,5,8,1,5,14,35.7,9,19,2,17,6,11,0
1566,Habib Maïga,2,2,1,0,1,1,3,33.3,2,2,0,2,4,2,0
1567,Mike Maignan,1,0,1,0,0,1,1,100.0,0,1,0,1,1,4,3
1568,Linton Maina,18,15,11,5,2,9,28,32.1,19,12,1,11,6,12,0
1569,Patrick Mainka,85,49,58,24,3,38,74,51.4,36,66,32,34,49,158,1
1570,Kobbie Mainoo,47,27,20,16,11,21,45,46.7,24,20,12,8,22,30,1
1571,Ainsley Maitland-Niles,34,18,12,14,8,19,37,51.4,18,16,6,10,17,29,1
1572,Radosław Majecki,0,0,0,0,0,0,0,,0,1,0,1,0,5,1
1573,Lovro Majer,0,0,0,0,0,0,0,,0,0,0,0,0,1,0
1574,Lovro Majer,39,18,17,22,0,12,31,38.7,19,20,1,19,12,13,0
1575,Jean-Victor Makengo,5,4,3,2,0,2,6,33.3,4,12,1,11,8,5,0
1576,Jordy Makengo,17,11,11,5,1,6,10,60.0,4,16,4,12,11,37,0
1577,Antoine Makoumbou,41,24,21,15,5,15,30,50.0,15,23,4,19,16,27,2
1578,Nemanja Maksimović,65,43,26,31,8,23,41,56.1,18,56,23,33,46,61,0
1579,Julián Malatini,18,13,12,3,3,16,24,66.7,8,8,1,7,13,26,0
1580,Daniel Maldini,3,2,0,2,1,3,6,50.0,3,2,0,2,2,1,0
1581,Daniel Maldini,4,2,0,2,2,2,2,100.0,0,5,0,5,2,2,0
1582,Youssef Maleh,74,48,30,36,8,23,52,44.2,29,62,7,55,25,29,0
1583,Donyell Malen,11,7,5,3,3,2,6,33.3,4,11,4,7,2,8,0
1584,Ruslan Malinovskyi,35,20,18,11,6,17,41,41.5,24,22,8,14,5,16,0
1585,Lennard Maloney,43,26,14,24,5,25,59,42.4,34,33,9,24,25,88,0
1586,Aaron Malouda,0,0,0,0,0,0,0,,0,0,0,0,0,0,0
1587,Giorgi Mamardashvili,4,3,4,0,0,4,4,100.0,0,1,0,1,2,22,2
1588,David Mamutovic,1,1,0,1,0,1,1,100.0,0,0,0,0,0,0,0
1589,Wilson Manafá,6,4,3,2,1,4,7,57.1,3,1,0,1,1,4,1
1590,Hianga Mananga Mbock,1,0,0,0,1,1,2,50.0,1,0,0,0,1,0,0
1591,Gianluca Mancini,34,20,21,11,2,11,27,40.7,16,38,26,12,36,77,1
1592,Marco Mancosu,3,0,0,2,1,1,2,50.0,1,0,0,0,0,0,0
1593,Steve Mandanda,2,0,2,0,0,2,4,50.0,2,0,0,0,0,6,1
1594,Christos Mandas,0,0,0,0,0,0,1,0.0,1,0,0,0,1,3,1
1595,Reinildo Mandava,30,22,16,11,3,19,22,86.4,3,10,2,8,15,21,0
1596,Aïssa Mandi,13,8,8,5,0,7,14,50.0,7,10,7,3,8,41,0
1597,Rolando Mandragora,26,11,8,13,5,10,22,45.5,12,14,3,11,9,18,1
1598,Orel Mangala,27,13,16,10,1,14,29,48.3,15,12,6,6,26,32,0
1599,Orel Mangala,5,3,0,2,3,1,3,33.3,2,3,2,1,5,6,0
1600,Vito Mannone,0,0,0,0,0,0,0,,0,0,0,0,0,0,0
1601,Kostas Manolas,9,5,6,3,0,6,8,75.0,2,10,7,3,2,20,0
1602,Javier Manquillo,15,11,6,5,4,8,15,53.3,7,14,3,11,3,17,0
1603,Braydon Manu,2,0,0,1,1,0,0,,0,1,0,1,0,0,0
1604,Benson Manuel,3,2,2,1,0,0,0,,0,1,0,1,0,0,0
1605,Faitout Maouassa,8,5,6,1,1,4,5,80.0,1,6,0,6,1,3,0
1606,Faitout Maouassa,1,1,1,0,0,1,1,100.0,0,1,0,1,0,3,0
1607,Marcão,9,6,5,4,0,6,10,60.0,4,8,6,2,4,11,1
1608,Solly March,19,14,9,7,3,8,14,57.1,6,5,0,5,11,8,0
1609,Riccardo Marchizza,7,6,4,3,0,3,13,23.1,10,10,2,8,7,33,0
1610,Gian Marco Ferrari,22,10,11,11,0,12,18,66.7,6,28,17,11,25,76,0
1611,Óscar de Marcos,56,39,26,24,6,42,71,59.2,29,28,6,22,15,44,0
1612,Alberto Marí,4,2,0,1,3,1,1,100.0,0,3,0,3,0,5,0
1613,José Mari,2,1,0,2,0,1,2,50.0,1,0,0,0,0,0,0
1614,Pablo Marí,41,25,34,7,0,22,34,64.7,12,40,25,15,37,115,1
1615,José María Giménez,18,10,10,7,1,5,16,31.3,11,16,12,4,10,95,0
1616,Mariano,1,1,0,1,0,0,1,0.0,1,1,0,1,0,2,0
1617,Mirko Marić,4,0,2,1,1,0,2,0.0,2,4,0,4,2,3,0
1618,Rafa Marín,32,20,23,9,0,14,27,51.9,13,34,21,13,33,129,2
1619,Răzvan Marin,40,22,13,23,4,19,29,65.5,10,16,4,12,6,30,2
1620,Diego Mariño,0,0,0,0,0,0,0,,0,0,0,0,0,1,0
1621,Guillermo Maripán,22,8,15,6,1,10,27,37.0,17,26,13,13,30,106,4
1622,Mika Màrmol,70,42,44,24,2,35,53,66.0,18,39,19,20,44,147,2
1623,Omar Marmoush,21,11,7,8,6,6,16,37.5,10,13,0,13,11,7,0
1624,Marquinhos,3,2,2,0,1,1,4,25.0,3,7,2,5,6,1,0
1625,Marquinhos,19,11,10,7,2,11,17,64.7,6,29,19,10,17,58,1
1626,Unai Marrero,0,0,0,0,0,0,0,,0,0,0,0,0,0,0
1627,Agustín Martegani,13,7,7,3,3,6,18,33.3,12,4,1,3,4,7,1
1628,Eric Martel,70,43,32,34,4,37,67,55.2,30,65,19,46,43,80,0
1629,Roger Martí,12,6,1,9,2,2,7,28.6,5,16,1,15,7,4,0
1630,Anthony Martial,4,1,1,1,2,1,1,100.0,0,4,0,4,0,3,0
1631,Aarón Martín,21,10,7,10,4,9,22,40.9,13,12,4,8,9,15,0
1632,Iván Martín,44,25,22,15,7,22,57,38.6,35,25,3,22,21,14,0
1633,Jon Martin,0,0,0,0,0,0,0,,0,0,0,0,0,3,0
1634,Jonas Martin,43,27,17,24,2,21,36,58.3,15,16,2,14,9,28,2
1635,Mario Martín,5,1,0,2,3,3,4,75.0,1,2,1,1,0,0,0
1636,Gabriel Martinelli,30,24,9,12,9,13,32,40.6,19,23,1,22,5,9,1
1637,Tommaso Martinelli,,0,,,,,,,,,,,0,,
1638,Arnau Martinez,25,16,17,6,2,15,32,46.9,17,15,5,10,10,41,3
1639,Emiliano Martínez,0,0,0,0,0,0,0,,0,0,0,0,0,12,3
1640,Iñigo Martínez,10,7,9,1,0,6,8,75.0,2,13,10,3,11,50,0
1641,Josep Martinez,0,0,0,0,0,0,0,,0,0,0,0,1,21,3
1642,Lautaro Martínez,22,16,4,13,5,4,19,21.1,15,30,1,29,20,10,0
1643,Lisandro Martínez,12,8,8,4,0,5,12,41.7,7,10,8,2,5,26,0
1644,Marc Martínez,0,0,0,0,0,0,1,0.0,1,0,0,0,0,1,0
1645,Lucas Martínez Quarta,75,47,43,28,4,36,54,66.7,18,38,14,24,30,69,4
1646,Adam Marušić,45,31,24,19,2,27,49,55.1,22,27,7,20,29,63,2
1647,Marvin,39,25,18,17,4,18,36,50.0,18,28,2,26,14,18,1
1648,Omar Mascarell,33,16,16,17,0,18,35,51.4,17,24,8,16,31,30,1
1649,Adam Masina,4,0,2,2,0,2,4,50.0,2,2,1,1,2,5,0
1650,Adam Masina,17,12,8,8,1,5,20,25.0,15,12,6,6,11,30,0
1651,Erhan Mašović,64,40,37,22,5,37,70,52.9,33,32,10,22,25,75,2
1652,Han-Noah Massengo,1,1,1,0,0,0,0,,0,1,0,1,0,0,0
1653,Roberto Massimo,1,0,1,0,0,1,2,50.0,1,0,0,0,0,1,0
1654,Clinton Mata,43,24,29,8,6,23,40,57.5,17,35,16,19,40,61,0
1655,Jaime Mata,24,15,12,8,4,11,26,42.3,15,18,1,17,17,31,0
1656,Pape Matar Sarr,34,24,11,17,6,15,36,41.7,21,21,5,16,31,28,1
1657,Eliot Matazo,3,1,0,3,0,2,4,50.0,2,1,1,0,3,0,0
1658,Jean-Philippe Mateta,22,15,4,11,7,6,10,60.0,4,13,4,9,4,14,0
1659,Nemanja Matić,19,10,7,9,3,9,12,75.0,3,15,7,8,27,19,0
1660,Nemanja Matić,17,11,8,7,2,9,19,47.4,10,17,6,11,16,17,1
1661,Joël Matip,12,6,7,4,1,8,12,66.7,4,16,12,4,9,43,0
1662,Alex Matos,0,0,0,0,0,0,0,,0,0,0,0,0,0,0
1663,Chrislain Matsima,18,11,11,7,0,10,18,55.6,8,14,10,4,13,74,1
1664,Chrislain Matsima,9,7,5,3,1,2,7,28.6,5,4,1,3,4,4,0
1665,Jean Mattéo Bahoya,3,1,0,3,0,1,4,25.0,3,2,0,2,1,1,0
1666,Remi Matthews,0,0,0,0,0,0,0,,0,0,0,0,0,1,0
1667,Alan Matturro,1,1,1,0,0,1,1,100.0,0,6,3,3,2,4,0
1668,Azor Matusiwa,39,27,17,19,3,22,32,68.8,10,21,3,18,33,32,1
1669,Azor Matusiwa,7,3,3,4,0,4,7,57.1,3,9,2,7,11,17,0
1670,Neal Maupay,10,7,4,5,1,3,13,23.1,10,11,0,11,2,3,0
1671,Neal Maupay,0,0,0,0,0,0,1,0.0,1,2,0,2,0,1,0
1672,Aïman Maurer,1,1,1,0,0,1,3,33.3,2,0,0,0,0,0,0
1673,Konstantinos Mavropanos,28,16,17,9,2,17,21,81.0,4,21,13,8,23,79,3
1674,Christian Mawissa,22,15,14,4,4,9,23,39.1,14,22,11,11,22,41,1
1675,Philipp Max,26,17,6,18,2,19,26,73.1,7,18,1,17,7,18,2
1676,Eric Maxim Choupo-Moting,17,12,8,5,4,6,14,42.9,8,5,0,5,7,7,0
1677,Luís Maximiano,0,0,0,0,0,0,1,0.0,1,0,0,0,0,19,2
1678,Noam Mayoka-Tika,0,0,0,0,0,0,0,,0,0,0,0,0,0,0
1679,Borja Mayoral,9,5,2,2,5,5,22,22.7,17,7,0,7,4,16,0
1680,Senny Mayulu,13,8,6,6,1,6,7,85.7,1,1,0,1,3,0,0
1681,Youssef Maziz,0,0,0,0,0,0,2,0.0,2,1,0,1,1,2,0
1682,Noussair Mazraoui,32,21,14,11,7,13,21,61.9,8,14,1,13,20,27,1
1683,Luca Mazzitelli,45,23,15,24,6,26,49,53.1,23,23,7,16,19,62,0
1684,Pasquale Mazzocchi,25,19,14,10,1,16,29,55.2,13,14,6,8,5,31,0
1685,Pasquale Mazzocchi,5,2,1,2,2,2,3,66.7,1,5,1,4,1,13,0
1686,Kevin Mbabu,51,39,25,18,8,23,40,57.5,17,29,9,20,24,48,0
1687,Noah Mbamba,0,0,0,0,0,0,0,,0,0,0,0,1,0,0
1688,Ethan Mbappé,0,0,0,0,0,0,2,0.0,2,1,0,1,0,0,0
1689,Kylian Mbappé,4,1,1,1,2,4,9,44.4,5,4,0,4,2,2,0
1690,Malick Mbaye,5,1,0,1,4,1,2,50.0,1,1,0,1,1,2,0
1691,Mamadou Mbaye,6,3,3,3,0,2,5,40.0,3,10,7,3,5,26,0
1692,Chancel Mbemba,33,21,25,7,1,17,30,56.7,13,21,13,8,13,95,1
1693,Nolan Mbemba,2,1,0,1,1,1,2,50.0,1,0,0,0,0,0,0
1694,Bryan Mbeumo,15,10,6,6,3,5,19,26.3,14,26,2,24,7,13,0
1695,Christ Mbondi,1,1,1,0,0,1,1,100.0,0,0,0,0,0,0,0
1696,Jordi Mboula,4,4,1,2,1,4,7,57.1,3,4,1,3,1,0,0
1697,Nathanael Mbuku,0,0,0,0,0,0,0,,0,1,0,1,0,0,0
1698,James Mcatee,32,21,9,13,10,13,33,39.4,20,20,0,20,11,18,0
1699,James Mcatee,0,0,0,0,0,0,0,,0,1,0,1,0,0,0
1700,Oliver McBurnie,17,7,4,7,6,5,12,41.7,7,18,2,16,5,28,0
1701,James McConnell,0,0,0,0,0,0,0,,0,1,0,1,1,0,0
1702,John McGinn,59,35,18,34,7,32,77,41.6,45,33,4,29,21,21,0
1703,Scott McKenna,4,0,3,1,0,2,3,66.7,1,6,4,2,5,27,0
1704,Weston McKennie,48,29,31,11,6,17,27,63.0,10,28,7,21,18,69,0
1705,Dwight McNeil,44,27,16,14,14,24,55,43.6,31,44,7,37,22,37,0
1706,Scott McTominay,49,25,23,24,2,22,33,66.7,11,34,12,22,14,54,0
1707,Facundo Medina,64,38,25,31,8,44,69,63.8,25,38,13,25,24,59,2
1708,Ben Mee,26,15,12,12,2,17,22,77.3,5,21,13,8,13,63,1
1709,Marvin Mehlem,28,21,10,14,4,11,27,40.7,16,21,2,19,33,15,0
1710,Bamo Meïté,16,10,13,3,0,8,12,66.7,4,11,5,6,11,35,0
1711,Bamo Meïté,2,1,2,0,0,0,1,0.0,1,3,2,1,3,9,0
1712,Hannibal Mejbri,3,3,1,2,0,1,3,33.3,2,1,1,0,0,0,0
1713,Hannibal Mejbri,3,3,1,2,0,0,1,0.0,1,1,0,1,0,0,0
1714,Óscar Melendo,14,6,4,10,0,4,12,33.3,8,13,0,13,5,4,1
1715,Gonzalo Melero,14,8,7,5,2,7,19,36.8,12,12,4,8,4,11,0
1716,Birger Meling,1,1,1,0,0,1,1,100.0,0,1,0,1,0,0,0
1717,Arthur Melo,45,30,17,24,4,26,42,61.9,16,27,3,24,18,8,0
1718,Memphis,5,2,0,3,2,3,6,50.0,3,2,0,2,1,0,0
1719,Houboulang Mendes,16,13,11,5,0,8,16,50.0,8,4,2,2,1,17,1
1720,Nuno Mendes,5,5,4,1,0,4,7,57.1,3,4,0,4,4,2,0
1721,Tomás Mendes,0,0,0,0,0,0,0,,0,0,0,0,0,0,0
1722,Brais Méndez,42,28,13,20,9,15,43,34.9,28,23,4,19,12,21,0
1723,Bruno Méndez,36,17,19,12,5,21,37,56.8,16,24,6,18,26,45,0
1724,Diego Méndez,1,1,1,0,0,1,1,100.0,0,0,0,0,1,0,0
1725,Leonardo Mendicino,0,0,0,0,0,0,0,,0,0,0,0,0,0,0
1726,Antoine Mendy,7,5,4,3,0,3,7,42.9,4,4,1,3,8,16,0
1727,Benjamin Mendy,3,1,2,1,0,1,5,20.0,4,8,2,6,7,20,0
1728,Ferland Mendy,15,10,12,2,1,11,14,78.6,3,12,2,10,13,26,1
1729,Formose Mendy,33,19,24,8,1,20,33,60.6,13,23,12,11,20,59,1
1730,Nampalys Mendy,29,18,10,13,6,16,20,80.0,4,11,4,7,14,14,1
1731,Teden Mengi,54,22,33,20,1,19,30,63.3,11,39,27,12,57,140,1
1732,Chris Mepham,12,11,9,3,0,9,14,64.3,5,13,6,7,7,30,1
1733,Jorge Meré,8,7,6,2,0,4,7,57.1,3,5,3,2,8,33,0
1734,Alex Meret,1,0,1,0,0,1,2,50.0,1,0,0,0,0,10,1
1735,Mikel Merino,77,43,25,34,18,22,48,45.8,26,36,11,25,16,55,3
1736,Quentin Merlin,13,12,7,5,1,8,20,40.0,12,4,0,4,6,14,0
1737,Quentin Merlin,29,20,15,12,2,16,25,64.0,9,22,1,21,18,22,0
1738,Junior Messias,26,20,19,5,2,8,19,42.1,11,9,1,8,5,22,0
1739,Thomas Meunier,5,1,3,2,0,3,13,23.1,10,8,2,6,4,22,0
1740,Bastien Meupiyou,0,0,0,0,0,0,0,,0,0,0,0,0,1,0
1741,Alexander Meyer,1,1,1,0,0,1,1,100.0,0,0,0,0,0,2,1
1742,Omenuke Mfulu,4,3,3,1,0,0,1,0.0,1,1,1,0,2,5,0
1743,Lucas Michal,0,0,0,0,0,0,0,,0,0,0,0,0,0,0
1744,Sven Michel,7,5,2,1,4,2,7,28.6,5,1,0,1,0,4,0
1745,Miguel,0,0,0,0,0,0,0,,0,2,0,2,0,0,0
1746,Georges Mikautadze,4,3,1,2,1,0,9,0.0,9,11,0,11,8,3,0
1747,Nikola Milenković,41,21,24,14,3,22,36,61.1,14,22,14,8,27,95,1
1748,Lewis Miley,33,21,6,20,7,15,32,46.9,17,20,3,17,8,18,2
1749,Arkadiusz Milik,9,5,2,5,2,3,5,60.0,2,7,1,6,5,3,0
1750,Vanja Milinković-Savić,1,0,1,0,0,1,1,100.0,0,0,0,0,1,14,4
1751,Éder Militão,7,3,4,3,0,6,9,66.7,3,4,3,1,4,19,1
1752,Luis Milla,57,33,19,28,10,28,47,59.6,19,20,1,19,32,10,0
1753,Enzo Millot,40,22,9,21,10,18,39,46.2,21,24,2,22,16,7,1
1754,James Milner,20,14,9,10,1,9,14,64.3,5,9,0,9,8,16,0
1755,Jovan Milošević,0,0,0,0,0,0,0,,0,0,0,0,0,0,0
1756,Marko Milovanović,4,4,1,3,0,2,4,50.0,2,2,0,2,0,5,0
1757,Kim Min-jae,37,24,21,11,5,12,24,50.0,12,29,19,10,45,70,2
1758,Yerry Mina,1,1,1,0,0,1,2,50.0,1,0,0,0,0,2,0
1759,Yerry Mina,20,13,14,6,0,13,19,68.4,6,23,14,9,4,77,0
1760,Takumi Minamino,34,17,10,13,11,16,54,29.6,38,29,1,28,11,8,0
1761,Lucas Mincarelli,29,16,19,6,4,17,34,50.0,17,17,4,13,8,27,0
1762,Tyrone Mings,0,0,0,0,0,0,0,,0,0,0,0,1,1,0
1763,Óscar Mingueza,62,38,44,11,7,37,80,46.3,43,38,7,31,17,49,2
1764,Ignasi Miquel,47,30,39,6,2,23,40,57.5,17,32,16,16,45,132,4
1765,Rafa Mir,2,2,1,1,0,1,2,50.0,1,2,0,2,1,1,0
1766,Ignacio Miramon,1,0,0,1,0,0,1,0.0,1,1,0,1,0,0,0
1767,Aleksei Miranchuk,12,6,6,4,2,5,13,38.5,8,6,1,5,2,5,1
1768,Juan Miranda,38,24,21,13,4,17,31,54.8,14,31,6,25,19,62,0
1769,Kevin Miranda,0,0,0,0,0,0,0,,0,0,0,0,0,1,0
1770,Antonio Mirante,0,0,0,0,0,0,0,,0,0,0,0,0,1,0
1771,Fabio Miretti,18,14,6,8,4,10,26,38.5,16,10,1,9,7,6,0
1772,Filippo Missori,6,3,2,4,0,4,11,36.4,7,3,2,1,4,8,0
1773,Tyrick Mitchell,105,60,75,21,9,43,60,71.7,17,63,10,53,26,104,0
1774,Kaoru Mitoma,13,6,3,7,3,5,19,26.3,14,15,1,14,5,12,0
1775,Aleksandar Mitrović,0,0,0,0,0,0,0,,0,0,0,0,0,0,0
1776,Stefan Mitrović,6,3,0,5,1,2,5,40.0,3,6,1,5,0,4,0
1777,Stefan Mitrović,9,3,7,2,0,4,8,50.0,4,3,2,1,6,26,0
1778,Maximilian Mittelstädt,91,51,46,39,6,53,89,59.6,36,36,6,30,46,65,0
1779,Henrikh Mkhitaryan,62,34,18,35,9,24,49,49.0,25,23,4,19,29,43,0
1780,Marko Mladenović,0,0,0,0,0,0,0,,0,0,0,0,0,0,0
1781,Jakub Moder,19,10,9,5,5,9,18,50.0,9,8,2,6,2,12,0
1782,Luka Modrić,22,15,10,6,6,9,25,36.0,16,13,4,9,21,9,0
1783,Max Moerstedt,0,0,0,0,0,0,1,0.0,1,0,0,0,0,0,0
1784,Terem Moffi,7,4,0,5,2,3,12,25.0,9,14,1,13,3,15,0
1785,Mostafa Mohamed,21,14,7,11,3,6,28,21.4,22,21,5,16,12,29,0
1786,Dion Moise Sahi,5,5,1,2,2,0,3,0.0,3,11,1,10,1,7,0
1787,Johan Mojica,30,22,11,15,4,16,25,64.0,9,15,2,13,21,40,2
1788,Alberto Moleiro,15,6,4,7,4,6,30,20.0,24,11,0,11,7,10,0
1789,Nahuel Molina,38,22,16,18,4,26,54,48.1,28,19,3,16,9,36,1
1790,Florent Mollet,18,11,8,6,4,10,31,32.3,21,18,5,13,13,17,0
1791,Jon Moncayola,27,18,14,10,3,17,42,40.5,25,31,5,26,15,21,0
1792,Enzo Mongo,1,1,1,0,0,1,2,50.0,1,1,1,0,1,0,0
1793,Ilario Monterisi,23,13,14,7,2,12,26,46.2,14,22,18,4,8,63,0
1794,César Montes,22,13,13,9,0,9,18,50.0,9,21,9,12,11,94,0
1795,Gonzalo Montiel,22,19,12,8,2,16,29,55.2,13,8,3,5,9,31,1
1796,Lorenzo Montipò,1,1,1,0,0,1,3,33.3,2,0,0,0,0,25,2
1797,Kieffer Moore,0,0,0,0,0,0,0,,0,0,0,0,0,0,0
1798,Mikey Moore,0,0,0,0,0,0,0,,0,0,0,0,0,1,0
1799,Álvaro Morata,16,10,4,7,5,3,5,60.0,2,18,3,15,1,26,0
1800,Diego Moreira,0,0,0,0,0,0,3,0.0,3,3,0,3,2,5,0
1801,Alberto Moreno,31,21,19,10,2,10,30,33.3,20,12,2,10,24,33,0
1802,Álex Moreno,18,12,18,0,0,12,19,63.2,7,11,2,9,13,37,0
1803,Gerard Moreno,25,12,10,7,8,11,25,44.0,14,24,7,17,9,24,0
1804,Jorge Moreno,0,0,0,0,0,0,0,,0,1,0,1,0,3,0
1805,Mateu Morey,2,2,1,1,0,2,4,50.0,2,3,1,2,1,3,0
1806,Ilaix Moriba,20,11,3,11,6,4,9,44.4,5,3,1,2,4,10,0
1807,Manu Morlanes,50,29,23,26,1,23,53,43.4,30,13,1,12,20,21,0
1808,Nikola Moro,21,16,8,12,1,8,15,53.3,7,14,1,13,7,10,0
1809,Carlton Morris,15,8,4,6,5,9,15,60.0,6,24,5,19,1,53,0
1810,Cristhian Mosquera,57,34,36,18,3,25,39,64.1,14,42,23,19,36,137,2
1811,Yerson Mosquera,27,13,18,7,2,12,15,80.0,3,12,2,10,17,65,0
1812,Dany Mota,13,7,2,5,6,8,17,47.1,9,4,1,3,2,18,0
1813,Lebo Mothiba,5,2,1,4,0,3,4,75.0,1,6,1,5,0,11,0
1814,Youssoufa Moukoko,4,1,2,2,0,3,7,42.9,4,4,1,3,2,4,0
1815,Steve Mounié,8,7,0,3,5,3,11,27.3,8,13,3,10,2,18,0
1816,Mason Mount,22,14,6,10,6,6,16,37.5,10,6,1,5,6,3,0
1817,Samuel Moutoussamy,38,20,14,17,7,17,37,45.9,20,16,3,13,11,13,0
1818,Loris Mouyokolo,4,1,4,0,0,1,1,100.0,0,1,0,1,0,3,0
1819,Divin Mubama,0,0,0,0,0,0,0,,0,0,0,0,0,0,0
1820,Mykhailo Mudryk,21,12,9,7,5,10,32,31.3,22,14,1,13,9,9,0
1821,François Mughe,0,0,0,0,0,0,3,0.0,3,2,0,2,1,1,0
1822,Nordi Mukiele,12,8,6,5,1,8,15,53.3,7,17,4,13,14,28,0
1823,Samuele Mulattieri,1,1,0,0,1,1,2,50.0,1,7,2,5,1,2,0
1824,Andreas Müller,14,9,8,5,1,4,9,44.4,5,5,2,3,4,5,0
1825,Jannik Müller,33,16,21,9,3,16,27,59.3,11,24,12,12,17,39,1
1826,Kevin Müller,3,0,3,0,0,3,5,60.0,2,0,0,0,0,6,1
1827,Marcus Müller,0,0,0,0,0,0,0,,0,0,0,0,0,0,0
1828,Thomas Müller,26,16,5,10,11,13,35,37.1,22,22,0,22,3,6,0
1829,Abdul Mumin,19,10,13,4,2,8,10,80.0,2,27,19,8,22,82,1
1830,Marshall Munetsi,61,39,18,34,9,33,61,54.1,28,21,7,14,14,33,0
1831,Iker Muniain,5,1,2,3,0,1,3,33.3,2,4,1,3,0,0,0
1832,Rodrigo Muniz,7,3,1,5,1,1,6,16.7,5,9,3,6,6,20,0
1833,Aihen Muñoz,36,21,20,10,6,24,35,68.6,11,16,8,8,9,33,0
1834,Álvaro Muñoz,0,0,0,0,0,0,0,,0,0,0,0,0,1,0
1835,Daniel Muñoz,55,35,31,14,10,19,38,50.0,19,29,7,22,24,47,0
1836,Iker Muñoz,32,18,13,17,2,15,31,48.4,16,16,5,11,11,50,0
1837,Javier Muñoz,42,23,14,22,6,16,44,36.4,28,40,4,36,20,29,1
1838,Finley Munroe,0,0,0,0,0,0,0,,0,0,0,0,0,0,0
1839,Arijanet Muric,1,1,1,0,0,1,1,100.0,0,0,0,0,0,10,4
1840,Luis Muriel,3,2,0,2,1,1,1,100.0,0,4,0,4,1,0,0
1841,Murillo,50,31,36,13,1,19,33,57.6,14,41,24,17,37,188,0
1842,Vedat Muriqi,11,6,4,3,4,2,14,14.3,12,11,4,7,6,26,0
1843,Alex Murphy,1,1,0,1,0,1,2,50.0,1,1,0,1,1,0,0
1844,Jacob Murphy,20,10,8,4,8,12,26,46.2,14,17,0,17,6,16,0
1845,Yunus Musah,25,14,15,6,4,8,15,53.3,7,18,4,14,10,16,1
1846,Jamal Musiala,40,25,9,21,10,14,36,38.9,22,25,1,24,16,5,0
1847,Florent Muslija,5,4,3,2,0,2,5,40.0,3,1,0,1,0,2,0
1848,Juan Musso,1,0,1,0,0,1,1,100.0,0,0,0,0,0,6,0
1849,Kingstone Mutandwa,1,0,1,0,0,1,4,25.0,3,1,0,1,0,2,0
1850,Yvon Mvogo,0,0,0,0,0,0,1,0.0,1,0,0,0,0,15,3
1851,Joel Mvuka,5,3,3,1,1,3,7,42.9,4,1,0,1,2,1,0
1852,Junior Mwanga,40,20,23,12,5,12,24,50.0,12,20,5,15,18,19,0
1853,Phillipp Mwene,34,15,15,16,3,16,33,48.5,17,27,3,24,17,47,0
1854,Vitaliy Mykolenko,69,38,46,21,2,41,66,62.1,25,36,11,25,36,92,0
1855,Joakim Mæhle,62,39,33,18,11,41,64,64.1,23,43,5,38,29,65,0
1856,Obite N'Dicka,32,18,12,19,1,12,20,60.0,8,30,16,14,16,75,0
1857,Kévin N'Doram,31,22,20,9,2,17,38,44.7,21,17,8,9,27,38,0
1858,Nathan N'Goumou,37,22,17,18,2,16,34,47.1,18,22,0,22,5,17,1
1859,Stanley N'Soki,21,10,12,8,1,17,29,58.6,12,13,2,11,8,33,0
1860,Nacho,18,10,9,7,2,6,13,46.2,7,23,13,10,18,56,0
1861,Bilal Nadir,4,3,2,2,0,1,2,50.0,1,0,0,0,2,2,0
1862,Mahamadou Nagida,1,1,0,0,1,0,2,0.0,2,2,1,1,4,0,0
1863,Marvelous Nakamba,40,24,24,14,2,24,42,57.1,18,23,6,17,11,11,1
1864,Keito Nakamura,28,11,9,10,9,17,37,45.9,20,15,2,13,6,7,0
1865,Nahitan Nández,59,40,27,23,9,27,64,42.2,37,25,2,23,19,32,0
1866,Matija Nastasić,35,17,26,9,0,24,32,75.0,8,33,20,13,29,114,0
1867,Natan,14,10,10,3,1,5,10,50.0,5,12,9,3,8,32,0
1868,Lapo Nava,0,0,0,0,0,0,0,,0,0,0,0,0,0,0
1869,Roberto Navarro,46,29,20,21,5,22,43,51.2,21,33,0,33,19,7,1
1870,Jesús Navas,37,27,21,14,2,22,40,55.0,18,15,7,8,22,48,0
1871,Keylor Navas,0,0,0,0,0,0,0,,0,0,0,0,0,2,0
1872,Michel Ndary Adopo,4,3,0,3,1,1,1,100.0,0,0,0,0,0,2,1
1873,Youssouf Ndayishimiye,31,20,17,12,2,12,23,52.2,11,19,11,8,12,47,1
1874,Bassirou Ndiaye,5,2,2,2,1,3,5,60.0,2,1,1,0,1,0,0
1875,Iliman Ndiaye,21,18,5,11,5,11,29,37.9,18,14,2,12,6,6,0
1876,Massamba Ndiaye,0,0,0,0,0,0,0,,0,0,0,0,0,2,0
1877,Rassoul Ndiaye,25,17,8,16,1,12,24,50.0,12,2,1,1,4,5,0
1878,Michael Ndiweni,0,0,0,0,0,0,0,,0,0,0,0,0,0,0
1879,Cher Ndour,2,2,0,2,0,1,2,50.0,1,0,0,0,0,0,0
1880,Dan Ndoye,30,15,17,11,2,17,39,43.6,22,20,1,19,10,14,0
1881,Joseph Nduquidi,11,4,6,3,2,1,9,11.1,8,11,3,8,11,15,1
1882,Loïc Nego,37,26,21,12,4,18,30,60.0,12,12,2,10,16,17,0
1883,Álvaro Negredo,0,0,0,0,0,0,0,,0,1,0,1,1,0,0
1884,Reiss Nelson,9,6,5,1,3,8,10,80.0,2,5,1,4,1,5,0
1885,Zack Nelson,1,0,1,0,0,0,0,,0,0,0,0,0,0,0
1886,Neto,0,0,0,0,0,0,0,,0,1,0,1,1,12,3
1887,Pedro Neto,7,3,3,2,2,5,15,33.3,10,5,1,4,5,2,0
1888,Luca Netz,38,22,19,16,3,23,43,53.5,20,36,10,26,22,76,1
1889,Manuel Neuer,1,1,1,0,0,0,0,,0,0,0,0,0,14,3
1890,Florian Neuhaus,15,12,7,8,0,8,26,30.8,18,8,6,2,14,8,0
1891,Carlos Neva,32,21,22,9,1,17,40,42.5,23,39,14,25,30,108,2
1892,Jessic Ngankam,1,1,0,1,0,0,0,,0,3,1,2,3,0,0
1893,Jessic Ngankam,3,2,1,1,1,0,0,,0,0,0,0,0,1,0
1894,Cyril Ngonge,14,9,5,3,6,5,14,35.7,9,7,1,6,4,10,0
1895,Cyril Ngonge,5,3,1,4,0,2,2,100.0,0,2,0,2,0,2,0
1896,Steve Ngoura,2,1,1,1,0,1,4,25.0,3,0,0,0,0,3,0
1897,Moussa Niakhate,42,25,33,9,0,20,25,80.0,5,19,12,7,14,51,0
1898,M'Baye Niang,3,1,0,1,2,0,6,0.0,6,7,1,6,3,10,0
1899,Tanguy Nianzou,12,8,9,2,1,8,11,72.7,3,2,0,2,3,9,1
1900,Shamar Nicholson,6,2,0,4,2,1,4,25.0,3,6,2,4,0,15,0
1901,Rasmus Nicolaisen,50,30,39,11,0,26,44,59.1,18,44,33,11,42,158,1
1902,Moritz Nicolas,1,0,1,0,0,1,3,33.3,2,0,0,0,0,12,5
1903,Hans Nicolussi Caviglia,5,2,1,3,1,4,6,66.7,2,5,1,4,0,2,0
1904,Saúl Ñíguez,64,39,29,29,6,30,49,61.2,19,36,9,27,14,56,0
1905,Justin Njinmah,5,1,2,2,1,3,9,33.3,6,9,1,8,2,6,0
1906,Eddie Nketiah,12,7,2,6,4,2,7,28.6,5,11,0,11,4,4,0
1907,Niels Nkounkou,54,30,34,17,3,29,64,45.3,35,30,2,28,16,30,0
1908,Christopher Nkunku,5,4,0,4,1,1,2,50.0,1,4,1,3,2,4,0
1909,Felix Nmecha,19,13,7,8,4,11,22,50.0,11,18,5,13,11,19,0
1910,Lukas Nmecha,1,1,0,0,1,0,0,,0,1,0,1,0,0,0
1911,Peru Nolaskoain,1,1,1,0,0,1,1,100.0,0,0,0,0,0,1,0
1912,Joseph Nonge,0,0,0,0,0,0,0,,0,0,0,0,0,1,0
1913,Jonathan Norbye,0,0,0,0,0,0,0,,0,0,0,0,0,0,0
1914,Arnaud Nordin,12,6,3,5,4,6,16,37.5,10,11,0,11,2,10,0
1915,Rhys Norrington-Davies,1,1,1,0,0,0,1,0.0,1,2,0,2,1,2,0
1916,Oliver Norwood,41,26,18,18,5,20,47,42.6,27,24,9,15,21,39,0
1917,Tijjani Noslin,18,8,5,7,6,6,16,37.5,10,17,2,15,2,14,0
1918,Randy Nteka,11,4,1,6,4,4,10,40.0,6,6,1,5,2,11,1
1919,Ernest Nuamah,28,14,18,6,4,12,38,31.6,26,15,1,14,8,9,0
1920,Alexander Nübel,2,2,2,0,0,2,4,50.0,2,0,0,0,0,13,4
1921,Kasim Nuhu,0,0,0,0,0,0,0,,0,0,0,0,0,0,0
1922,Matheus Nunes,3,1,3,0,0,2,6,33.3,4,0,0,0,6,1,0
1923,Matheus Nunes,10,4,1,7,2,5,16,31.3,11,7,1,6,1,8,1
1924,Darwin Núñez,22,12,2,10,10,11,23,47.8,12,18,6,12,3,9,0
1925,Unai Núñez,51,28,30,19,2,23,49,46.9,26,38,24,14,52,153,3
1926,Fabian Nürnberger,29,22,22,6,1,22,41,53.7,19,11,1,10,17,26,0
1927,Ethan Nwaneri,0,0,0,0,0,0,0,,0,1,0,1,0,0,0
1928,Simeon Nwankwo,6,3,0,2,4,1,3,33.3,2,7,0,7,0,4,0
1929,Gerzino Nyamsi,18,14,13,5,0,12,18,66.7,6,19,11,8,10,43,0
1930,Ørjan Nyland,0,0,0,0,0,0,1,0.0,1,0,0,0,0,9,1
1931,Rabby Nzingoula,3,3,0,3,0,3,4,75.0,1,4,0,4,5,0,0
1932,M'Bala Nzola,11,8,1,4,6,6,7,85.7,1,10,1,9,0,22,0
1933,Christian Nørgaard,81,50,42,31,8,32,87,36.8,55,48,6,42,54,50,0
1934,Jake O'Brien,22,16,16,5,1,14,20,70.0,6,23,18,5,12,98,1
1935,Mark O'Mahony,1,0,1,0,0,1,2,50.0,1,2,1,1,0,1,0
1936,Dara O'Shea,39,20,22,14,3,11,26,42.3,15,41,30,11,35,158,2
1937,Michael Obafemi,0,0,0,0,0,0,0,,0,1,0,1,0,0,0
1938,Adam Obert,17,9,8,8,1,8,17,47.1,9,13,7,6,21,41,1
1939,Pedro Obiang,8,4,3,4,1,2,10,20.0,8,6,4,2,8,10,0
1940,Jan Oblak,0,0,0,0,0,0,0,,0,0,0,0,0,10,0
1941,Brian Ocampo,4,3,1,3,0,2,5,40.0,3,4,0,4,3,0,0
1942,Lucas Ocampos,66,47,22,27,17,29,58,50.0,29,34,1,33,21,29,0
1943,Guillermo Ochoa,0,0,0,0,0,0,1,0.0,1,0,0,0,0,9,1
1944,Jens Odgaard,4,4,1,1,2,1,3,33.3,2,9,0,9,1,3,0
1945,Wilson Odobert,17,13,8,5,4,6,22,27.3,16,26,2,24,6,14,0
1946,Álvaro Odriozola,9,7,7,1,1,5,5,100.0,0,2,1,1,8,7,0
1947,Tim Oermann,19,11,11,4,4,9,14,64.3,5,15,6,9,2,22,0
1948,Odeluga Offiah,1,0,1,0,0,1,1,100.0,0,0,0,0,1,0,0
1949,Chiedozie Ogbene,17,10,10,7,0,12,22,54.5,10,14,3,11,7,34,2
1950,Angelo Ogbonna,11,5,9,2,0,6,7,85.7,1,13,10,3,3,29,0
1951,Florent Ogier,19,9,13,6,0,11,18,61.1,7,25,19,6,9,35,3
1952,Noah Okafor,6,4,1,4,1,3,10,30.0,7,8,1,7,0,10,0
1953,David Okereke,3,1,1,1,1,0,3,0.0,3,2,0,2,1,0,0
1954,Caleb Okoli,56,34,33,22,1,29,44,65.9,15,48,32,16,29,156,4
1955,Maduka Okoye,0,0,0,0,0,0,0,,0,0,0,0,1,4,2
1956,Masaya Okugawa,0,0,0,0,0,0,0,,0,0,0,0,0,2,0
1957,Joseph Okumu,44,28,28,14,2,24,38,63.2,14,27,19,8,35,112,2
1958,Aingeru Olabarrieta,0,0,0,0,0,0,0,,0,0,0,0,0,0,0
1959,Michael Olakigbe,3,0,2,1,0,2,4,50.0,2,7,0,7,1,0,1
1960,Olasagasti,16,13,4,7,5,5,8,62.5,3,2,0,2,3,5,1
1961,Finn Ole Becker,10,9,8,2,0,4,17,23.5,13,9,1,8,1,10,0
1962,Mathias Olesen,0,0,0,0,0,0,0,,0,0,0,0,2,2,0
1963,Michael Olise,19,10,7,10,2,8,24,33.3,16,21,0,21,11,9,0
1964,Mathías Olivera,50,29,29,15,6,23,39,59.0,16,35,6,29,20,25,0
1965,Dani Olmo,26,18,14,8,4,10,22,45.5,12,7,0,7,13,12,1
1966,Robin Olsen,0,0,0,0,0,0,0,,0,0,0,0,0,1,0
1967,Warmed Omari,32,19,23,7,2,16,28,57.1,12,30,20,10,33,77,2
1968,Becir Omeragic,48,29,31,13,4,20,33,60.6,13,51,29,22,27,65,0
1969,Jonas Omlin,1,0,1,0,0,1,1,100.0,0,0,0,0,0,3,0
1970,Andrew Omobamidele,10,3,9,1,0,5,8,62.5,3,12,8,4,13,42,1
1971,Samuel Omorodion,6,3,1,4,1,0,4,0.0,4,11,2,9,1,14,0
1972,Samuel Omorodion,1,1,0,1,0,1,1,100.0,0,0,0,0,0,0,0
1973,Amadou Onana,71,38,32,31,8,21,42,50.0,21,25,6,19,21,31,0
1974,André Onana,2,0,2,0,0,2,2,100.0,0,0,0,0,0,11,2
1975,Jean Onana,23,14,6,14,3,13,25,52.0,12,10,2,8,11,11,1
1976,Ryan One,0,0,0,0,0,0,0,,0,0,0,0,0,0,0
1977,Karim Onisiwo,17,8,4,6,7,6,11,54.5,5,18,4,14,2,7,0
1978,Tyler Onyango,0,0,0,0,0,0,0,,0,0,0,0,0,0,0
1979,Fred Onyedinma,10,6,7,3,0,5,12,41.7,7,3,0,3,1,13,0
1980,Frank Onyeka,37,24,9,23,5,16,29,55.2,13,15,7,8,23,17,0
1981,Loïs Openda,3,3,0,1,2,0,6,0.0,6,19,3,16,5,14,0
1982,Royce Openda Owaga,0,0,0,0,0,0,0,,0,0,0,0,0,0,0
1983,Christopher Operi,55,36,37,15,3,32,59,54.2,27,45,7,38,35,68,1
1984,Leon Opitz,2,2,1,1,0,2,3,66.7,1,0,0,0,0,0,0
1985,Gift Orban,4,3,0,1,3,1,4,25.0,3,2,0,2,1,2,1
1986,Willi Orban,20,12,8,10,2,9,18,50.0,9,22,13,9,16,76,1
1987,Ivan Ordets,19,14,11,6,2,10,17,58.8,7,41,29,12,31,130,0
1988,Divock Origi,6,4,5,0,1,0,0,,0,6,0,6,2,4,0
1989,Gaetano Oristanio,20,10,5,14,1,5,17,29.4,12,11,0,11,9,8,0
1990,Aimar Oroz,43,26,18,20,5,13,37,35.1,24,27,2,25,16,11,0
1991,Riccardo Orsolini,23,14,13,4,6,9,30,30.0,21,25,3,22,8,19,1
1992,Stefan Ortega,0,0,0,0,0,0,0,,0,0,0,0,0,2,1
1993,Eneko Ortiz,0,0,0,0,0,0,0,,0,0,0,0,0,0,0
1994,Asier Osambela,2,1,0,1,1,0,0,,0,0,0,0,0,0,0
1995,Ben Osborn,22,9,11,9,2,8,17,47.1,9,18,2,16,8,30,0
1996,Gabriel Osho,41,22,21,19,1,16,27,59.3,11,37,20,17,31,92,0
1997,Victor Osimhen,9,5,0,4,5,2,4,50.0,2,5,1,4,2,18,0
1998,Milutin Osmajić,0,0,0,0,0,0,0,,0,0,0,0,0,0,0
1999,Patrick Osterhage,38,26,14,23,1,17,36,47.2,19,36,9,27,27,32,1
2000,William Osula,2,2,1,0,1,1,2,50.0,1,3,1,2,2,9,0
2001,Dango Ouattara,45,27,22,11,12,19,34,55.9,15,18,3,15,22,35,0
2002,Kassoum Ouattara,17,12,8,5,4,9,20,45.0,11,11,0,11,13,20,0
2003,Remi Oudin,26,14,12,12,2,12,19,63.2,7,13,1,12,20,22,0
2004,Alexandre Oukidja,2,1,2,0,0,1,2,50.0,1,1,0,1,3,24,3
2005,Azzedine Ounahi,25,11,9,14,2,11,32,34.4,21,6,1,5,11,8,0
2006,Adam Ounas,4,3,2,2,0,2,7,28.6,5,2,0,2,6,1,0
2007,Patrick Ouotro,0,0,0,0,0,0,0,,0,0,0,0,0,0,0
2008,Aiham Ousou,8,5,6,2,0,5,5,100.0,0,1,0,1,7,15,0
2009,Jesús Owono,0,0,0,0,0,0,0,,0,0,0,0,0,3,0
2010,Mikel Oyarzabal,23,18,7,11,5,7,21,33.3,14,25,4,21,4,12,0
2011,Anthony Oyono,37,26,21,14,2,23,34,67.6,11,17,3,14,9,32,0
2012,Salih Özcan,20,12,11,8,1,10,18,55.6,8,28,3,25,17,18,1
2013,Cenk Özkacar,26,15,22,4,0,15,23,65.2,8,18,7,11,18,84,1
2014,David Ozoh,10,6,3,6,1,5,6,83.3,1,2,0,2,0,2,0
2015,Jon Pacheco,25,15,21,4,0,14,22,63.6,8,17,6,11,10,53,1
2016,Willian Pacho,62,37,38,23,1,31,53,58.5,22,51,22,29,47,152,2
2017,Gonçalo Paciência,8,4,2,2,4,3,6,50.0,3,5,0,5,0,7,0
2018,Simone Pafundi,0,0,0,0,0,0,0,,0,0,0,0,0,0,0
2019,Riccardo Pagano,2,2,1,1,0,0,6,0.0,6,3,2,1,0,2,0
2020,Pablo Pagis,10,6,5,4,1,6,10,60.0,4,2,0,2,3,1,0
2021,Exequiel Palacios,60,34,28,26,6,26,53,49.1,27,24,0,24,29,20,2
2022,Isaac Palazón Camacho,46,25,16,21,9,20,58,34.5,38,29,2,27,16,41,0
2023,João Palhinha,152,75,80,60,12,103,152,67.8,49,57,9,48,46,58,0
2024,Nicolas Pallois,34,19,21,11,2,19,35,54.3,16,37,26,11,26,111,0
2025,Cole Palmer,23,12,9,6,8,8,19,42.1,11,20,2,18,20,13,2
2026,Cole Palmer,0,0,0,0,0,0,0,,0,0,0,0,0,0,0
2027,Emerson Palmieri,106,68,48,42,16,57,90,63.3,33,47,15,32,43,96,0
2028,Joaquín Panichelli,3,3,1,1,1,1,2,50.0,1,1,0,1,1,4,0
2029,Miloš Pantović,0,0,0,0,0,0,0,,0,0,0,0,0,0,0
2030,Antonios Papadopoulos,6,3,6,0,0,6,7,85.7,1,3,2,1,2,7,0
2031,Christos Papadopoulos,0,0,0,0,0,0,1,0.0,1,0,0,0,0,0,0
2032,Sokratis Papastathopoulos,21,14,16,5,0,13,17,76.5,4,15,9,6,6,60,0
2033,Matondo-Merveille Papela,5,4,2,3,0,0,4,0.0,4,1,0,1,4,2,0
2034,Leart Paqarada,21,11,9,9,3,11,22,50.0,11,17,5,12,10,30,1
2035,Lucas Paquetá,71,48,38,26,7,25,52,48.1,27,28,1,27,21,28,2
2036,Victor Parada,1,1,0,1,0,1,1,100.0,0,0,0,0,0,0,0
2037,Aitor Paredes,20,11,11,9,0,7,14,50.0,7,23,11,12,33,104,0
2038,Kevin Paredes,42,21,22,13,7,20,34,58.8,14,27,2,25,23,26,0
2039,Leandro Paredes,57,36,30,22,5,33,77,42.9,44,26,7,19,29,43,1
2040,Daniel Parejo,43,30,16,21,6,20,46,43.5,26,25,9,16,21,29,3
2041,Fabiano Parisi,30,15,11,12,7,15,26,57.7,11,21,5,16,17,26,0
2042,Ben Parkinson,0,0,0,0,0,0,0,,0,1,0,1,0,1,0
2043,Thomas Partey,14,11,9,4,1,5,10,50.0,5,9,3,6,11,9,0
2044,Mario Pašalić,28,17,9,18,1,14,31,45.2,17,29,6,23,16,34,0
2045,Triantafyllos Pasaridīs,11,7,9,2,0,9,14,64.3,5,7,3,4,3,19,0
2046,Pascu,0,0,0,0,0,0,0,,0,0,0,0,0,0,0
2047,Felix Passlack,21,14,9,10,2,14,24,58.3,10,13,2,11,10,21,0
2048,Patric,13,8,10,3,0,8,18,44.4,10,15,9,6,6,44,0
2049,Rui Patrício,0,0,0,0,0,0,1,0.0,1,1,0,1,0,3,1
2050,Nathan Patterson,34,24,21,11,2,14,37,37.8,23,14,3,11,9,33,0
2051,Gabriel Paulista,7,5,4,3,0,3,4,75.0,1,5,3,2,4,27,0
2052,Gabriel Paulista,10,7,8,2,0,6,11,54.5,5,15,7,8,24,78,0
2053,Benjamin Pavard,34,21,21,11,2,20,24,83.3,4,25,15,10,32,44,1
2054,Jiří Pavlenka,0,0,0,0,0,0,0,,0,0,0,0,0,2,0
2055,Aleksandar Pavlovic,28,16,10,14,4,17,33,51.5,16,13,3,10,17,12,0
2056,Leonardo Pavoletti,1,1,0,0,1,0,1,0.0,1,2,1,1,0,7,0
2057,Martín Payero,54,32,28,19,7,19,46,41.3,27,25,7,18,15,21,0
2058,Nicolás Paz,0,0,0,0,0,0,0,,0,2,0,2,1,0,0
2059,Myles Peart-Harris,0,0,0,0,0,0,0,,0,0,0,0,0,1,0
2060,Sydie Peck,0,0,0,0,0,0,0,,0,0,0,0,0,0,0
2061,Mads Pedersen,64,39,31,27,6,24,44,54.5,20,20,3,17,19,46,0
2062,Marcus Pedersen,36,24,25,5,6,21,25,84.0,4,19,5,14,10,51,0
2063,Alfonso Pedraza,25,9,18,5,2,9,17,52.9,8,16,7,9,13,19,0
2064,Pedri,33,24,16,13,4,8,27,29.6,19,27,3,24,14,10,0
2065,Pedro,16,12,5,7,4,3,12,25.0,9,16,2,14,3,1,0
2066,Adrià Pedrosa,46,26,28,14,4,23,34,67.6,11,26,6,20,15,54,0
2067,Jordan Pefok,10,4,0,8,2,3,8,37.5,5,12,3,9,5,28,0
2068,Jordan Pefok,0,0,0,0,0,0,0,,0,1,1,0,0,0,0
2069,Dženan Pejčinović,0,0,0,0,0,0,0,,0,1,0,1,0,0,0
2070,Pietro Pellegri,5,1,1,4,0,1,5,20.0,4,4,1,3,2,3,0
2071,Lorenzo Pellegrini,35,20,14,16,5,17,51,33.3,34,28,5,23,20,22,0
2072,Luca Pellegrini,18,13,7,10,1,9,17,52.9,8,7,3,4,9,20,0
2073,Marco Pellegrino,8,6,4,3,1,5,10,50.0,5,11,6,5,10,28,0
2074,Marco Pellegrino,1,1,0,0,1,0,2,0.0,2,1,1,0,1,2,0
2075,Facundo Pellistri,5,3,4,1,0,1,3,33.3,2,7,1,6,1,5,0
2076,Facundo Pellistri,29,19,12,10,7,6,21,28.6,15,18,0,18,4,7,0
2077,Andy Pelmard,51,38,41,9,1,32,40,80.0,8,37,20,17,33,99,2
2078,Aurélien Pelon,1,0,1,0,0,0,2,0.0,2,2,2,0,0,7,0
2079,Faris Pemi Moumbagna,2,1,0,2,0,0,3,0.0,3,4,0,4,3,1,0
2080,Iñaki Peña,0,0,0,0,0,0,1,0.0,1,0,0,0,0,5,1
2081,Marcos Peña,19,14,12,7,0,6,12,50.0,6,9,3,6,13,8,0
2082,Rubén Peña,47,25,22,18,7,20,49,40.8,29,37,8,29,30,39,3
2083,Pepín,6,1,1,4,1,2,4,50.0,2,5,2,3,0,6,0
2084,Alberto Perea,0,0,0,0,0,0,2,0.0,2,0,0,0,0,0,0
2085,Andreas Pereira,25,12,4,12,9,11,41,26.8,30,16,2,14,4,12,0
2086,Danilo Pereira,22,12,14,6,2,9,17,52.9,8,29,26,3,23,100,1
2087,Mathias Pereira Lage,21,15,7,8,6,7,28,25.0,21,14,5,9,10,13,0
2088,Pedro Pereira,19,13,14,4,1,9,17,52.9,8,15,2,13,4,18,0
2089,Daniel Peretz,0,0,0,0,0,0,0,,0,0,0,0,0,0,0
2090,Roberto Pereyra,19,9,11,5,3,11,29,37.9,18,20,4,16,7,18,0
2091,Ayoze Pérez,59,32,16,33,10,21,49,42.9,28,42,4,38,22,18,0
2092,Carles Pérez,13,5,6,5,2,7,18,38.9,11,14,1,13,5,8,0
2093,Francisco Perez,30,17,10,14,6,15,44,34.1,29,19,0,19,14,5,0
2094,Kike Pérez,27,11,11,15,1,11,23,47.8,12,11,0,11,8,6,0
2095,Nehuén Pérez,72,48,42,28,2,39,48,81.3,9,53,26,27,45,158,1
2096,Matteo Perez Vinlöf,0,0,0,0,0,0,0,,0,0,0,0,1,0,0
2097,Simone Perilli,0,0,0,0,0,0,0,,0,0,0,0,0,0,0
2098,Mattia Perin,0,0,0,0,0,0,0,,0,0,0,0,0,1,0
2099,Samuele Perisan,0,0,0,0,0,0,0,,0,0,0,0,0,0,0
2100,Ivan Perišić,3,2,1,1,1,3,5,60.0,2,1,0,1,2,1,0
2101,Romain Perraud,7,6,5,1,1,4,11,36.4,7,4,0,4,6,15,1
2102,Lucas Perrin,47,30,33,14,0,28,46,60.9,18,45,32,13,28,113,0
2103,Máximo Perrone,42,21,17,22,3,19,39,48.7,20,27,4,23,24,21,0
2104,Pavao Pervan,0,0,0,0,0,0,0,,0,0,0,0,0,4,0
2105,Matteo Pessina,44,25,20,20,4,23,49,46.9,26,29,11,18,27,46,1
2106,Andrea Petagna,4,2,1,0,3,1,2,50.0,1,6,3,3,1,4,0
2107,Denis Petrić,0,0,0,0,0,0,0,,0,0,0,0,0,0,0
2108,Njegoš Petrović,5,2,4,1,0,2,3,66.7,1,2,0,2,1,3,0
2109,Đorđe Petrović,0,0,0,0,0,0,0,,0,0,0,0,0,12,3
2110,Jens Petter Hauge,2,1,1,0,1,2,7,28.6,5,5,1,4,0,1,0
2111,Germán Pezzella,34,24,24,10,0,23,38,60.5,15,31,18,13,31,150,0
2112,Giuseppe Pezzella,25,14,19,5,1,20,28,71.4,8,17,6,11,2,35,0
2113,Luca Pfeiffer,11,6,2,6,3,5,11,45.5,6,5,1,4,2,21,0
2114,Patric Pfeiffer,11,7,6,4,1,5,6,83.3,1,10,6,4,11,21,0
2115,Maximilian Philipp,8,5,4,4,0,1,6,16.7,5,7,0,7,1,3,0
2116,Kalvin Phillips,11,6,2,8,1,5,9,55.6,4,4,1,3,4,2,1
2117,Kalvin Phillips,3,3,1,1,1,0,0,,0,0,0,0,2,2,0
2118,Jaden Philogene Bidace,0,0,0,0,0,0,0,,0,0,0,0,0,0,0
2119,Kamil Piątkowski,18,10,16,1,1,10,14,71.4,4,6,5,1,8,28,1
2120,Roberto Piccoli,1,1,0,0,1,1,1,100.0,0,0,0,0,0,0,0
2121,Roberto Piccoli,10,6,3,5,2,1,4,25.0,3,17,1,16,4,16,0
2122,Florian Pick,4,4,3,0,1,2,3,66.7,1,2,0,2,2,2,0
2123,Jordan Pickford,1,0,1,0,0,1,1,100.0,0,3,0,3,0,19,1
2124,Amos Pieper,14,11,8,6,0,7,13,53.8,6,12,7,5,9,36,1
2125,Marvin Pieringer,19,12,5,11,3,8,20,40.0,12,28,4,24,12,21,0
2126,Santiago Pierotti,8,8,2,5,1,2,8,25.0,6,5,0,5,1,0,0
2127,Niccolò Pierozzi,17,11,13,4,0,11,22,50.0,11,24,7,17,11,36,0
2128,Ronaël Pierre-Gabriel,15,9,12,2,1,5,7,71.4,2,13,4,9,8,25,0
2129,Andrea Pinamonti,13,8,1,6,6,5,22,22.7,17,19,2,17,1,40,0
2130,Ethan Pinnock,35,23,22,13,0,9,20,45.0,11,40,24,16,43,170,3
2131,Yeremi Pino,25,18,12,10,3,9,18,50.0,9,11,1,10,5,5,0
2132,Carlo Pinsoglio,0,0,0,0,0,0,0,,0,0,0,0,0,0,0
2133,Lorenzo Pirola,39,23,25,14,0,15,28,53.6,13,46,30,16,25,93,1
2134,Niccolò Pisilli,0,0,0,0,0,0,0,,0,0,0,0,0,0,0
2135,Alassane Pléa,17,7,5,8,4,7,15,46.7,8,11,0,11,2,6,0
2136,Tommaso Pobega,16,9,11,5,0,6,13,46.2,7,10,2,8,6,7,0
2137,Paul Pogba,1,1,0,1,0,1,1,100.0,0,0,0,0,1,1,0
2138,Ole Pohlmann,1,0,0,1,0,1,2,50.0,1,0,0,0,0,1,0
2139,Matteo Politano,19,8,8,7,4,11,34,32.4,23,9,1,8,15,11,1
2140,Sebastian Polter,1,0,1,0,0,0,1,0.0,1,5,1,4,0,4,0
2141,Julien Ponceau,32,15,12,14,6,9,30,30.0,21,22,1,21,19,20,0
2142,Marin Pongračić,43,30,22,20,1,19,25,76.0,6,37,26,11,51,130,1
2143,Nick Pope,0,0,0,0,0,0,1,0.0,1,0,0,0,0,7,2
2144,Pedro Porro,91,63,43,34,14,62,120,51.7,58,63,18,45,34,102,3
2145,Portu,5,3,4,0,1,5,6,83.3,1,0,0,0,0,0,0
2146,Portu,18,13,3,10,5,3,18,16.7,15,9,1,8,4,6,0
2147,Stefan Posch,77,46,35,38,4,49,88,55.7,39,27,8,19,18,72,0
2148,Yussuf Poulsen,13,8,1,9,3,4,14,28.6,10,13,3,10,4,15,0
2149,José Pozo,1,1,0,1,0,1,1,100.0,0,1,0,1,0,0,0
2150,Alejandro Pozo Pozo,19,12,11,6,2,12,20,60.0,8,14,4,10,7,21,0
2151,Beñat Prados,45,28,11,23,11,23,42,54.8,19,32,5,27,23,27,0
2152,Matteo Prati,45,25,15,27,3,26,42,61.9,16,29,6,23,15,26,1
2153,Abdón Prats,6,4,2,2,2,3,5,60.0,2,6,3,3,2,12,0
2154,Sanjin Prcić,0,0,0,0,0,0,1,0.0,1,2,1,1,3,1,0
2155,Grischa Prömel,32,18,11,15,6,14,32,43.8,18,22,6,16,22,36,0
2156,Ivan Provedel,1,0,1,0,0,1,3,33.3,2,0,0,0,0,12,1
2157,Pubill,47,23,35,8,4,22,39,56.4,17,20,8,12,15,83,1
2158,Gustavo Puerta,5,3,2,2,1,1,2,50.0,1,2,0,2,0,0,0
2159,Antonio Puertas,12,8,6,5,1,6,15,40.0,9,5,0,5,6,4,0
2160,Arnau Puigmal,2,1,1,1,0,1,3,33.3,2,3,0,3,3,2,0
2161,Christian Pulisic,35,26,14,11,10,17,30,56.7,13,20,1,19,10,10,1
2162,George Pușcaș,0,0,0,0,0,0,3,0.0,3,1,0,1,0,1,0
2163,Jarell Quansah,25,22,17,7,1,14,20,70.0,6,16,8,8,17,39,1
2164,Domingos Quina,1,1,1,0,0,0,0,,0,0,0,0,0,0,0
2165,Adrien Rabiot,58,39,22,30,6,30,45,66.7,15,26,6,20,25,34,0
2166,Uroš Račić,10,4,6,4,0,0,9,0.0,9,16,7,9,7,22,0
2167,Nemanja Radonjić,1,1,0,0,1,1,3,33.3,2,3,0,3,0,0,0
2168,Nemanja Radonjić,4,2,1,3,0,1,4,25.0,3,2,0,2,3,3,0
2169,Aleksandar Radovanović,8,7,7,1,0,6,6,100.0,0,8,8,0,11,48,0
2170,Ionuț Radu,0,0,0,0,0,0,0,,0,0,0,0,0,0,0
2171,Boris Radunović,0,0,0,0,0,0,0,,0,0,0,0,1,1,2
2172,Hamza Rafia,44,31,13,27,4,13,30,43.3,17,27,1,26,11,13,0
2173,Abdellah Raihani,0,0,0,0,0,0,1,0.0,1,0,0,0,0,0,0
2174,Antonio Raillo,30,23,18,12,0,17,23,73.9,6,44,30,14,37,104,2
2175,Luca Raimund,3,1,2,1,0,0,0,,0,2,0,2,0,0,0
2176,Predrag Rajković,2,1,2,0,0,2,2,100.0,0,0,0,0,0,14,0
2177,Jesurun Rak Sakyi,4,1,3,1,0,2,3,66.7,1,2,0,2,3,1,0
2178,Ivan Rakitić,30,16,9,12,9,11,19,57.9,8,16,5,11,14,12,0
2179,Ylber Ramadani,68,41,32,29,7,37,96,38.5,59,54,13,41,44,44,0
2180,Largie Ramazani,12,7,5,6,1,6,26,23.1,20,16,2,14,34,10,0
2181,Benito Ramírez,5,3,2,3,0,3,6,50.0,3,7,1,6,3,0,0
2182,Sandro Ramírez,12,8,4,6,2,6,15,40.0,9,13,1,12,4,14,1
2183,Chris Ramos,28,15,9,15,4,8,27,29.6,19,23,7,16,9,44,0
2184,Gonçalo Ramos,25,15,4,12,9,6,20,30.0,14,12,2,10,5,16,0
2185,Sergio Ramos,45,30,32,11,2,27,40,67.5,13,35,30,5,41,156,0
2186,Aaron Ramsdale,0,0,0,0,0,0,0,,0,0,0,0,0,3,2
2187,Aaron Ramsey,17,14,7,5,5,8,16,50.0,8,11,2,9,1,10,0
2188,Jacob Ramsey,16,8,7,6,3,5,15,33.3,10,15,2,13,3,8,0
2189,Luca Ranieri,14,10,11,1,2,8,13,61.5,5,25,11,14,29,64,0
2190,Filippo Ranocchia,16,11,7,9,0,7,16,43.8,9,9,1,8,3,14,0
2191,Grant Ranos,1,0,0,0,1,0,0,,0,0,0,0,0,0,0
2192,Raphinha,14,8,6,6,2,4,18,22.2,14,17,1,16,13,11,0
2193,Nicolai Rapp,3,2,2,1,0,2,2,100.0,0,2,0,2,2,8,0
2194,Elba Rashani,30,18,4,17,9,11,24,45.8,13,17,3,14,12,15,0
2195,Marcus Rashford,19,12,9,4,6,9,26,34.6,17,15,1,14,4,21,0
2196,Giacomo Raspadori,21,10,6,10,5,6,15,40.0,9,15,1,14,3,7,0
2197,Andrei Ratiu,12,4,6,5,1,8,15,53.3,7,4,1,3,0,12,0
2198,Raúl,10,4,4,2,4,2,10,20.0,8,9,1,8,5,11,0
2199,David Raum,58,35,24,29,5,34,58,58.6,24,51,9,42,27,82,2
2200,Federico Ravaglia,0,0,0,0,0,0,0,,0,0,0,0,0,2,0
2201,David Raya,1,1,1,0,0,1,1,100.0,0,0,0,0,0,8,5
2202,Tim Ream,20,9,13,5,2,9,18,50.0,9,23,15,8,25,61,2
2203,Abderrahman Rebbach,9,5,4,2,3,5,15,33.3,10,10,1,9,3,7,0
2204,Nathan Redmond,2,1,0,0,2,1,4,25.0,3,1,0,1,0,3,0
2205,Harrison Reed,29,18,9,17,3,13,31,41.9,18,19,9,10,11,24,0
2206,Sergio Reguilón,13,8,6,2,5,8,17,47.1,9,10,0,10,5,7,0
2207,Sergio Reguilón,45,20,26,18,1,24,40,60.0,16,23,6,17,16,41,1
2208,Bobby Reid,22,14,5,15,2,4,16,25.0,12,24,2,22,5,14,0
2209,Tijjani Reijnders,46,25,10,31,5,21,43,48.8,22,26,8,18,18,26,0
2210,Pepe Reina,0,0,0,0,0,0,0,,0,0,0,0,0,1,0
2211,Reinier,21,10,6,12,3,5,17,29.4,12,24,4,20,10,5,0
2212,Rocco Reitz,61,36,28,29,4,28,55,50.9,27,61,20,41,44,31,1
2213,Álex Remiro,0,0,0,0,0,0,0,,0,0,0,0,0,24,2
2214,Guillaume Restes,0,0,0,0,0,0,3,0.0,3,0,0,0,0,19,1
2215,Mateo Retegui,17,9,7,8,2,6,20,30.0,14,18,2,16,0,30,0
2216,Marco Reus,37,25,20,14,3,12,27,44.4,15,17,2,15,5,18,0
2217,Elvis Rexhbeçaj,30,19,14,13,3,18,36,50.0,18,32,7,25,20,20,0
2218,Gio Reyna,7,3,4,0,3,3,6,50.0,3,3,0,3,2,0,0
2219,Gio Reyna,9,6,3,4,2,2,5,40.0,3,5,1,4,2,5,0
2220,Chadi Riad,35,24,17,18,0,17,27,63.0,10,23,14,9,23,108,0
2221,Alexsandro Ribeiro,32,22,24,8,0,16,31,51.6,15,25,15,10,35,116,5
2222,Rodrigo Ribeiro,0,0,0,0,0,0,1,0.0,1,1,0,1,1,0,0
2223,Samuele Ricci,33,18,17,12,4,15,23,65.2,8,21,3,18,27,25,0
2224,Declan Rice,83,51,37,38,8,32,57,56.1,25,37,11,26,44,52,0
2225,Chris Richards,46,28,21,22,3,20,30,66.7,10,32,12,20,27,109,0
2226,Amir Richardson,33,23,12,18,3,10,22,45.5,12,26,5,21,15,30,0
2227,Richarlison,16,11,4,8,4,2,10,20.0,8,32,6,26,8,23,0
2228,Marco Richter,10,4,5,3,2,4,11,36.4,7,9,0,9,2,1,0
2229,Diego Rico,64,48,32,23,9,41,76,53.9,35,25,8,17,41,76,0
2230,Clemens Riedel,22,13,16,5,1,15,24,62.5,9,11,3,8,11,26,0
2231,Fabian Rieder,13,7,2,9,2,6,11,54.5,5,3,1,2,5,2,0
2232,Jaïro Riedewald,9,3,2,4,3,3,6,50.0,3,0,0,0,2,2,0
2233,Manuel Riemann,2,1,2,0,0,2,4,50.0,2,0,0,0,1,25,1
2234,Luis Rioja,27,19,10,12,5,14,43,32.6,29,28,1,27,16,28,0
2235,Rémy Riou,0,0,0,0,0,0,1,0.0,1,0,0,0,0,1,1
2236,Rodrigo Riquelme,30,19,18,4,8,18,46,39.1,28,19,0,19,9,20,0
2237,Alberto Risco,2,2,1,1,0,0,4,0.0,4,0,0,0,0,1,0
2238,Mihailo Ristić,15,9,9,6,0,9,12,75.0,3,9,2,7,10,23,0
2239,Matt Ritchie,5,3,2,2,1,2,4,50.0,2,3,2,1,1,5,0
2240,Gorka Rivera Alonso,0,0,0,0,0,0,0,,0,0,0,0,0,0,0
2241,Sergi Roberto,15,10,4,10,1,3,11,27.3,8,7,2,5,8,7,1
2242,Lucas Robertone,61,33,28,23,10,25,50,50.0,25,43,9,34,51,43,0
2243,Connor Roberts,12,5,6,4,2,8,17,47.1,9,8,6,2,4,25,2
2244,Andrew Robertson,35,24,21,11,3,26,43,60.5,17,20,6,14,13,40,0
2245,Antonee Robinson,93,58,60,26,7,52,110,47.3,58,56,8,48,80,117,3
2246,Jack Robinson,43,28,29,14,0,25,39,64.1,14,49,33,16,33,132,2
2247,Marc Roca,52,36,17,29,6,30,53,56.6,23,29,6,23,17,23,1
2248,Sebastian Rode,6,4,0,5,1,4,6,66.7,2,0,0,0,1,1,0
2249,Sergio Rodelas,3,2,1,0,2,0,3,0.0,3,0,0,0,0,0,0
2250,Rodri,70,43,25,33,12,29,60,48.3,31,32,8,24,26,41,4
2251,Rodri,17,10,6,7,4,8,21,38.1,13,11,0,11,8,2,0
2252,Óscar Rodríguez Arnaiz,24,13,2,15,7,9,15,60.0,6,12,1,11,5,5,0
2253,Damián Rodríguez,6,3,1,3,2,1,3,33.3,2,4,2,2,1,2,0
2254,Dani Rodríguez,47,24,21,20,6,21,45,46.7,24,34,5,29,15,21,0
2255,Guido Rodríguez,53,30,21,24,8,34,55,61.8,21,27,6,21,29,44,0
2256,Jay Rodriguez,14,9,7,4,3,7,13,53.8,6,11,1,10,1,8,0
2257,Kirian Rodríguez,52,32,22,25,5,24,67,35.8,43,39,3,36,28,23,1
2258,Miguel Rodríguez,6,3,3,1,2,3,9,33.3,6,8,0,8,4,0,0
2259,Ricardo Rodríguez,45,26,21,22,2,28,45,62.2,17,22,9,13,24,64,2
2260,Rodrygo,16,15,2,9,5,5,19,26.3,14,14,0,14,8,6,0
2261,Mads Roerslev,48,31,34,9,5,27,54,50.0,27,15,3,12,19,71,0
2262,Rogério,14,6,7,5,2,10,14,71.4,4,16,5,11,5,23,1
2263,Morgan Rogers,8,1,3,2,3,2,11,18.2,9,11,0,11,3,11,0
2264,Merlin Röhl,21,13,10,9,2,8,21,38.1,13,27,3,24,9,22,0
2265,Alessio Romagnoli,25,18,14,11,0,16,24,66.7,8,29,17,12,29,115,0
2266,Simone Romagnoli,35,15,23,11,1,15,20,75.0,5,51,36,15,29,147,0
2267,Carlos Romero,11,5,8,1,2,7,12,58.3,5,3,0,3,1,11,0
2268,Cristian Romero,66,40,35,25,6,32,44,72.7,12,46,22,24,44,106,1
2269,Luka Romero,0,0,0,0,0,0,3,0.0,3,2,0,2,0,0,0
2270,Luka Romero,5,1,2,3,0,2,4,50.0,2,12,1,11,1,2,1
2271,Oriol Romeu,34,20,17,14,3,13,24,54.2,11,12,2,10,10,18,0
2272,Valentin Rongier,23,12,9,12,2,14,26,53.8,12,16,4,12,15,18,0
2273,Frank Ronstadt,1,0,0,1,0,0,1,0.0,1,1,0,1,1,3,0
2274,Marten de Roon,80,43,36,32,12,35,82,42.7,47,36,10,26,40,54,0
2275,Unai Ropero,0,0,0,0,0,0,0,,0,0,0,0,0,0,0
2276,Vitor Roque,3,2,2,0,1,0,2,0.0,2,3,0,3,0,5,0
2277,Pablo Rosario,36,25,15,16,5,23,34,67.6,11,27,13,14,29,39,0
2278,Valentin Rosier,1,0,1,0,0,0,0,,0,1,0,1,2,5,0
2279,Francesco Rossi,0,0,0,0,0,0,0,,0,0,0,0,0,0,0
2280,Joe Rothwell,7,2,4,2,1,2,8,25.0,6,4,2,2,3,2,0
2281,Anthony Rouault,21,12,14,5,2,13,21,61.9,8,14,8,6,8,28,0
2282,Jérôme Roussillon,16,9,6,7,3,8,12,66.7,4,13,4,9,5,26,0
2283,Nicolò Rovella,46,28,25,17,4,16,36,44.4,20,27,6,21,23,29,0
2284,Amir Rrahmani,33,27,17,14,2,16,32,50.0,16,24,10,14,20,90,0
2285,Ruan,25,15,11,10,4,10,18,55.6,8,18,15,3,24,68,2
2286,Pelly Ruddock Mpanzu,13,5,6,6,1,5,9,55.6,4,15,7,8,9,16,3
2287,Antonio Rüdiger,26,15,18,4,4,16,20,80.0,4,27,20,7,11,89,0
2288,Fabian Rüdlin,1,0,0,0,1,0,0,,0,0,0,0,0,0,0
2289,Javier Rueda Garcia,0,0,0,0,0,0,0,,0,0,0,0,0,0,0
2290,Daniele Rugani,11,9,7,3,1,4,5,80.0,1,11,4,7,9,42,0
2291,Matteo Ruggeri,29,15,14,7,8,16,30,53.3,14,46,4,42,23,44,0
2292,Mário Rui,27,15,17,5,5,14,21,66.7,7,17,2,15,15,19,0
2293,Aitor Ruibal,46,27,28,13,5,32,59,54.2,27,12,1,11,14,33,1
2294,Fabián Ruiz Peña,34,23,17,14,3,23,42,54.8,19,8,2,6,11,21,2
2295,Sergio Ruiz,83,46,43,36,4,38,84,45.2,46,24,6,18,28,43,1
2296,Julian Ryerson,41,23,26,11,4,27,47,57.4,20,31,7,24,10,35,3
2297,Frederik Rønnow,1,1,1,0,0,0,0,,0,0,0,0,1,20,2
2298,José Sá,0,0,0,0,0,0,1,0.0,1,3,0,3,0,21,5
2299,Youssouf Sabaly,16,11,12,3,1,8,12,66.7,4,6,3,3,11,27,0
2300,Emmanuel Sabbi,38,19,15,15,8,16,39,41.0,23,26,2,24,19,7,0
2301,Stefano Sabelli,50,24,28,19,3,15,46,32.6,31,27,6,21,23,35,0
2302,Marcel Sabitzer,39,24,18,20,1,23,42,54.8,19,31,12,19,12,34,0
2303,Falaye Sacko,28,16,13,10,5,21,32,65.6,11,19,7,12,24,37,0
2304,Dominic Sadi,0,0,0,0,0,0,0,,0,0,0,0,0,0,0
2305,Umar Sadiq,15,10,2,8,5,4,8,50.0,4,9,0,9,0,10,0
2306,Alexis Saelemaekers,32,22,13,14,5,12,27,44.4,15,13,1,12,13,10,1
2307,Pablo Saenz,3,3,2,0,1,1,3,33.3,2,0,0,0,0,0,0
2308,Modibo Sagnan,34,22,23,9,2,15,25,60.0,10,13,9,4,15,67,0
2309,Wesley Saïd,8,4,1,2,5,2,9,22.2,7,4,0,4,4,3,0
2310,Théo Sainte-Luce,17,7,10,6,1,11,19,57.9,8,9,4,5,3,15,0
2311,Bukayo Saka,66,35,22,24,20,26,59,44.1,33,43,2,41,15,24,1
2312,Mamadou Sakho,1,1,1,0,0,1,1,100.0,0,0,0,0,0,1,0
2313,Ibrahim Salah,15,7,5,6,4,11,18,61.1,7,4,0,4,10,5,0
2314,Mohamed Salah,17,11,1,8,8,6,21,28.6,15,19,1,18,2,1,0
2315,Amine Salama,0,0,0,0,0,0,0,,0,1,0,1,1,1,0
2316,Kike Salas,41,23,26,12,3,22,36,61.1,14,25,14,11,26,91,1
2317,William Saliba,41,26,28,12,1,20,27,74.1,7,32,17,15,29,81,3
2318,Mohammed Salisu,27,12,11,13,3,17,26,65.4,9,21,12,9,22,44,0
2319,Roland Sallai,17,10,5,5,7,8,20,40.0,12,21,1,20,6,23,0
2320,Yoann Salmier,22,10,13,6,3,13,20,65.0,7,21,15,6,21,57,0
2321,Salvi,0,0,0,0,0,0,4,0.0,4,0,0,0,1,0,0
2322,Lazar Samardzic,40,19,18,18,4,16,39,41.0,23,26,6,20,10,25,0
2323,Diadie Samassékou,5,3,2,2,1,5,6,83.3,1,0,0,0,3,1,0
2324,Diadie Samassékou,0,0,0,0,0,0,0,,0,0,0,0,1,0,0
2325,Mama Samba Baldé,8,5,1,2,5,3,9,33.3,6,0,0,0,3,1,1
2326,Brice Samba,1,1,1,0,0,1,1,100.0,0,0,0,0,0,10,3
2327,Albert Sambi Lokonga,29,18,14,12,3,17,24,70.8,7,23,13,10,11,14,0
2328,Junior Sambia,12,5,8,1,3,6,11,54.5,5,15,7,8,11,28,0
2329,Fede San Emeterio,3,2,2,1,0,1,4,25.0,3,3,2,1,2,1,0
2330,Antonio Sanabria,18,15,5,9,4,4,9,44.4,5,7,1,6,6,12,0
2331,Oihan Sancet,19,11,3,10,6,8,21,38.1,13,5,1,4,10,5,0
2332,Renato Sanches,2,1,1,1,0,2,3,66.7,1,2,0,2,0,1,0
2333,Ricard Sánchez,29,18,15,8,6,12,24,50.0,12,32,4,28,13,64,0
2334,Alexis Sánchez,7,6,0,5,2,1,4,25.0,3,4,1,3,1,3,0
2335,Antonio Sánchez,25,11,13,10,2,11,32,34.4,21,24,5,19,13,13,0
2336,Davinson Sánchez,0,0,0,0,0,0,0,,0,3,2,1,1,2,0
2337,Juanlu Sánchez,56,35,34,18,4,34,58,58.6,24,24,7,17,12,36,0
2338,Manu Sánchez,54,28,21,25,8,31,55,56.4,24,23,3,20,19,65,0
2339,Robert Sánchez,0,0,0,0,0,0,0,,0,0,0,0,0,11,3
2340,Jadon Sancho,1,0,1,0,0,1,3,33.3,2,1,0,1,1,0,0
2341,Jadon Sancho,5,4,1,3,1,0,4,0.0,4,11,0,11,4,6,0
2342,Alex Sandro,13,7,7,6,0,4,5,80.0,1,13,7,6,15,23,0
2343,Ibou Sané,6,4,2,1,3,2,2,100.0,0,3,0,3,1,2,0
2344,Leroy Sané,15,8,6,6,3,4,19,21.1,15,12,0,12,7,3,0
2345,Sadibou Sané,19,12,16,2,1,6,7,85.7,1,14,9,5,8,64,0
2346,Arouna Sangante,53,33,27,23,3,24,40,60.0,16,35,18,17,66,93,2
2347,Ibrahim Sangaré,42,23,25,13,4,12,29,41.4,17,24,7,17,16,21,0
2348,Morgan Sanson,26,19,12,7,7,12,31,38.7,19,34,5,29,20,16,0
2349,Nicola Sansone,11,6,6,2,3,5,16,31.3,11,7,1,6,4,5,2
2350,Baptiste Santamaria,52,33,21,25,6,29,46,63.0,17,15,6,9,34,33,1
2351,Jesús Santiago,17,8,8,5,4,4,7,57.1,3,3,0,3,0,8,0
2352,Andrey Santos,0,0,0,0,0,0,0,,0,1,0,1,0,0,0
2353,Andrey Santos,29,18,15,13,1,17,26,65.4,9,8,0,8,10,11,1
2354,Tiago Santos,63,42,31,19,13,30,52,57.7,22,24,5,19,15,37,0
2355,Paco Sanz,0,0,0,0,0,0,1,0.0,1,0,0,0,0,4,0
2356,Riccardo Saponara,3,1,2,0,1,1,7,14.3,6,4,0,4,0,2,0
2357,Pablo Sarabia,20,13,8,8,4,12,36,33.3,24,17,1,16,10,9,0
2358,Amin Sarr,1,0,0,1,0,0,0,,0,1,0,1,0,1,0
2359,Amin Sarr,3,2,1,2,0,1,2,50.0,1,6,1,5,2,1,0
2360,Bouna Sarr,2,0,1,1,0,2,2,100.0,0,3,0,3,0,1,0
2361,Ismaila Sarr,14,8,2,10,2,6,17,35.3,11,21,6,15,13,11,0
2362,Mamadou Sarr,0,0,0,0,0,0,0,,0,0,0,0,0,0,0
2363,Martin Satriano,24,16,6,13,5,10,25,40.0,15,19,7,12,7,28,0
2364,Téji Savanier,37,20,16,15,6,14,63,22.2,49,36,8,28,33,28,1
2365,Stefan Savić,27,19,16,7,4,15,30,50.0,15,29,15,14,27,61,1
2366,Sávio,42,25,14,22,6,16,28,57.1,12,34,0,34,18,11,1
2367,Zanos Savva,1,1,0,1,0,1,3,33.3,2,0,0,0,0,1,0
2368,Saba Sazonov,9,7,4,5,0,3,3,100.0,0,8,5,3,3,22,0
2369,Joe Scally,41,28,21,17,3,23,40,57.5,17,31,11,20,18,78,2
2370,Giorgio Scalvini,53,33,29,19,5,19,40,47.5,21,44,17,27,59,71,0
2371,Gianluca Scamacca,15,9,4,5,6,7,14,50.0,7,7,1,6,4,9,0
2372,Dane Scarlett,1,1,0,0,1,0,1,0.0,1,0,0,0,0,0,0
2373,Kevin Schade,3,1,1,2,0,0,5,0.0,5,2,0,2,1,4,0
2374,András Schäfer,29,16,9,15,5,11,20,55.0,9,25,4,21,20,25,0
2375,Fabian Schär,42,24,27,13,2,18,40,45.0,22,50,38,12,36,133,1
2376,Patrik Schick,6,4,0,3,3,1,5,20.0,4,2,0,2,1,7,0
2377,Stefan Schimmer,1,1,0,1,0,0,3,0.0,3,2,0,2,1,6,0
2378,Xaver Schlager,81,50,35,38,8,21,53,39.6,32,41,8,33,19,27,0
2379,Keven Schlotterbeck,42,22,26,14,2,25,30,83.3,5,33,23,10,33,104,2
2380,Nico Schlotterbeck,70,50,36,27,7,41,65,63.1,24,52,25,27,45,101,3
2381,Jeffrey Schlupp,38,24,14,16,8,9,18,50.0,9,13,2,11,8,24,0
2382,Romano Schmid,35,20,7,22,6,14,46,30.4,32,36,7,29,11,17,2
2383,Kenneth Schmidt,2,2,2,0,0,2,4,50.0,2,1,0,1,1,2,0
2384,Niklas Schmidt,36,21,13,19,4,16,33,48.5,17,14,7,7,4,13,0
2385,Benno Schmitz,27,15,20,7,0,17,34,50.0,17,19,4,15,7,29,0
2386,Fabian Schnellhardt,4,1,2,1,1,1,3,33.3,2,1,0,1,4,5,0
2387,Jan Schöppner,48,26,26,20,2,21,42,50.0,21,37,7,30,26,57,0
2388,Marcel Schuhen,1,0,1,0,0,1,3,33.3,2,0,0,0,2,11,4
2389,Perr Schuurs,20,12,11,8,1,3,9,33.3,6,10,2,8,9,23,0
2390,Marvin Schwäbe,1,0,1,0,0,1,1,100.0,0,0,0,0,0,10,1
2391,Alexander Schwolow,0,0,0,0,0,0,0,,0,0,0,0,0,2,0
2392,Alex Scott,24,15,8,10,6,12,28,42.9,16,14,4,10,12,18,2
2393,Simone Scuffet,1,0,1,0,0,1,2,50.0,1,1,0,1,1,9,0
2394,Jérémy Sebas,7,1,2,3,2,3,5,60.0,2,3,1,2,1,1,0
2395,Manuel Sebastián,4,2,4,0,0,3,3,100.0,0,3,0,3,0,1,0
2396,Demba Seck,5,3,1,4,0,3,4,75.0,1,1,0,1,1,0,0
2397,Demba Seck,7,4,2,3,2,4,5,80.0,1,3,0,3,1,1,0
2398,Aleksandar Sedlar,14,10,10,4,0,10,16,62.5,6,8,4,4,13,43,0
2399,Alidu Seidu,21,9,17,3,1,14,19,73.7,5,11,3,8,10,13,0
2400,Alidu Seidu,32,24,17,15,0,24,31,77.4,7,15,7,8,25,37,0
2401,Nicolas Seiwald,33,18,16,15,2,16,25,64.0,9,12,2,10,8,15,0
2402,Nikola Sekulov,0,0,0,0,0,0,0,,0,0,0,0,0,0,0
2403,Davie Selke,4,2,1,3,0,0,2,0.0,2,5,3,2,0,20,0
2404,Matz Sels,0,0,0,0,0,0,0,,0,0,0,0,0,11,1
2405,Matz Sels,0,0,0,0,0,0,0,,0,2,0,2,0,13,1
2406,Nélson Semedo,79,48,52,19,8,38,64,59.4,26,44,8,36,36,85,1
2407,Vivaldo Semedo,0,0,0,0,0,0,0,,0,0,0,0,0,0,0
2408,Antoine Semenyo,24,17,7,9,8,9,27,33.3,18,39,2,37,6,21,0
2409,Marvin Senaya,72,53,38,25,9,42,68,61.8,26,40,13,27,41,68,0
2410,Marcos Senesi,55,32,28,23,4,24,56,42.9,32,50,23,27,35,109,1
2411,Stefano Sensi,1,1,0,1,0,1,3,33.3,2,1,0,1,1,0,0
2412,Suat Serdar,51,39,24,23,4,22,45,48.9,23,29,7,22,20,25,1
2413,Benjamin Šeško,13,5,2,7,4,2,9,22.2,7,23,2,21,3,27,0
2414,Kevin Sessa,17,10,9,6,2,7,16,43.8,9,12,1,11,4,17,0
2415,Aaron Seydel,3,2,0,2,1,0,3,0.0,3,8,2,6,1,9,0
2416,Andres Sfait,1,1,1,0,0,1,2,50.0,1,0,0,0,0,0,0
2417,Stephan El Shaarawy,21,13,14,4,3,6,15,40.0,9,11,4,7,13,15,2
2418,Luke Shaw,11,8,7,3,1,9,15,60.0,6,18,11,7,6,39,0
2419,James Shea,0,0,0,0,0,0,0,,0,0,0,0,0,2,0
2420,Eldor Shomurodov,11,4,2,6,3,6,10,60.0,4,5,0,5,4,4,0
2421,Steven Shpendi,0,0,0,0,0,0,4,0.0,4,2,1,1,1,0,0
2422,Sofiane Sidi Ali,2,0,0,2,0,1,2,50.0,1,1,0,1,2,0,0
2423,Vincent Sierro,41,24,15,20,6,27,77,35.1,50,37,13,24,27,33,0
2424,Tim Siersleben,27,11,21,6,0,8,20,40.0,12,16,10,6,21,29,1
2425,Kiliann Sildillia,43,19,28,8,7,26,42,61.9,16,33,15,18,22,64,0
2426,André Silva,2,2,0,0,2,0,4,0.0,4,3,0,3,1,3,0
2427,Bernardo Silva,51,23,13,25,13,25,57,43.9,32,32,4,28,17,15,1
2428,Caio Henrique Oliveira Silva,13,7,3,7,3,6,9,66.7,3,8,2,6,6,9,0
2429,Fábio Silva,7,4,3,4,0,2,3,66.7,1,1,0,1,2,0,0
2430,Rui Silva,0,0,0,0,0,0,3,0.0,3,0,0,0,1,13,1
2431,Thiago Silva,29,15,22,6,1,20,34,58.8,14,33,24,9,26,153,4
2432,Marco Silvestri,0,0,0,0,0,0,3,0.0,3,1,0,1,0,5,3
2433,Mohamed Simakan,48,29,28,19,1,32,44,72.7,12,36,14,22,29,69,0
2434,Giovanni Simeone,12,4,1,3,8,3,12,25.0,9,11,0,11,1,7,0
2435,Giuliano Simeone,7,5,2,3,2,5,17,29.4,12,10,0,10,5,3,0
2436,Jan-Carlo Simic,1,1,1,0,0,0,0,,0,5,4,1,0,3,0
2437,Moses Simon,7,5,2,5,0,2,8,25.0,6,9,1,8,3,5,1
2438,Unai Simón,2,1,1,1,0,2,3,66.7,1,0,0,0,1,9,0
2439,Xavi Simons,30,17,10,11,9,15,31,48.4,16,23,0,23,16,4,0
2440,Wilfried Singo,34,25,18,14,2,17,26,65.4,9,27,14,13,51,81,2
2441,Luis Sinisterra,23,12,9,10,4,9,16,56.3,7,18,0,18,8,4,0
2442,Daley Sinkgraven,11,5,6,5,0,2,8,25.0,6,5,3,2,6,9,0
2443,Jailson Siqueira,27,18,22,5,0,13,24,54.2,11,13,5,8,12,32,0
2444,Ayanda Sishuba,3,1,0,2,1,1,2,50.0,1,1,0,1,0,0,0
2445,Ibrahima Sissoko,47,33,13,25,9,23,30,76.7,7,21,8,13,19,30,0
2446,Moussa Sissoko,27,16,13,8,6,12,25,48.0,13,8,2,6,12,31,0
2447,Antonio Sivera,0,0,0,0,0,0,1,0.0,1,0,0,0,0,17,1
2448,Tim Skarke,26,16,12,10,4,10,28,35.7,18,25,2,23,6,20,0
2449,Ellyes Skhiri,44,24,18,19,7,19,36,52.8,17,33,4,29,39,47,2
2450,Oliver Skipp,18,12,9,6,3,11,18,61.1,7,12,1,11,3,9,0
2451,Leo Skiri Østigård,24,12,13,10,1,6,11,54.5,5,18,12,6,16,65,0
2452,Łukasz Skorupski,2,2,2,0,0,2,3,66.7,1,0,0,0,1,11,3
2453,Robert Skov,24,16,15,8,1,17,36,47.2,19,17,4,13,10,23,1
2454,Milan Škriniar,24,18,17,7,0,14,22,63.6,8,19,10,9,12,51,2
2455,Naatan Skyttä,4,4,2,1,1,1,1,100.0,0,0,0,0,0,0,0
2456,Chris Smalling,1,1,1,0,0,1,4,25.0,3,6,5,1,5,8,0
2457,Adam Smith,37,23,18,11,8,19,39,48.7,20,28,11,17,21,62,0
2458,Emile Smith Rowe,4,1,2,2,0,2,4,50.0,2,3,1,2,3,1,0
2459,Hrvoje Smolčić,7,3,7,0,0,4,5,80.0,1,3,1,2,6,23,1
2460,Cédric Soares,0,0,0,0,0,0,0,,0,0,0,0,0,0,0
2461,Danilo Soares,10,6,5,3,2,5,8,62.5,3,6,0,6,7,11,0
2462,Eduard Sobol,0,0,0,0,0,0,0,,0,0,0,0,0,1,0
2463,Rubén Sobrino,52,28,18,26,8,22,51,43.1,29,26,2,24,16,18,0
2464,Andrea Sodero,0,0,0,0,0,0,0,,0,0,0,0,0,0,0
2465,Emran Soglo,2,1,0,2,0,1,3,33.3,2,6,0,6,1,3,0
2466,Alex Sola,27,15,11,9,7,14,26,53.8,12,18,2,16,11,16,0
2467,Alex Sola,0,0,0,0,0,0,0,,0,0,0,0,1,2,0
2468,Dominic Solanke,23,11,3,13,7,10,29,34.5,19,24,5,19,7,43,0
2469,Ola Solbakken,0,0,0,0,0,0,0,,0,0,0,0,0,0,0
2470,Carlos Soler,15,10,9,2,4,6,21,28.6,15,10,3,7,5,11,1
2471,Jhon Solis,10,8,4,5,1,4,12,33.3,8,8,3,5,8,7,1
2472,Manor Solomon,3,3,1,1,1,1,2,50.0,1,4,0,4,3,2,0
2473,Daniele Sommariva,0,0,0,0,0,0,0,,0,0,0,0,0,0,0
2474,Yann Sommer,2,1,2,0,0,2,2,100.0,0,1,0,1,0,7,1
2475,Brandon Soppy,2,2,1,1,0,2,6,33.3,4,2,0,2,0,3,1
2476,David Soria,0,0,0,0,0,0,2,0.0,2,0,0,0,0,21,6
2477,Alberto Soro,0,0,0,0,0,0,0,,0,0,0,0,0,0,0
2478,Alessandro Sorrentino,0,0,0,0,0,0,0,,0,0,0,0,0,0,0
2479,Borna Sosa,0,0,0,0,0,0,1,0.0,1,0,0,0,0,0,0
2480,Hugo Sotelo,19,17,3,13,3,8,20,40.0,12,7,1,6,2,5,0
2481,Florian Sotoca,33,22,9,21,3,17,38,44.7,21,41,4,37,20,34,0
2482,Riccardo Sottil,10,5,5,1,4,3,8,37.5,5,12,0,12,2,2,0
2483,Tomáš Souček,53,35,24,26,3,21,47,44.7,26,55,28,27,37,109,0
2484,Matìas Soulé,41,27,12,14,15,19,40,47.5,21,38,4,34,18,9,0
2485,Boubakary Soumaré,39,28,24,14,1,14,26,53.8,12,25,7,18,26,20,1
2486,Issa Soumaré,2,0,2,0,0,0,4,0.0,4,0,0,0,0,2,0
2487,Vinicius Souza,125,76,59,51,15,41,74,55.4,33,57,17,40,32,75,1
2488,Djibril Sow,28,21,15,8,5,9,25,36.0,16,20,3,17,17,8,1
2489,Saidou Sow,20,12,17,3,0,9,13,69.2,4,7,4,3,12,36,3
2490,Çağlar Söyüncü,1,1,1,0,0,0,0,,0,1,0,1,1,7,0
2491,Djed Spence,16,10,12,4,0,8,10,80.0,2,20,5,15,8,28,0
2492,Stijn Spierings,53,40,26,20,7,29,52,55.8,23,22,5,17,26,32,0
2493,Stijn Spierings,1,0,0,1,0,1,1,100.0,0,2,1,1,2,1,0
2494,Leonardo Spinazzola,15,7,10,5,0,8,18,44.4,10,8,2,6,3,15,0
2495,Marco Sportiello,0,0,0,0,0,0,0,,0,0,0,0,0,2,0
2496,Anton Stach,73,42,40,27,6,33,63,52.4,30,38,12,26,72,67,1
2497,Anton Stach,3,0,2,0,1,2,4,50.0,2,5,0,5,2,5,0
2498,Jens Stage,52,22,21,23,8,18,50,36.0,32,42,23,19,23,55,0
2499,Benjamin Stambouli,9,7,3,5,1,6,11,54.5,5,3,1,2,2,8,0
2500,Josip Stanišić,38,20,19,13,6,22,33,66.7,11,18,3,15,9,26,0
2501,Carl Starfelt,36,30,30,5,1,19,28,67.9,9,35,28,7,34,159,2
2502,Niklas Stark,26,15,13,11,2,12,18,66.7,6,14,7,7,19,61,1
2503,Jason Steele,0,0,0,0,0,0,3,0.0,3,0,0,0,0,8,1
2504,Pascal Stenzel,18,8,7,9,2,10,30,33.3,20,22,8,14,15,26,0
2505,Leonidas Stergiou,15,8,7,7,1,9,13,69.2,4,8,1,7,5,13,0
2506,Raheem Sterling,21,10,7,8,6,12,26,46.2,14,13,0,13,13,9,1
2507,Trivante Stewart,0,0,0,0,0,0,0,,0,1,0,1,0,0,0
2508,Angelo Stiller,0,0,0,0,0,0,1,0.0,1,2,0,2,0,3,0
2509,Angelo Stiller,55,33,15,34,6,24,42,57.1,18,41,13,28,28,25,2
2510,Kevin Stöger,49,30,21,21,7,25,63,39.7,38,46,4,42,19,18,0
2511,Filip Stojilković,1,1,0,0,1,0,0,,0,0,0,0,0,1,0
2512,John Stones,2,1,1,0,1,0,3,0.0,3,11,7,4,10,21,0
2513,Thomas Strakosha,0,0,0,0,0,0,0,,0,0,0,0,0,0,0
2514,Jørgen Strand Larsen,21,11,1,15,5,8,38,21.1,30,15,1,14,5,17,0
2515,Gabriel Strefezza,24,17,8,7,9,14,20,70.0,6,17,0,17,7,11,0
2516,Kevin Strootman,34,19,13,18,3,15,31,48.4,16,20,6,14,7,22,0
2517,Cristhian Stuani,14,11,4,6,4,4,7,57.1,3,9,2,7,5,13,0
2518,Álex Suárez,53,36,33,15,5,31,37,83.8,6,33,14,19,18,84,0
2519,Damián Suárez,36,21,16,16,4,26,45,57.8,19,13,3,10,10,31,0
2520,Denis Suárez,0,0,0,0,0,0,2,0.0,2,2,2,0,0,4,0
2521,Gabriel Suazo,66,32,40,19,7,38,86,44.2,48,37,4,33,26,33,0
2522,Isaac Success,6,4,0,5,1,1,3,33.3,2,6,1,5,2,11,0
2523,Niklas Süle,18,10,14,3,1,11,16,68.8,5,25,14,11,25,58,2
2524,Ibrahim Sulemana,36,14,15,15,6,17,27,63.0,10,24,5,19,7,23,0
2525,Tomáš Suslov,42,30,11,22,9,15,47,31.9,32,15,0,15,6,8,0
2526,Suso,24,17,14,8,2,8,28,28.6,20,9,0,9,5,4,0
2527,Mattias Svanberg,37,17,8,19,10,12,38,31.6,26,25,5,20,21,28,0
2528,Max Svensson,1,0,0,0,1,0,0,,0,0,0,0,0,0,0
2529,Mile Svilar,0,0,0,0,0,0,0,,0,0,0,0,0,2,1
2530,Williot Swedberg,9,4,3,6,0,5,8,62.5,3,11,1,10,0,4,0
2531,Karol Świderski,7,3,1,3,3,2,3,66.7,1,6,4,2,1,8,0
2532,Abakar Sylla,54,23,30,19,5,29,40,72.5,11,40,11,29,26,70,2
2533,Dembo Sylla,1,1,0,1,0,0,0,,0,0,0,0,1,2,0
2534,Issiaga Sylla,28,17,20,6,2,16,34,47.1,18,21,7,14,23,53,0
2535,Mamadou Sylla,0,0,0,0,0,0,0,,0,1,1,0,0,1,0
2536,Attila Szalai,3,1,3,0,0,1,4,25.0,3,6,2,4,1,7,0
2537,Attila Szalai,1,1,1,0,0,1,2,50.0,1,5,2,3,1,11,1
2538,Wojciech Szczęsny,0,0,0,0,0,0,0,,0,0,0,0,1,11,2
2539,Dominik Szoboszlai,32,19,12,12,8,16,50,32.0,34,37,2,35,15,16,1
2540,Przemysław Szymiński,0,0,0,0,0,0,0,,0,1,1,0,0,0,0
2541,Alexander Sørloth,6,3,1,2,3,2,6,33.3,4,9,4,5,0,26,0
2542,Musa Al-Taamari,20,16,10,5,5,9,21,42.9,12,18,2,16,4,5,0
2543,Nicolás Tagliafico,54,34,23,22,9,22,49,44.9,27,25,8,17,28,43,0
2544,Jonathan Tah,19,9,10,7,2,5,16,31.3,11,28,23,5,23,97,1
2545,Montassar Talbi,38,22,23,13,2,19,32,59.4,13,39,23,16,32,114,0
2546,Yassin Tallal,0,0,0,0,0,0,0,,0,0,0,0,0,0,0
2547,Adrien Tameze,35,16,13,18,4,18,37,48.6,19,24,11,13,47,25,2
2548,Renato Tapia,41,29,19,19,3,14,25,56.0,11,31,7,24,21,50,1
2549,Edmond Tapsoba,34,25,17,15,2,17,24,70.8,7,21,10,11,24,52,3
2550,Matt Targett,2,0,1,1,0,1,1,100.0,0,1,0,1,0,2,0
2551,Oussama Targhalline,23,11,16,7,0,15,25,60.0,10,9,3,6,20,14,2
2552,James Tarkowski,61,42,46,14,1,27,48,56.3,21,82,56,26,56,191,2
2553,César Tárrega,0,0,0,0,0,0,0,,0,0,0,0,0,2,0
2554,Jimi Tauriainen,0,0,0,0,0,0,0,,0,0,0,0,0,0,0
2555,Nuno Tavares,11,7,9,1,1,8,9,88.9,1,6,0,6,1,21,0
2556,Marcus Tavernier,53,34,25,22,6,26,48,54.2,22,31,3,28,5,23,0
2557,Elayis Tavsan,0,0,0,0,0,0,1,0.0,1,0,0,0,0,1,0
2558,Charlie Taylor,35,20,19,14,2,17,35,48.6,18,27,11,16,19,78,0
2559,Marciano Tchami,0,0,0,0,0,0,0,,0,0,0,0,0,0,0
2560,Loum Tchaouna,20,10,5,13,2,10,20,50.0,10,20,1,19,4,16,1
2561,Jackson Tchatchoua,39,26,25,12,2,23,48,47.9,25,17,7,10,23,49,2
2562,Enzo Tchato,26,17,18,4,4,11,25,44.0,14,20,7,13,11,25,0
2563,Aurélien Tchouaméni,38,23,19,17,2,9,18,50.0,9,21,13,8,28,52,1
2564,Mathys Tel,12,2,3,4,5,4,6,66.7,2,11,0,11,6,6,0
2565,Nathan Tella,13,8,6,5,2,5,10,50.0,5,10,0,10,3,8,0
2566,Nahuel Tenaglia,29,19,22,4,3,16,28,57.1,12,14,8,6,12,59,0
2567,Arnau Tenas,0,0,0,0,0,0,0,,0,0,0,0,0,0,0
2568,Marc-André ter Stegen,0,0,0,0,0,0,0,,0,0,0,0,0,3,3
2569,Filippo Terracciano,30,19,23,6,1,17,31,54.8,14,24,6,18,20,17,0
2570,Filippo Terracciano,2,2,1,1,0,1,3,33.3,2,3,0,3,0,1,0
2571,Pietro Terracciano,1,1,1,0,0,1,3,33.3,2,1,0,1,0,8,0
2572,Ramón Terrats,17,13,8,8,1,7,15,46.7,8,11,1,10,3,9,0
2573,Martin Terrier,14,9,3,8,3,6,14,42.9,8,21,4,17,9,17,0
2574,Kenny Tete,27,17,19,6,2,11,19,57.9,8,10,3,7,16,35,0
2575,Benjamin Tetteh,6,6,1,5,0,4,7,57.1,3,0,0,0,0,1,0
2576,Teddy Teuma,54,36,19,21,14,25,62,40.3,37,33,4,29,20,6,0
2577,Florian Thauvin,7,4,2,4,1,4,13,30.8,9,9,1,8,3,2,0
2578,Arthur Theate,30,17,19,6,5,24,37,64.9,13,40,23,17,31,90,2
2579,Norman Theuerkauf,24,16,13,7,4,13,22,59.1,9,16,6,10,14,21,0
2580,Malick Thiaw,34,17,15,17,2,12,25,48.0,13,23,13,10,13,55,0
2581,Jan Thielmann,28,18,13,9,6,12,24,50.0,12,31,6,25,8,28,0
2582,Denis Thomalla,9,6,4,4,1,5,11,45.5,6,3,2,1,4,13,0
2583,Luke Thomas,20,9,13,6,1,8,14,57.1,6,23,5,18,10,27,0
2584,Adrien Thomasson,25,14,4,16,5,11,34,32.4,23,14,0,14,9,10,1
2585,Morten Thorsby,19,11,9,8,2,7,14,50.0,7,21,5,16,4,20,0
2586,Kristian Thorstvedt,40,22,7,28,5,22,44,50.0,22,25,9,16,21,36,0
2587,Khéphren Thuram,42,29,13,23,6,20,40,50.0,20,21,10,11,18,37,0
2588,Marcus Thuram,23,15,9,9,5,4,13,30.8,9,26,3,23,4,19,0
2589,Cheikh Tidiane Sabaly,40,20,23,12,5,16,40,40.0,24,19,2,17,10,14,0
2590,Youri Tielemans,41,20,17,18,6,16,40,40.0,24,23,3,20,15,9,0
2591,Kieran Tierney,37,24,16,18,3,18,27,66.7,9,22,8,14,10,45,0
2592,Phillip Tietz,23,14,7,13,3,6,15,40.0,9,17,3,14,6,35,0
2593,Steffen Tigges,10,6,4,5,1,3,7,42.9,4,4,2,2,1,12,0
2594,Antonio Tikvić,0,0,0,0,0,0,0,,0,0,0,0,0,0,0
2595,Jurriën Timber,2,2,1,1,0,0,0,,0,1,0,1,0,1,0
2596,Jean-Clair Todibo,58,28,35,17,6,34,56,60.7,22,34,15,19,38,97,1
2597,Harry Toffolo,26,14,20,6,0,15,24,62.5,9,34,13,21,14,49,0
2598,Umut Tohumcu,16,12,9,7,0,6,19,31.6,13,11,1,10,6,12,0
2599,Corentin Tolisso,33,21,13,11,9,14,33,42.4,19,26,9,17,10,18,0
2600,Jeremy Toljan,13,10,8,4,1,9,15,60.0,6,17,5,12,16,49,1
2601,Rafael Tolói,20,9,7,8,5,14,27,51.9,13,9,4,5,13,29,0
2602,Raúl de Tomás,9,5,4,3,2,3,6,50.0,3,3,0,3,1,8,0
2603,Tiago Tomás,5,2,3,0,2,1,6,16.7,5,13,0,13,3,9,0
2604,Takehiro Tomiyasu,20,9,15,4,1,11,18,61.1,7,10,4,6,18,33,0
2605,James Tomkins,0,0,0,0,0,0,0,,0,0,0,0,1,0,0
2606,Fikayo Tomori,42,24,29,10,3,18,29,62.1,11,34,23,11,26,75,1
2607,Sandro Tonali,7,7,4,2,1,3,9,33.3,6,3,0,3,2,4,0
2608,Ivan Toney,15,5,2,7,6,6,14,42.9,8,5,1,4,10,18,0
2609,Pablo Torre,5,2,0,5,0,4,10,40.0,6,10,2,8,4,6,1
2610,Raúl Torrente,29,16,20,9,0,17,22,77.3,5,16,10,6,11,68,2
2611,Ferrán Torres,9,6,1,6,2,5,16,31.3,11,7,1,6,5,6,0
2612,Óliver Torres,37,22,17,15,5,22,57,38.6,35,40,4,36,6,6,0
2613,Pau Torres,29,18,17,11,1,14,30,46.7,16,28,12,16,14,75,0
2614,Lucas Torró,25,15,11,8,6,11,28,39.3,17,10,2,8,33,37,0
2615,Fabio Torsiello,1,0,1,0,0,1,8,12.5,7,1,0,1,1,1,0
2616,Ahmed Touba,6,4,3,3,0,3,4,75.0,1,4,3,1,7,20,0
2617,Abdoulaye Touré,47,28,22,22,3,30,60,50.0,30,30,8,22,25,33,0
2618,Souleymane Touré,25,12,16,9,0,8,14,57.1,6,38,20,18,36,101,2
2619,Lucas Tousart,35,20,14,17,4,17,37,45.9,20,32,9,23,25,41,0
2620,Andros Townsend,21,13,11,2,8,13,27,48.1,14,12,0,12,5,10,0
2621,James Trafford,2,1,2,0,0,2,2,100.0,0,0,0,0,1,18,1
2622,Adama Traoré,4,3,1,2,1,3,6,50.0,3,2,0,2,1,2,0
2623,Bertrand Traoré,1,1,1,0,0,0,0,,0,0,0,0,0,1,0
2624,Bertrand Traoré,5,4,2,1,2,1,4,25.0,3,6,0,6,1,2,0
2625,Boubacar Traoré,35,23,16,17,2,9,21,42.9,12,12,2,10,5,7,0
2626,Chaka Traorè,2,1,2,0,0,1,2,50.0,1,1,1,0,0,0,0
2627,Daouda Traoré,0,0,0,0,0,0,0,,0,0,0,0,0,0,0
2628,Hamari Traoré,44,19,24,17,3,25,43,58.1,18,27,8,19,24,59,2
2629,Ismaël Traoré,19,12,13,6,0,8,21,38.1,13,33,20,13,30,86,0
2630,Omar Traoré,60,33,33,21,6,32,56,57.1,24,32,7,25,40,54,1
2631,Kevin Trapp,0,0,0,0,0,0,0,,0,0,0,0,1,9,1
2632,Mark Travers,0,0,0,0,0,0,0,,0,0,0,0,0,2,0
2633,Óscar Trejo,27,15,11,9,7,13,21,61.9,8,21,1,20,5,9,0
2634,Mike Trésor,10,6,9,1,0,8,18,44.4,10,5,0,5,1,1,0
2635,Manu Trigueros,7,5,6,1,0,4,10,40.0,6,1,1,0,3,9,0
2636,Christopher Trimmel,23,15,12,10,1,13,33,39.4,20,16,3,13,13,57,0
2637,Kieran Trippier,57,27,30,16,11,37,77,48.1,40,41,8,33,24,57,3
2638,Leandro Trossard,27,16,8,9,10,9,25,36.0,16,27,1,26,8,6,0
2639,Adrien Truffert,39,21,23,10,6,25,40,62.5,15,31,5,26,19,49,0
2640,Auston Trusty,47,30,31,13,3,21,43,48.8,22,41,22,19,35,153,3
2641,Kostas Tsimikas,19,13,9,6,4,9,15,60.0,6,9,1,8,6,10,0
2642,Viktor Tsyhankov,29,20,11,13,5,14,26,53.8,12,18,1,17,12,24,0
2643,Stefano Turati,0,0,0,0,0,0,0,,0,0,0,0,0,6,3
2644,Matt Turner,0,0,0,0,0,0,0,,0,0,0,0,0,8,4
2645,Beñat Turrientes,31,17,6,20,5,13,30,43.3,17,19,8,11,6,17,0
2646,Tuta,63,33,38,19,6,39,59,66.1,20,29,12,17,36,99,0
2647,Destiny Udogie,68,33,41,16,11,27,49,55.1,22,27,8,19,37,80,5
2648,Matthieu Udol,55,37,38,12,5,38,56,67.9,18,62,16,46,50,108,0
2649,Manuel Ugarte Ribeiro,98,57,39,43,16,43,89,48.3,46,27,6,21,40,25,2
2650,Lesley Ugochukwu,14,10,4,8,2,4,10,40.0,6,6,2,4,1,5,0
2651,Lukas Ullrich,1,0,1,0,0,1,4,25.0,3,0,0,0,0,1,0
2652,Sven Ulreich,1,0,1,0,0,1,1,100.0,0,0,0,0,0,3,2
2653,Samuel Umtiti,1,1,0,1,0,1,4,25.0,3,0,0,0,2,4,0
2654,Enes Ünal,6,4,2,3,1,2,5,40.0,3,4,2,2,1,6,0
2655,Enes Ünal,0,0,0,0,0,0,0,,0,1,0,1,0,2,0
2656,Deniz Undav,28,13,6,8,14,4,15,26.7,11,17,0,17,6,5,0
2657,Dayot Upamecano,34,21,21,11,2,15,29,51.7,14,19,7,12,19,56,3
2658,Kacper Urbanski,16,10,5,10,1,6,13,46.2,7,15,1,14,4,14,0
2659,Mark Uth,8,4,2,3,3,4,12,33.3,8,6,0,6,1,2,0
2660,Myrto Uzuni,18,14,8,7,3,6,27,22.2,21,19,3,16,4,7,0
2661,Josha Vagnoman,28,18,15,11,2,15,30,50.0,15,11,5,6,2,16,1
2662,Óscar Valentín,107,66,39,62,6,46,101,45.5,55,62,10,52,35,52,1
2663,Emanuele Valeri,19,16,10,5,4,10,21,47.6,11,14,3,11,9,22,0
2664,Martin Valjent,34,18,19,13,2,18,30,60.0,12,26,11,15,29,112,1
2665,Jesús Vallejo,3,1,1,2,0,2,2,100.0,0,3,2,1,0,1,1
2666,Álvaro Vallés,3,2,3,0,0,3,8,37.5,5,0,0,0,0,40,1
2667,Federico Valverde,47,34,22,13,12,24,42,57.1,18,39,2,37,43,40,0
2668,Kévin Van Den Kerkhof,31,24,11,13,7,13,32,40.6,19,15,2,13,11,32,1
2669,Siebe Van Der Heyden,9,2,7,2,0,4,6,66.7,2,1,1,0,7,12,0
2670,Virgil van Dijk,40,23,24,13,3,12,14,85.7,2,47,34,13,39,144,0
2671,Vanderson,60,41,20,30,10,32,70,45.7,38,29,2,27,35,37,1
2672,Raphaël Varane,18,11,10,7,1,10,14,71.4,4,23,18,5,15,88,0
2673,Ruben Vargas,23,10,6,10,7,10,25,40.0,15,19,4,15,7,17,0
2674,Johan Vásquez,51,33,38,11,2,32,50,64.0,18,50,26,24,45,113,0
2675,José Luis García Vayá,78,53,36,36,6,37,71,52.1,34,41,10,31,49,71,0
2676,Borja Vázquez,1,0,1,0,0,1,1,100.0,0,0,0,0,0,1,0
2677,Jesus Vazquez,24,12,13,8,3,10,16,62.5,6,17,4,13,3,24,0
2678,Kevin Vázquez,15,13,7,7,1,12,21,57.1,9,11,3,8,5,25,0
2679,Lucas Vázquez,37,25,22,14,1,18,25,72.0,7,27,5,22,12,36,0
2680,Matías Vecino,32,17,12,20,0,20,31,64.5,11,17,5,12,12,21,0
2681,Gabriel Veiga,0,0,0,0,0,0,0,,0,0,0,0,0,0,0
2682,Alejo Véliz,1,0,1,0,0,0,0,,0,0,0,0,0,0,0
2683,Alejo Véliz,1,0,0,1,0,1,2,50.0,1,0,0,0,0,1,0
2684,Miloš Veljković,31,15,17,13,1,16,31,51.6,15,31,20,11,17,57,0
2685,Joël Veltman,54,41,32,17,5,39,58,67.2,19,17,7,10,18,57,1
2686,Micky van de Ven,49,35,34,12,3,24,33,72.7,9,25,15,10,18,78,1
2687,Lorenzo Venuti,6,4,5,1,0,6,10,60.0,4,4,3,1,5,14,0
2688,Bart Verbruggen,1,1,1,0,0,1,2,50.0,1,0,0,0,0,11,3
2689,Simone Verdi,0,0,0,0,0,0,0,,0,0,0,0,0,0,0
2690,Jordan Veretout,38,22,19,13,6,18,39,46.2,21,20,4,16,13,25,0
2691,Arthur Vermeeren,1,0,0,1,0,0,1,0.0,1,5,0,5,6,2,0
2692,Yorbe Vertessen,3,2,0,3,0,1,4,25.0,3,8,0,8,1,3,0
2693,Mikel Vesga,40,20,11,23,6,19,49,38.8,30,19,7,12,32,35,1
2694,Guglielmo Vicario,0,0,0,0,0,0,1,0.0,1,0,0,0,1,31,2
2695,Carlos Vicente,16,6,7,7,2,10,25,40.0,15,4,0,4,4,9,0
2696,Nacho Vidal,5,4,2,2,1,2,5,40.0,3,2,0,2,0,6,0
2697,Nacho Vidal,12,5,4,5,3,6,13,46.2,7,5,2,3,3,9,0
2698,Fabio Vieira,3,2,2,0,1,3,3,100.0,0,0,0,0,2,2,0
2699,Fran Vieites,1,0,1,0,0,1,1,100.0,0,0,0,0,0,2,1
2700,Jonathan Viera,6,3,1,2,3,1,9,11.1,8,0,0,0,0,1,0
2701,Jonathan Viera,19,9,6,9,4,10,19,52.6,9,4,0,4,4,1,0
2702,Emanuel Vignato,10,7,4,5,1,5,6,83.3,1,1,0,1,1,7,0
2703,Samuele Vignato,6,4,2,3,1,2,3,66.7,1,2,0,2,1,1,0
2704,Oscar Vilhelmsson,13,6,3,7,3,7,10,70.0,3,15,5,10,3,19,0
2705,Toni Villa,0,0,0,0,0,0,0,,0,0,0,0,0,0,0
2706,Asier Villalibre,2,1,0,0,2,2,2,100.0,0,2,1,1,0,6,0
2707,Gonzalo Villar,51,33,26,20,5,26,41,63.4,15,32,10,22,6,26,1
2708,Iván Villar,0,0,0,0,0,0,1,0.0,1,0,0,0,0,6,0
2709,Matías Viña,34,21,22,7,5,20,36,55.6,16,12,2,10,9,34,0
2710,Rúben Vinagre,4,2,1,1,2,3,4,75.0,1,6,3,3,1,4,0
2711,Carlos Vinícius,3,2,0,1,2,0,4,0.0,4,4,0,4,0,1,0
2712,Nicolas Viola,13,9,2,8,3,7,17,41.2,10,9,0,9,2,6,0
2713,Alan Virginius,1,1,1,0,0,0,1,0.0,1,0,0,0,0,0,0
2714,Alan Virginius,9,5,4,4,1,4,11,36.4,7,7,0,7,3,7,0
2715,Ricardo Visus,2,2,1,1,0,2,2,100.0,0,2,2,0,2,9,1
2716,Mattia Viti,24,15,14,7,3,10,22,45.5,12,20,10,10,10,44,0
2717,Vitinha,2,2,1,0,1,1,2,50.0,1,2,0,2,0,2,0
2718,Vitinha,14,8,3,5,6,3,12,25.0,9,11,2,9,5,8,0
2719,Vitinha,39,24,12,16,11,16,48,33.3,32,29,11,18,23,30,2
2720,Vitinho,64,34,36,22,6,43,86,50.0,43,44,6,38,12,47,4
2721,Daniel Vivian,42,28,29,11,2,28,45,62.2,17,49,25,24,31,104,0
2722,Odisseas Vlachodimos,0,0,0,0,0,0,1,0.0,1,0,0,0,0,1,0
2723,Dušan Vlahović,9,5,0,6,3,4,11,36.4,7,4,2,2,1,11,0
2724,Nikola Vlašić,28,16,6,14,8,4,30,13.3,26,26,7,19,11,16,0
2725,Alessandro Vogliacco,23,15,14,8,1,12,15,80.0,3,16,10,6,30,40,1
2726,Kevin Vogt,14,10,7,7,0,8,13,61.5,5,16,13,3,9,54,0
2727,Kevin Vogt,10,9,6,4,0,6,12,50.0,6,22,15,7,7,72,2
2728,Mërgim Vojvoda,17,8,7,6,4,11,16,68.8,5,12,2,10,13,28,0
2729,Kevin Volland,22,9,8,8,6,8,20,40.0,12,8,0,8,6,12,0
2730,Cristian Volpato,16,8,9,6,1,9,25,36.0,16,7,0,7,1,5,0
2731,Aster Vranckx,32,15,11,11,10,15,28,53.6,13,17,6,11,14,29,0
2732,Stefan de Vrij,18,13,13,4,1,8,15,53.3,7,22,10,12,24,51,0
2733,Elye Wahi,0,0,0,0,0,0,0,,0,0,0,0,0,0,0
2734,Elye Wahi,6,4,1,3,2,2,10,20.0,8,5,1,4,3,3,0
2735,Walace,66,43,40,26,0,36,77,46.8,41,43,6,37,43,66,1
2736,Luca Waldschmidt,19,12,4,12,3,5,16,31.3,11,18,3,15,6,8,1
2737,Kyle Walker,38,24,19,17,2,19,39,48.7,20,19,6,13,27,40,1
2738,Sebastian Walukiewicz,39,28,33,6,0,28,41,68.3,13,50,31,19,15,121,0
2739,Aaron Wan-Bissaka,42,25,18,20,4,19,26,73.1,7,29,15,14,41,68,1
2740,Joel Ward,45,28,26,18,1,30,47,63.8,17,17,10,7,14,94,1
2741,James Ward-Prowse,45,29,14,23,8,18,44,40.9,26,31,9,22,38,49,0
2742,Lewis Warrington,0,0,0,0,0,0,0,,0,0,0,0,0,0,0
2743,Deivid Washington,1,1,1,0,0,0,1,0.0,1,0,0,0,0,0,0
2744,Kjell-Arik Wätjen,3,2,2,1,0,2,5,40.0,3,1,1,0,0,3,0
2745,Ollie Watkins,12,7,0,5,7,5,11,45.5,6,26,4,22,4,20,0
2746,Timothy Weah,27,20,16,8,3,15,20,75.0,5,12,1,11,5,15,0
2747,Adam Webster,14,12,8,5,1,6,18,33.3,12,16,12,4,16,43,1
2748,Wout Weghorst,13,6,4,7,2,9,15,60.0,6,25,8,17,6,24,0
2749,Julian Weigl,66,40,28,32,6,41,67,61.2,26,47,14,33,48,61,1
2750,Nelson Weiper,2,1,2,0,0,2,3,66.7,1,1,0,1,1,0,0
2751,Mitchell Weiser,64,38,29,25,10,31,53,58.5,22,36,6,30,20,43,0
2752,Noah Weißhaupt,9,4,6,0,3,5,11,45.5,6,8,1,7,8,12,0
2753,Shon Weissman,4,3,2,0,2,0,4,0.0,4,2,1,1,3,4,0
2754,Shon Weissman,1,1,0,0,1,1,4,25.0,3,3,0,3,0,1,0
2755,Danny Welbeck,35,17,9,17,9,10,17,58.8,7,12,0,12,9,17,1
2756,Timo Werner,7,4,3,4,0,5,18,27.8,13,12,0,12,3,2,0
2757,Timo Werner,2,1,0,1,1,0,0,,0,1,0,1,1,0,0
2758,Adam Wharton,48,32,18,22,8,23,46,50.0,23,17,3,14,20,24,1
2759,Ethan Wheatley,1,1,0,1,0,1,1,100.0,0,2,0,2,2,0,0
2760,Ben White,48,28,20,22,6,26,58,44.8,32,48,22,26,32,77,1
2761,Joe White,1,1,1,0,0,0,0,,0,0,0,0,0,0,0
2762,Silvan Widmer,23,10,12,8,3,17,28,60.7,11,18,5,13,16,37,0
2763,Mateusz Wieteska,14,11,9,3,2,3,10,30.0,7,10,5,5,14,48,0
2764,Mateusz Wieteska,4,1,3,1,0,3,5,60.0,2,4,2,2,5,8,0
2765,Iñaki Williams,24,17,6,8,10,13,34,38.2,21,42,8,34,14,29,0
2766,Neco Williams,69,40,42,18,9,35,56,62.5,21,44,13,31,22,53,0
2767,Nico Williams,31,12,9,15,7,13,36,36.1,23,18,2,16,3,4,1
2768,Willian,18,11,6,7,5,3,21,14.3,18,13,0,13,9,12,1
2769,Joe Willock,13,7,7,6,0,4,11,36.4,7,7,0,7,1,1,0
2770,Callum Wilson,5,3,0,2,3,0,4,0.0,4,6,0,6,2,4,0
2771,Harry Wilson,21,14,9,8,4,11,28,39.3,17,27,3,24,10,12,0
2772,Josh Wilson-Esbrand,5,4,2,3,0,2,8,25.0,6,5,2,3,6,7,0
2773,Patrick Wimmer,14,5,5,5,4,8,18,44.4,10,14,0,14,3,7,0
2774,Jonas Wind,13,10,4,6,3,7,17,41.2,10,13,4,9,3,21,0
2775,Florian Wirtz,27,18,7,14,6,9,29,31.0,20,36,2,34,9,3,0
2776,Yoane Wissa,28,16,13,10,5,5,20,25.0,15,24,3,21,9,15,0
2777,Axel Witsel,35,21,23,12,0,17,24,70.8,7,40,21,19,16,119,0
2778,Maximilian Wittek,23,17,9,11,3,13,21,61.9,8,12,1,11,18,23,0
2779,Maximilian Wöber,66,31,40,25,1,31,53,58.5,22,47,26,21,38,111,0
2780,Marius Wolf,20,12,8,11,1,11,23,47.8,12,12,2,10,8,20,0
2781,Nick Woltemade,34,23,7,20,7,15,21,71.4,6,12,0,12,5,17,0
2782,Jeong Woo-yeong,15,9,6,8,1,6,8,75.0,2,5,0,5,7,5,0
2783,Chris Wood,7,4,1,4,2,3,9,33.3,6,11,3,8,1,26,0
2784,Cauley Woodrow,16,10,8,4,4,9,16,56.3,7,7,1,6,1,14,0
2785,Christopher Wooh,18,12,12,6,0,8,15,53.3,7,19,9,10,18,51,0
2786,Joe Worrall,7,5,6,1,0,3,6,50.0,3,5,4,1,3,32,1
2787,Xeber,5,5,3,2,0,3,7,42.9,4,2,1,1,1,2,0
2788,Granit Xhaka,29,21,11,14,4,9,30,30.0,21,29,8,21,19,42,0
2789,Abduqodir Xusanov,21,12,13,8,0,9,17,52.9,8,13,8,5,13,32,2
2790,Antal Yaakobishvili,2,1,1,1,0,1,1,100.0,0,0,0,0,3,3,0
2791,Lamine Yamal,61,37,32,15,14,18,48,37.5,30,32,0,32,19,11,0
2792,Roman Yaremchuk,5,2,1,2,2,3,6,50.0,3,4,0,4,1,9,0
2793,Yehor Yarmoliuk,17,11,6,8,3,7,17,41.2,10,17,4,13,6,5,0
2794,Ryan Yates,66,39,39,21,6,19,34,55.9,15,42,15,27,21,44,1
2795,Yusuf Yazıcı,19,11,6,9,4,4,15,26.7,11,10,1,9,5,5,0
2796,Kelvin Yeboah,4,2,2,2,0,1,3,33.3,2,3,2,1,1,3,0
2797,Bertuğ Yıldırım,7,5,2,3,2,3,8,37.5,5,8,0,8,0,4,0
2798,Kenan Yıldız,13,9,5,6,2,4,8,50.0,4,6,0,6,1,4,0
2799,Darlin Yongwa,30,23,17,11,2,14,25,56.0,11,14,2,12,15,36,0
2800,Leny Yoro,36,25,27,7,2,17,31,54.8,14,20,14,6,36,97,1
2801,Ashley Young,53,38,28,19,6,30,54,55.6,24,24,6,18,22,50,3
2802,Etienne Youte Kinkoue,15,9,13,2,0,7,11,63.6,4,21,16,5,44,104,0
2803,Illia Zabarnyi,59,32,29,29,1,23,50,46.0,27,53,34,19,33,143,4
2804,Mattia Zaccagni,27,16,11,15,1,9,21,42.9,12,26,2,24,21,15,0
2805,Dan-Axel Zagadou,21,14,16,5,0,4,8,50.0,4,23,18,5,20,78,1
2806,Yoram Zague,18,8,11,4,3,11,24,45.8,13,3,0,3,4,9,1
2807,Warren Zaïre-Emery,51,28,18,24,9,28,51,54.9,23,32,8,24,15,22,2
2808,Denis Zakaria,38,27,11,20,7,12,30,40.0,18,39,13,26,47,41,0
2809,Arsen Zakharyan,22,15,8,11,3,9,22,40.9,13,16,0,16,4,10,0
2810,Joseba Zaldúa,20,12,17,2,1,13,21,61.9,8,6,4,2,2,20,0
2811,Nicola Zalewski,20,14,10,9,1,8,22,36.4,14,12,4,8,9,17,0
2812,Andre-Frank Zambo Anguissa,61,33,21,29,11,34,69,49.3,35,40,5,35,28,19,1
2813,Nicolò Zaniolo,19,9,10,7,2,9,17,52.9,8,13,0,13,1,11,0
2814,Alessandro Zanoli,16,13,9,7,0,7,12,58.3,5,10,2,8,1,17,0
2815,Alessandro Zanoli,1,1,1,0,0,0,0,,0,0,0,0,1,1,0
2816,Duván Zapata,18,7,9,2,7,3,12,25.0,9,20,6,14,7,26,0
2817,Duván Zapata,0,0,0,0,0,0,1,0.0,1,0,0,0,0,1,0
2818,Gabriele Zappa,54,31,29,16,9,29,41,70.7,12,29,5,24,20,75,2
2819,Davide Zappacosta,30,20,15,10,5,16,34,47.1,18,29,4,25,5,19,0
2820,Bryan Zaragoza,18,9,8,6,4,8,23,34.8,15,9,0,9,3,3,0
2821,Bryan Zaragoza,4,4,2,1,1,3,3,100.0,0,0,0,0,2,0,0
2822,Anass Zaroury,1,0,1,0,0,0,4,0.0,4,2,0,2,0,1,1
2823,Oier Zarraga,3,3,2,1,0,1,5,20.0,4,5,2,3,5,16,1
2824,Mehdi Zeffane,31,20,17,11,3,17,34,50.0,17,14,3,11,16,34,0
2825,Jordan Zemura,24,16,13,7,4,11,19,57.9,8,5,1,4,13,21,0
2826,Robin Zentner,2,2,2,0,0,2,5,40.0,3,1,0,1,1,19,1
2827,Alessio Zerbin,18,10,13,2,3,4,13,30.8,9,16,3,13,3,5,0
2828,Alessio Zerbin,5,2,1,3,1,2,7,28.6,5,1,0,1,0,0,0
2829,Kevin Zeroli,1,1,1,0,0,0,0,,0,1,0,1,0,1,0
2830,Cedric Zesiger,19,9,13,4,2,10,22,45.5,12,32,21,11,15,88,1
2831,Michael Zetterer,3,1,3,0,0,3,3,100.0,0,0,0,0,0,7,3
2832,Nathan Zeze,11,6,9,2,0,7,14,50.0,7,12,3,9,12,47,1
2833,Edon Zhegrova,32,18,9,15,8,14,36,38.9,22,17,1,16,8,8,0
2834,Piotr Zieliński,23,15,6,13,4,12,24,50.0,12,12,1,11,9,15,0
2835,David Zima,1,1,1,0,0,0,0,,0,0,0,0,3,7,0
2836,Christoph Zimmermann,33,21,26,7,0,19,39,48.7,20,21,14,7,21,66,1
2837,Oleksandr Zinchenko,50,30,19,24,7,35,52,67.3,17,18,3,15,20,26,2
2838,Joshua Zirkzee,32,20,8,15,9,13,24,54.2,11,25,2,23,3,36,0
2839,Luc Zogbé,0,0,0,0,0,0,1,0.0,1,1,1,0,1,0,0
2840,Simon Zoller,0,0,0,0,0,0,0,,0,1,0,1,0,0,0
2841,Nadir Zortea,21,14,8,13,0,10,22,45.5,12,13,5,8,4,29,1
2842,Nadir Zortea,5,4,3,1,1,1,4,25.0,3,2,0,2,1,3,0
2843,Kurt Zouma,23,17,14,9,0,10,16,62.5,6,38,28,10,29,160,0
2844,Igor Zubeldia,32,25,20,10,2,19,26,73.1,7,28,19,9,32,97,3
2845,Martín Zubimendi,49,27,18,29,2,23,42,54.8,19,33,9,24,37,54,0
2846,Szymon Żurkowski,15,6,5,8,2,5,15,33.3,10,5,1,4,6,11,0
2847,Lovro Zvonarek,0,0,0,0,0,0,5,0.0,5,3,0,3,0,2,0
2848,Martin Ødegaard,49,17,18,21,10,17,58,29.3,41,23,1,22,15,5,0
2849,Milan Đurić,1,0,0,0,1,0,3,0.0,3,0,0,0,1,13,0
2850,Milan Đurić,5,5,0,5,0,2,4,50.0,2,6,2,4,0,27,0
2851,Mateusz Łęgowski,23,12,8,12,3,11,26,42.3,15,13,2,11,7,16,0
