,Player,Tkl,TklW,Def 3rd,Mid 3rd,Att 3rd,TklDribblers,Att,Tkl%,Lost,Blocks,Sh,Pass,Int,Clr,Err
0,Ismael Aaneba,0,0,0,0,0,0,0,,0,0,0,0,1,1,0
1,Patrick van Aanholt,35,22,18,17,0,19,43,44.2,24,18,6,12,30,40,2
2,Yunis Abdelhamid,59,37,36,23,0,26,42,61.9,16,34,15,19,61,132,0
3,Sabit Abdulai,2,0,1,1,0,1,3,33.3,2,0,0,0,0,0,0
4,Mehdi Abeid,34,19,16,14,4,15,30,50.0,15,9,2,7,20,10,0
5,Laurent Abergel,145,84,64,69,12,54,162,33.3,108,64,6,58,46,12,0
6,Charles Abi,8,2,5,0,3,3,12,25.0,9,6,2,4,4,5,0
7,Matthis Abline,0,0,0,0,0,0,0,,0,0,0,0,0,0,0
8,Pape Abou Cissé,15,13,10,5,0,6,10,60.0,4,7,4,3,27,87,0
9,David Abraham,18,12,13,3,2,11,17,64.7,6,13,4,9,17,34,0
10,Tammy Abraham,7,5,3,3,1,1,7,14.3,6,6,0,6,5,17,0
11,Amir Abrashi,1,1,1,0,0,0,0,,0,1,1,0,2,1,0
12,Gennaro Acampora,6,4,1,4,1,2,7,28.6,5,4,1,3,4,4,0
13,Francesco Acerbi,51,32,34,13,4,18,40,45.0,22,24,15,9,76,121,2
14,Ragnar Ache,2,0,0,1,1,0,0,,0,1,0,1,1,1,0
15,Marcos Acuña,62,42,34,20,8,23,41,56.1,18,23,2,21,23,30,1
16,Che Adams,25,16,4,15,6,6,17,35.3,11,20,2,18,4,19,1
17,Tyler Adams,35,24,12,15,8,17,31,54.8,14,22,5,17,29,30,0
18,Sargis Adamyan,9,4,4,3,2,7,14,50.0,7,2,0,2,6,1,0
19,Tosin Adarabioyo,37,19,30,6,1,19,40,47.5,21,26,20,6,42,197,2
20,Bobby Adekanye,0,0,0,0,0,0,1,0.0,1,0,0,0,0,1,0
21,Yacine Adli,74,37,30,33,11,35,92,38.0,57,27,2,25,39,17,2
22,Andrea Adorante,0,0,0,0,0,0,0,,0,0,0,0,0,0,0
23,Adrián,0,0,0,0,0,0,0,,0,0,0,0,0,3,1
24,Martin Agirregabiria,32,18,17,12,3,17,33,51.5,16,9,3,6,27,36,0
25,Lucien Agoume,18,10,11,7,0,6,19,31.6,13,10,5,5,15,10,0
26,Felix Agu,20,9,10,9,1,10,18,55.6,8,14,3,11,12,18,0
27,Kevin Agudelo,39,28,9,15,15,12,34,35.3,22,30,0,30,10,2,0
28,Nayef Aguerd,37,30,28,9,0,21,33,63.6,12,34,22,12,47,102,0
29,Sergio Agüero,4,1,0,2,2,2,11,18.2,9,2,0,2,2,0,0
30,Ruben Aguilar,63,37,32,21,10,32,52,61.5,20,30,3,27,47,43,1
31,Naouirou Ahamada,4,1,3,1,0,1,1,100.0,0,2,0,2,1,1,0
32,Matteo Ahlinvi,26,20,10,14,2,11,39,28.2,28,6,0,6,2,8,0
33,Jean-Eudes Aholou,46,25,18,25,3,19,48,39.6,29,17,5,12,53,32,0
34,Jean-Eudes Aholou,1,0,0,1,0,1,3,33.3,2,0,0,0,1,1,0
35,Joseph Aidoo,26,17,17,9,0,12,21,57.1,9,7,4,3,25,88,1
36,Ola Aina,37,20,22,7,8,21,43,48.8,22,22,6,16,45,94,2
37,Rayan Aït-Nouri,29,16,18,10,1,13,27,48.1,14,14,1,13,15,25,0
38,Rayan Aït-Nouri,3,2,1,2,0,3,5,60.0,2,2,1,1,4,1,0
39,Semi Ajayi,40,14,34,6,0,23,41,56.1,18,51,32,19,42,122,2
40,Ludovic Ajorque,30,18,6,18,6,7,31,22.6,24,14,5,9,11,54,0
41,Manuel Akanji,41,22,23,12,6,19,31,61.3,12,23,10,13,49,70,1
42,Carlos Akapo,18,14,14,4,0,10,18,55.6,8,16,3,13,19,33,0
43,Marley Aké,3,3,1,0,2,0,1,0.0,1,2,0,2,0,1,0
44,Nathan Aké,10,5,3,6,1,3,4,75.0,1,2,1,1,9,23,0
45,Paul Akouokou,11,8,2,8,1,5,8,62.5,3,3,1,2,6,7,0
46,Jean-Daniel Akpa-Akpro,38,25,13,22,3,8,27,29.6,19,24,6,18,18,13,0
47,Kevin Akpoguma,18,12,11,6,1,8,14,57.1,6,28,15,13,13,32,2
48,David Alaba,37,21,14,19,4,17,32,53.1,15,29,13,16,43,60,0
49,Sofiane Alakouch,53,33,30,16,7,29,45,64.4,16,17,2,15,21,38,0
50,Jony Álamo,2,1,1,0,1,0,1,0.0,1,0,0,0,1,0,0
51,Lucas Alario,8,2,2,5,1,2,4,50.0,2,9,1,8,2,10,0
52,Jordi Alba,45,30,22,16,7,24,52,46.2,28,21,2,19,49,48,0
53,Luis Alberto,43,24,15,19,9,15,73,20.5,58,41,2,39,13,11,1
54,Raúl Albiol,22,15,19,3,0,13,18,72.2,5,32,22,10,22,146,2
55,Marc Albrighton,33,19,14,15,4,16,45,35.6,29,29,3,26,17,27,1
56,Paco Alcácer,6,3,1,2,3,3,7,42.9,4,8,0,8,9,6,0
57,Pedro Alcalá,8,4,6,2,0,3,5,60.0,2,19,13,6,16,50,0
58,Thiago Alcántara,61,36,20,30,11,17,49,34.7,32,26,0,26,30,14,0
59,Rubén Alcaraz,54,29,32,21,1,30,80,37.5,50,35,8,27,31,28,0
60,Omar Alderete,16,10,11,5,0,7,16,43.8,9,14,10,4,21,61,1
61,Toby Alderweireld,35,22,22,11,2,18,30,60.0,12,40,28,12,10,121,0
62,Iván Alejo,14,10,8,4,2,4,23,17.4,19,14,1,13,3,10,0
63,Carles Aleñá,1,0,1,0,0,0,0,,0,0,0,0,0,0,0
64,Carles Aleñá,15,10,3,9,3,7,25,28.0,18,14,1,13,2,2,0
65,Rúnar Alex Rúnarsson,0,0,0,0,0,0,0,,0,0,0,0,0,0,0
66,Trent Alexander-Arnold,56,33,31,18,7,36,56,64.3,20,24,3,21,49,50,3
67,Alfon,0,0,0,0,0,0,0,,0,0,0,0,0,0,0
68,Mohamed Ali Cho,9,7,2,6,1,4,9,44.4,5,4,0,4,3,0,0
69,Ezgjan Alioski,74,31,38,28,8,32,74,43.2,42,17,2,15,23,50,2
70,Rachid Alioui,0,0,0,0,0,0,1,0.0,1,0,0,0,0,0,0
71,Alisson,3,2,3,0,0,3,4,75.0,1,0,0,0,2,26,7
72,Saturnin Allagbé,0,0,0,0,0,0,1,0.0,1,0,0,0,0,9,3
73,Allan,80,45,39,37,4,28,95,29.5,67,31,12,19,19,25,1
74,Dele Alli,18,11,8,6,4,7,19,36.8,12,9,0,9,7,3,0
75,Miguel Almirón,49,29,21,25,3,14,56,25.0,42,23,4,19,25,20,1
76,Marcos Alonso,13,3,6,4,3,7,14,50.0,7,12,1,11,12,30,0
77,Sergio Álvarez,42,25,13,26,3,8,22,36.4,14,22,5,17,22,24,2
78,Yeray Álvarez,19,12,11,8,0,9,21,42.9,12,12,5,7,53,73,0
79,Bruno Alves,13,10,10,3,0,7,9,77.8,2,17,12,5,26,81,0
80,Steven Alzate,17,8,10,4,3,6,15,40.0,9,8,1,7,8,10,0
81,Ibrahim Amadou,39,26,18,19,2,15,38,39.5,23,14,4,10,23,25,0
82,Romain Amalfitano,4,2,3,1,0,1,3,33.3,2,2,1,1,1,1,0
83,Emmanuel Amankwaa Akurugu,0,0,0,0,0,0,1,0.0,1,1,0,1,2,1,0
84,Daniel Amartey,11,7,6,4,1,8,12,66.7,4,8,4,4,12,26,0
85,Jordan Amavi,11,9,9,1,1,9,12,75.0,3,12,2,10,27,33,1
86,Thierry Ambrose,7,4,1,1,5,2,12,16.7,10,2,0,2,2,4,0
87,Wisdom Amey,0,0,0,0,0,0,0,,0,0,0,0,0,0,0
88,Nadiem Amiri,12,7,4,8,0,7,33,21.2,26,18,3,15,12,7,0
89,Ethan Ampadu,57,36,31,24,2,20,46,43.5,26,40,19,21,49,87,3
90,Sofyan Amrabat,39,22,11,24,4,18,48,37.5,30,30,5,25,23,12,0
91,Jon Ander Garrido,18,10,8,7,3,10,26,38.5,16,12,4,8,14,13,0
92,Joachim Andersen,33,19,18,11,4,15,28,53.6,13,24,13,11,44,151,1
93,Joachim Andersen,2,1,1,1,0,2,2,100.0,0,1,1,0,2,6,0
94,Djavan Anderson,0,0,0,0,0,0,1,0.0,1,1,0,1,1,0,0
95,Elliot Anderson,0,0,0,0,0,0,0,,0,0,0,0,0,0,0
96,Felipe Anderson,1,1,0,1,0,0,0,,0,0,0,0,0,0,0
97,Sebastian Andersson,3,2,0,3,0,1,8,12.5,7,10,3,7,2,9,0
98,Nícolas Andrade,0,0,0,0,0,0,0,,0,0,0,0,0,0,0
99,Benjamin André,114,68,47,61,6,53,122,43.4,69,39,10,29,76,49,0
100,Marcos André,8,2,2,2,4,0,8,0.0,8,15,2,13,2,9,0
101,Robert Andrich,51,24,22,27,2,24,53,45.3,29,40,6,34,51,31,2
102,Victorien Angban,36,24,17,15,4,17,42,40.5,25,17,4,13,19,9,1
103,Ángel,0,0,0,0,0,0,0,,0,0,0,0,0,1,0
104,José Ángel,15,8,9,4,2,8,12,66.7,4,7,0,7,13,17,1
105,Miguel Ángel Rubio,0,0,0,0,0,0,0,,0,2,2,0,3,11,0
106,Angeliño,31,19,10,18,3,13,24,54.2,11,22,1,21,30,40,0
107,Davide Angelo Ghislandi,0,0,0,0,0,0,0,,0,0,0,0,0,1,0
108,Philip Ankhrah,0,0,0,0,0,0,0,,0,1,0,1,0,0,0
109,Cristian Ansaldi,48,33,25,14,9,24,38,63.2,14,21,7,14,16,38,0
110,Waldemar Anton,31,20,17,14,0,12,31,38.7,19,28,18,10,47,114,0
111,Michail Antonio,7,4,1,5,1,1,7,14.3,6,20,3,17,7,7,0
112,José Antonio Miranda,0,0,0,0,0,0,1,0.0,1,1,0,1,0,0,0
113,Valentin Antov,4,2,3,1,0,3,10,30.0,7,6,5,1,4,13,0
114,Houssem Aouar,17,12,0,13,4,8,25,32.0,17,17,1,16,17,4,0
115,Adil Aouchiche,38,20,12,17,9,13,49,26.5,36,15,1,14,10,6,0
116,Dennis Appiah,55,34,33,15,7,32,59,54.2,27,23,6,17,25,43,0
117,Aritz Arambarri,1,1,0,1,0,1,2,50.0,1,0,0,0,0,0,0
118,Mauro Arambarri,64,39,22,35,7,23,80,28.8,57,40,5,35,42,28,0
119,Charles Aránguiz,41,23,16,21,4,17,43,39.5,26,32,4,28,33,17,0
120,Luiz Araújo,38,25,12,18,8,8,28,28.6,20,23,1,22,11,3,0
121,Néstor Araujo,24,16,14,9,1,7,15,46.7,8,23,18,5,43,89,2
122,Ronald Araújo,22,11,12,8,2,9,9,100.0,0,24,15,9,20,47,1
123,Anaitz Arbilla,45,26,31,11,3,27,54,50.0,27,36,11,25,69,73,1
124,Alphonse Areola,1,0,1,0,0,1,5,20.0,4,0,0,0,1,13,3
125,Santiago Arias,2,1,0,1,1,1,1,100.0,0,0,0,0,1,4,0
126,Karim Aribi,2,2,0,1,1,0,5,0.0,5,1,0,1,0,3,0
127,Unai Arietaleanizbeaskoa,1,0,0,0,1,0,0,,0,0,0,0,0,0,0
128,Nicolò Armini,0,0,0,0,0,0,0,,0,0,0,0,0,0,0
129,Stuart Armstrong,60,41,19,32,9,27,75,36.0,48,26,1,25,24,19,0
130,Maximilian Arnold,47,32,20,26,1,18,49,36.7,31,24,3,21,49,57,0
131,Tolu Arokodare,1,1,0,0,1,0,0,,0,1,0,1,1,0,0
132,Sergio Arribas,3,1,2,1,0,1,3,33.3,2,2,0,2,4,2,0
133,Kepa Arrizabalaga,0,0,0,0,0,0,1,0.0,1,0,0,0,0,0,3
134,Tolgay Arslan,52,32,24,24,4,25,54,46.3,29,22,2,20,22,15,1
135,Kwadwo Asamoah,4,3,2,2,0,2,3,66.7,1,5,1,4,4,2,1
136,Santiago Ascacíbar,30,15,15,14,1,15,28,53.6,13,23,2,21,13,14,0
137,Sergio Asenjo,0,0,0,0,0,0,1,0.0,1,0,0,0,0,13,2
138,Marco Asensio,12,6,7,4,1,3,24,12.5,21,15,0,15,11,10,0
139,Kristoffer Askildsen,0,0,0,0,0,0,0,,0,2,0,2,3,3,0
140,Iago Aspas,11,3,2,7,2,2,23,8.7,21,25,2,23,16,21,0
141,Roger Assalé,10,8,3,5,2,4,12,33.3,8,7,3,4,2,2,0
142,Youcef Atal,25,12,11,14,0,13,26,50.0,13,10,2,8,26,12,0
143,Miguel Atienza,20,9,5,15,0,8,23,34.8,15,14,1,13,9,12,0
144,Pierre-Emerick Aubameyang,12,8,7,4,1,3,20,15.0,17,18,0,18,7,17,0
145,Emil Audero,1,1,1,0,0,1,2,50.0,1,0,0,0,1,16,0
146,Tommaso Augello,42,30,27,10,5,23,39,59.0,16,22,2,20,32,76,1
147,Jean-Kévin Augustin,2,0,0,2,0,2,2,100.0,0,0,0,0,0,0,0
148,Ludwig Augustinsson,37,20,19,14,4,17,29,58.6,12,21,7,14,20,62,0
149,Serge Aurier,55,33,33,17,5,15,40,37.5,25,28,5,23,19,44,3
150,Charlie Austin,4,2,1,2,1,1,3,33.3,2,0,0,0,3,4,0
151,Ezequiel Ávila,6,2,3,1,2,2,4,50.0,2,1,0,1,1,0,0
152,Taiwo Awoniyi,5,3,2,3,0,1,14,7.1,13,9,0,9,3,4,0
153,Mehmet Aydin,15,7,9,6,0,4,10,40.0,6,6,1,5,6,16,0
154,Jordan Ayew,38,26,8,16,14,16,44,36.4,28,28,2,26,16,12,0
155,Kaan Ayhan,15,9,8,5,2,8,13,61.5,5,9,5,4,16,33,0
156,Luke Ayling,108,61,69,30,9,49,87,56.3,38,53,36,17,36,96,5
157,Ramon Azeez,1,1,0,1,0,0,0,,0,0,0,0,1,1,0
158,César Azpilicueta,53,28,22,24,7,19,37,51.4,18,30,5,25,28,62,2
159,Ludovic Baal,6,5,4,1,1,2,5,40.0,3,4,1,3,5,5,0
160,Carlos Bacca,9,5,5,3,1,3,5,60.0,2,5,0,5,3,2,0
161,Loïc Bade,57,34,47,10,0,30,55,54.5,25,43,17,26,74,135,2
162,Milan Badelj,56,27,27,22,7,26,84,31.0,58,51,10,41,87,45,1
163,Édgar Badía,1,0,1,0,0,1,3,33.3,2,0,0,0,0,17,3
164,Benoît Badiashile,24,17,15,9,0,13,28,46.4,15,21,12,9,58,102,4
165,Alex Baena,4,3,1,2,1,1,3,33.3,2,1,1,0,1,1,0
166,Miguel Baeza,7,6,5,2,0,5,13,38.5,8,3,0,3,3,2,0
167,Stéphane Bahoken,9,6,1,7,1,4,12,33.3,8,9,0,9,9,9,0
168,Leon Bailey,14,8,3,7,4,4,15,26.7,11,13,0,13,9,3,0
169,Eric Bailly,5,5,3,1,1,0,1,0.0,1,13,11,2,13,36,2
170,Stefan Bajic,0,0,0,0,0,0,0,,0,0,0,0,0,1,0
171,Tiemoué Bakayoko,69,41,21,41,7,23,40,57.5,17,24,2,22,36,13,2
172,Mitchel Bakker,38,30,15,14,9,17,26,65.4,9,22,2,20,22,20,0
173,Ridle Baku,50,31,20,20,10,22,53,41.5,31,54,4,50,40,33,1
174,Ridle Baku,4,2,3,1,0,2,6,33.3,4,3,1,2,3,6,0
175,Dilane Bakwa,2,2,1,1,0,0,1,0.0,1,2,0,2,1,0,0
176,Fabián Balbuena,24,12,23,1,0,14,23,60.9,9,23,6,17,25,63,0
177,Keita Baldé,9,6,2,6,1,4,10,40.0,6,10,1,9,0,3,0
178,George Baldock,47,34,28,14,5,21,50,42.0,29,26,7,19,25,70,1
179,Gareth Bale,17,10,4,9,4,7,14,50.0,7,13,2,11,8,16,0
180,Mikel Balenziaga,26,15,11,12,3,9,18,50.0,9,22,7,15,7,46,0
181,Leonardo Balerdi,29,18,19,7,3,14,31,45.2,17,17,9,8,28,65,3
182,Fodé Ballo-Touré,21,17,9,11,1,6,13,46.2,7,7,0,7,6,11,1
183,Botond Balogh,9,7,9,0,0,2,5,40.0,3,4,3,1,2,8,0
184,Abdoulaye Bamba,27,17,19,7,1,19,28,67.9,9,7,1,6,19,34,0
185,Jonathan Bamba,45,23,15,19,11,24,84,28.6,60,24,2,22,24,15,0
186,Robson Bambu,16,11,14,2,0,11,14,78.6,3,8,7,1,10,57,0
187,Patrick Bamford,21,9,2,11,8,8,27,29.6,19,14,4,10,10,37,0
188,Mattia Bani,10,5,5,5,0,5,12,41.7,7,16,11,5,27,44,0
189,Mattia Bani,20,11,15,4,1,4,8,50.0,4,10,6,4,33,50,0
190,Simon Banza,13,6,0,4,9,1,14,7.1,13,16,1,15,7,15,0
191,Antonín Barák,30,19,8,16,6,14,47,29.8,33,26,7,19,12,38,1
192,Federico Barba,31,16,22,8,1,21,35,60.0,14,39,18,21,48,94,4
193,Danilo Barbosa,6,3,5,1,0,4,6,66.7,2,2,1,1,2,11,2
194,Barcia,1,1,1,0,0,0,0,,0,1,1,0,3,9,0
195,Melvin Bard,12,8,7,4,1,6,11,54.5,5,10,2,8,6,14,0
196,Enis Bardhi,28,12,8,16,4,10,36,27.8,26,8,2,6,21,14,0
197,Phil Bardsley,6,5,4,2,0,3,6,50.0,3,3,1,2,6,12,0
198,Nicolò Barella,58,31,23,29,6,23,72,31.9,49,29,4,25,26,14,0
199,Philipp Bargfrede,0,0,0,0,0,0,0,,0,0,0,0,0,3,0
200,Kike Barja,10,5,6,1,3,5,24,20.8,19,10,1,9,16,8,0
201,Ross Barkley,6,2,2,4,0,3,15,20.0,12,9,1,8,5,6,1
202,Ross Barkley,0,0,0,0,0,0,0,,0,0,0,0,0,0,0
203,Aymen Barkok,29,15,11,9,9,10,31,32.3,21,15,1,14,10,9,1
204,Ashley Barnes,12,6,2,6,4,3,13,23.1,10,14,2,12,5,11,0
205,Harvey Barnes,19,9,11,3,5,5,22,22.7,17,16,3,13,8,11,0
206,Marc Baró,2,1,2,0,0,0,2,0.0,2,1,0,1,2,2,1
207,Antonio Barragán,28,14,21,5,2,12,21,57.1,9,22,8,14,33,67,1
208,Antonio Barreca,1,0,0,1,0,1,1,100.0,0,0,0,0,0,1,0
209,Leandro Barreiro Martins,58,32,19,26,13,20,50,40.0,30,34,9,25,57,55,0
210,Ander Barrenetxea,29,19,5,18,6,9,24,37.5,15,20,0,20,6,8,0
211,Jacob Barrett Laursen,23,12,13,8,2,10,16,62.5,6,14,4,10,24,37,0
212,Musa Barrow,26,10,8,10,8,10,25,40.0,15,37,2,35,11,15,0
213,Kyle Bartley,27,16,14,10,3,11,23,47.8,12,50,35,15,38,159,1
214,Paolo Bartolomei,6,2,3,1,2,4,7,57.1,3,1,0,1,1,2,0
215,Marc Bartra,27,16,18,8,1,12,22,54.5,10,19,5,14,40,74,3
216,Daniele Baselli,12,7,3,6,3,6,10,60.0,4,2,0,2,9,5,0
217,Chris Basham,69,42,41,23,5,41,67,61.2,26,36,15,21,49,105,1
218,Toma Bašić,33,22,15,16,2,16,58,27.6,42,21,5,16,32,42,1
219,Álvaro Bastida,0,0,0,0,0,0,0,,0,0,0,0,0,0,0
220,Alessandro Bastoni,36,22,13,21,2,17,27,63.0,10,34,16,18,40,75,0
221,Simone Bastoni,50,29,26,22,2,27,52,51.9,25,19,1,18,16,31,0
222,Bastos,3,1,2,0,1,3,5,60.0,2,1,0,1,0,3,0
223,Michy Batshuayi,5,3,1,2,2,1,9,11.1,8,5,1,4,4,5,0
224,Rodrigo Battaglia,38,16,21,14,3,16,50,32.0,34,30,14,16,29,40,1
225,Cristian Battocchio,5,2,1,4,0,2,9,22.2,7,0,0,0,4,5,0
226,Oliver Baumann,0,0,0,0,0,0,1,0.0,1,0,0,0,2,14,0
227,Julian Baumgartlinger,43,20,14,26,3,16,31,51.6,15,12,0,12,12,10,1
228,Christoph Baumgartner,44,31,13,24,7,14,51,27.5,37,40,8,32,24,24,0
229,Jon Bautista,5,3,0,2,3,0,3,0.0,3,3,1,2,2,4,0
230,Paul Baysse,35,18,21,13,1,16,21,76.2,5,33,24,9,52,123,1
231,Noah Joel Sarenren Bazee,0,0,0,0,0,0,1,0.0,1,0,0,0,1,0,0
232,Ihlas Bebou,24,9,5,10,9,8,14,57.1,6,18,4,14,17,16,0
233,Rodrigo Becão,59,33,36,20,3,27,49,55.1,22,48,27,21,68,94,2
234,Sheraldo Becker,5,4,2,2,1,3,5,60.0,2,4,0,4,6,7,0
235,Timo Becker,34,23,28,6,0,16,25,64.0,9,18,4,14,22,58,0
236,Jan Bednarek,37,19,25,11,1,25,49,51.0,24,44,27,17,84,132,0
237,Donny van de Beek,15,10,2,11,2,7,15,46.7,8,10,1,9,6,7,0
238,Valon Behrami,21,9,9,10,2,9,26,34.6,17,13,5,8,9,13,0
239,Brian Behrendt,0,0,0,0,0,0,1,0.0,1,0,0,0,0,1,0
240,Maximilian Beier,0,0,0,0,0,0,1,0.0,1,0,0,0,0,0,0
241,Ishak Belfodil,3,2,0,0,3,0,2,0.0,2,1,0,1,1,3,0
242,Erwan Belhadji,3,0,3,0,0,3,5,60.0,2,1,0,1,0,0,0
243,Haris Belkebla,69,39,32,28,9,31,66,47.0,35,26,5,21,57,34,0
244,Stefan Bell,24,18,15,9,0,14,23,60.9,9,19,11,8,27,76,1
245,Karim Bellarabi,12,10,3,4,5,4,17,23.5,13,12,0,12,12,4,0
246,Jean-Ricner Bellegarde,56,39,22,25,9,14,23,60.9,9,20,2,18,19,16,0
247,Héctor Bellerín,29,19,14,12,3,12,41,29.3,29,26,8,18,33,33,0
248,Jude Bellingham,49,31,11,29,9,19,46,41.3,27,37,5,32,24,13,0
249,Andrea Belotti,30,18,4,16,10,11,35,31.4,24,27,4,23,12,21,0
250,Fran Beltrán,30,22,15,12,3,8,24,33.3,16,14,1,13,16,24,0
251,Sami Ben Amar,0,0,0,0,0,0,0,,0,1,0,1,0,0,0
252,Hatem Ben Arfa,11,7,1,7,3,2,9,22.2,7,3,0,3,2,0,0
253,Salim Ben Seghir,0,0,0,0,0,0,0,,0,0,0,0,0,0,0
254,Wissam Ben Yedder,18,9,2,10,6,3,13,23.1,10,16,0,16,13,3,0
255,Ahmad Benali,19,11,10,9,0,11,38,28.9,27,15,2,13,6,15,0
256,Samy Benchamma,1,1,1,0,0,0,0,,0,0,0,0,0,1,0
257,Lars Bender,19,13,12,6,1,9,21,42.9,12,19,5,14,16,19,0
258,Sven Bender,17,9,8,8,1,7,20,35.0,13,20,9,11,21,41,1
259,Darío Benedetto,6,4,1,4,1,5,13,38.5,8,9,2,7,3,17,0
260,László Bénes,8,6,4,4,0,2,8,25.0,6,6,2,4,7,1,1
261,László Bénes,6,2,5,1,0,2,4,50.0,2,0,0,0,2,1,0
262,Walter Benítez,1,1,1,0,0,1,3,33.3,2,1,0,1,1,7,2
263,Loris Benito,42,26,27,12,3,22,48,45.8,26,33,10,23,42,70,0
264,Sergio Benito,0,0,0,0,0,0,0,,0,0,0,0,0,0,0
265,Bilal Benkhedim,0,0,0,0,0,0,1,0.0,1,1,0,1,0,0,0
266,Djamel Benlamri,5,3,5,0,0,3,6,50.0,3,3,2,1,6,11,0
267,Ismaël Bennacer,39,18,17,21,1,15,32,46.9,17,10,1,9,20,12,0
268,Saïd Benrahma,24,15,8,11,5,8,28,28.6,20,10,0,10,8,8,0
269,Yassine Benrahou,16,9,8,6,2,7,25,28.0,18,9,0,9,4,5,1
270,Ramy Bensebaini,43,24,27,13,3,26,42,61.9,16,39,7,32,47,66,0
271,Josh Benson,5,1,3,0,2,1,6,16.7,5,3,0,3,3,2,0
272,Nabil Bentaleb,14,8,7,6,1,4,15,26.7,11,5,2,3,6,8,0
273,Rodrigo Bentancur,63,33,21,37,5,20,59,33.9,39,35,12,23,47,46,1
274,Christian Benteke,15,7,1,7,7,2,9,22.2,7,17,6,11,4,39,0
275,Karim Benzema,8,6,4,2,2,5,15,33.3,10,9,2,7,8,24,0
276,Yassine Benzia,10,5,5,3,2,2,10,20.0,8,3,0,3,6,2,0
277,Alessandro Berardi,0,0,0,0,0,0,0,,0,0,0,0,0,0,0
278,Domenico Berardi,42,22,17,11,14,21,62,33.9,41,23,1,22,26,34,0
279,Gaetano Berardi,2,2,1,0,1,0,0,,0,2,1,1,1,2,0
280,Yuri Berchiche,24,19,14,5,5,10,24,41.7,14,14,0,14,11,29,0
281,Álex Berenguer,2,0,0,0,2,2,5,40.0,3,2,0,2,0,1,0
282,Álex Berenguer,47,31,21,20,6,9,51,17.6,42,48,3,45,18,27,0
283,Bartosz Bereszyński,66,44,37,22,7,41,73,56.2,32,40,20,20,42,88,0
284,Jóhann Berg Guðmundsson,19,11,6,9,4,11,23,47.8,12,11,2,9,17,19,0
285,Sander Berge,16,7,8,5,3,7,15,46.7,8,11,2,9,4,18,0
286,Steven Bergwijn,15,7,8,3,4,7,20,35.0,13,7,1,6,5,9,0
287,Valon Berisha,40,23,19,17,4,11,47,23.4,36,14,2,12,25,21,1
288,Bernard,8,3,3,3,2,7,15,46.7,8,5,0,5,8,6,0
289,Federico Bernardeschi,9,4,3,5,1,4,20,20.0,16,6,2,4,14,7,1
290,Bernardo,10,8,8,1,1,4,6,66.7,2,2,0,2,1,1,0
291,Paul Bernardoni,1,1,1,0,0,1,2,50.0,1,0,0,0,2,23,1
292,Juan Bernat,5,3,0,4,1,3,5,60.0,2,4,0,4,1,6,0
293,Dimitry Bertaud,0,0,0,0,0,0,0,,0,0,0,0,1,2,0
294,Marco Bertini,1,0,1,0,0,0,0,,0,0,0,0,0,0,0
295,Ryan Bertrand,60,32,26,27,7,30,48,62.5,18,19,1,18,30,41,1
296,Daniel Bessa,15,8,3,11,1,6,14,42.9,8,5,1,4,2,0,0
297,Loïc Bessile,0,0,0,0,0,0,0,,0,2,1,1,1,3,0
298,Jordan Beyer,2,1,2,0,0,1,2,50.0,1,5,4,1,5,5,0
299,Giulian Biancone,3,3,1,1,1,2,3,66.7,1,1,0,1,1,4,0
300,Bartosz Białek,6,5,1,4,1,4,4,100.0,0,5,1,4,3,4,0
301,Ermin Bičakčić,1,1,0,1,0,1,1,100.0,0,1,1,0,3,9,0
302,Pedro Bigas,11,9,7,4,0,7,14,50.0,7,12,6,6,23,54,0
303,El Bilal Touré,22,12,3,16,3,8,18,44.4,10,8,3,5,6,10,1
304,Cristiano Biraghi,42,23,19,15,8,27,45,60.0,18,23,9,14,27,56,3
305,Davide Biraschi,17,9,12,5,0,5,10,50.0,5,12,6,6,21,26,0
306,Yves Bissouma,104,68,50,48,6,33,67,49.3,34,42,6,36,64,67,0
307,Leonardo Bittencourt,58,32,24,28,6,16,51,31.4,35,29,2,27,13,10,0
308,Alejandro Blanco,8,4,4,4,0,3,18,16.7,15,5,0,5,8,9,0
309,Antonio Blanco,7,2,4,2,1,3,7,42.9,4,6,2,4,3,5,0
310,Rubén Blanco,0,0,0,0,0,0,0,,0,0,0,0,0,7,3
311,Ludovic Blas,58,30,18,37,3,23,54,42.6,31,33,4,29,21,19,0
312,Alejandro Blesa,0,0,0,0,0,0,0,,0,0,0,0,0,0,0
313,Jérôme Boateng,26,16,17,8,1,14,32,43.8,18,24,17,7,40,63,1
314,Antonin Bobichon,23,14,10,8,5,9,15,60.0,6,4,1,3,2,1,0
315,Yann Bodiger,2,2,1,1,0,1,6,16.7,5,7,3,4,8,4,0
316,Jean-Paul Boëtius,42,28,13,15,14,17,47,36.2,30,37,3,34,33,14,0
317,Sacha Boey,54,40,30,23,1,27,55,49.1,28,25,5,20,41,62,0
318,Sacha Boey,3,3,2,1,0,3,4,75.0,1,0,0,0,2,2,0
319,Jeremie Boga,11,9,5,0,6,3,11,27.3,8,10,0,10,8,7,0
320,Melayro Bogarde,7,3,3,3,1,5,9,55.6,4,0,0,0,5,1,0
321,Jayden Bogle,33,23,21,10,2,20,39,51.3,19,14,4,10,14,22,0
322,Quentin Boisgard,24,17,3,15,6,11,24,45.8,13,17,2,15,15,1,0
323,Willy Boly,33,20,26,7,0,13,24,54.2,11,18,12,6,32,84,1
324,Giacomo Bonaventura,34,19,16,13,5,16,53,30.2,37,26,2,24,39,12,0
325,Federico Bonazzoli,6,4,0,4,2,2,13,15.4,11,3,0,3,2,3,0
326,Federico Bonazzoli,0,0,0,0,0,0,0,,0,1,0,1,0,0,0
327,Kevin Bonifazi,32,21,24,6,2,8,23,34.8,15,33,20,13,50,85,1
328,Leonardo Bonucci,19,14,10,8,1,6,14,42.9,8,24,13,11,33,67,0
329,Elias Bördner,1,0,1,0,0,1,1,100.0,0,0,0,0,2,1,0
330,Dennis Borkowski,0,0,0,0,0,0,0,,0,1,0,1,0,0,0
331,Sebastiaan Bornauw,29,20,25,4,0,14,25,56.0,11,33,26,7,40,104,0
332,Sven Botman,31,21,18,12,1,14,26,53.8,12,31,21,10,57,126,2
333,Denis Bouanga,52,28,22,24,6,16,58,27.6,42,32,3,29,20,36,0
334,Hicham Boudaoui,52,35,20,24,8,26,68,38.2,42,14,4,10,23,26,1
335,Ryad Boudebouz,9,4,1,7,1,4,8,50.0,4,3,0,3,5,5,0
336,Sofiane Boufal,17,11,8,6,3,8,28,28.6,20,8,0,8,3,1,0
337,Nassim Boujellab,13,9,2,10,1,2,12,16.7,10,10,3,7,7,9,0
338,Farid Boulaya,24,16,4,17,3,13,51,25.5,38,19,3,16,12,7,0
339,Yassine Bounou,1,1,1,0,0,0,2,0.0,2,0,0,0,0,12,2
340,Ismaëlben Boura,11,7,8,2,1,3,9,33.3,6,7,2,5,21,12,0
341,Mehdi Bourabia,6,5,1,4,1,2,7,28.6,5,14,6,8,12,8,0
342,Benjamin Bourigeaud,40,23,17,16,7,21,71,29.6,50,37,1,36,19,25,0
343,Edoardo Bove,0,0,0,0,0,0,1,0.0,1,0,0,0,0,0,0
344,Jarrod Bowen,26,15,12,7,7,10,29,34.5,19,19,1,18,22,10,0
345,Dedryck Boyata,14,7,10,3,1,7,15,46.7,8,23,20,3,26,68,1
346,John Boye,58,34,43,13,2,31,54,57.4,23,36,20,16,80,146,1
347,Lucas Boyé,47,31,13,27,7,10,49,20.4,39,37,2,35,19,21,0
348,Can Bozdogan,13,5,6,6,1,4,15,26.7,11,10,2,8,7,5,0
349,Umut Bozok,0,0,0,0,0,0,2,0.0,2,0,0,0,0,0,0
350,Jayden Braaf,0,0,0,0,0,0,1,0.0,1,0,0,0,0,0,0
351,Domagoj Bradarić,28,18,11,13,4,12,27,44.4,15,14,4,10,26,21,0
352,Robbie Brady,22,15,12,6,4,12,35,34.3,23,16,0,16,9,29,1
353,Martin Braithwaite,8,4,2,3,3,1,6,16.7,5,2,0,2,6,7,0
354,Julian Brandt,27,14,13,9,5,12,43,27.9,31,25,1,24,17,7,1
355,Darko Brašanac,10,6,6,4,0,5,16,31.3,11,8,1,7,7,10,0
356,Lilian Brassier,19,10,12,4,3,7,11,63.6,4,13,6,7,23,38,1
357,Álvaro Bravo,1,1,1,0,0,1,2,50.0,1,0,0,0,1,0,0
358,Claudio Bravo,0,0,0,0,0,0,1,0.0,1,0,0,0,0,11,0
359,Fabian Bredlow,0,0,0,0,0,0,0,,0,0,0,0,0,0,0
360,Josip Brekalo,22,10,10,7,5,8,29,27.6,21,18,0,18,17,3,1
361,Gleison Bremer,51,34,36,14,1,21,36,58.3,15,54,21,33,70,142,1
362,Joshua Brenet,0,0,0,0,0,0,0,,0,0,0,0,0,0,0
363,Rhian Brewster,8,5,1,4,3,1,13,7.7,12,15,2,13,5,5,0
364,Anthony Briançon,12,7,9,3,0,9,19,47.4,10,19,12,7,33,57,2
365,Jimmy Briand,7,3,3,2,2,1,1,100.0,0,2,0,2,1,3,0
366,Yan Brice Eteki,23,15,10,12,1,8,19,42.1,11,13,3,10,13,16,1
367,Nathan Broadhead,1,1,0,1,0,0,0,,0,0,0,0,0,0,0
368,Dylan Bronn,57,37,38,19,0,24,44,54.5,20,31,14,17,44,112,0
369,John Brooks,47,29,33,14,0,30,54,55.6,24,35,10,25,55,134,0
370,Daniel Brosinski,19,14,10,7,2,12,31,38.7,19,18,1,17,14,33,0
371,Josh Brownhill,45,27,9,29,7,15,44,34.1,29,33,11,22,69,39,0
372,Marcelo Brozović,54,29,23,24,7,20,61,32.8,41,43,17,26,40,38,0
373,Gastón Brugman,35,19,18,15,2,11,44,25.0,33,33,4,29,45,34,0
374,Juan Brunet,0,0,0,0,0,0,0,,0,0,0,0,0,1,0
375,Juan Brunetta,2,2,0,2,0,1,6,16.7,5,5,0,5,1,2,0
376,Cédric Brunner,42,22,24,15,3,27,40,67.5,13,30,10,20,42,96,0
377,Jacob Bruun Larsen,0,0,0,0,0,0,0,,0,0,0,0,0,0,0
378,Joe Bryan,15,8,7,5,3,7,12,58.3,5,8,2,6,14,16,0
379,Kean Bryan,20,10,9,11,0,9,19,47.4,10,16,10,6,13,39,1
380,Lucas Buadés,1,0,0,1,0,0,0,,0,0,0,0,0,0,0
381,Ante Budimir,20,12,2,11,7,4,15,26.7,11,17,4,13,2,17,1
382,Gianluigi Buffon,0,0,0,0,0,0,0,,0,0,0,0,0,3,1
383,Marius Bülter,15,8,6,6,3,5,17,29.4,12,17,2,15,12,11,0
384,Alessandro Buongiorno,12,5,8,4,0,7,12,58.3,5,15,9,6,11,44,1
385,Esteban Burgos,7,6,4,3,0,1,5,20.0,4,8,7,1,23,54,2
386,Burgui,3,1,2,1,0,1,1,100.0,0,0,0,0,0,0,0
387,Jonathan Burkardt,27,13,15,10,2,11,19,57.9,8,20,3,17,8,15,0
388,Nishan Burkart,0,0,0,0,0,0,1,0.0,1,0,0,0,0,0,0
389,Oliver Burke,16,8,6,9,1,5,24,20.8,19,24,0,24,2,6,0
390,Roman Bürki,0,0,0,0,0,0,0,,0,0,0,0,0,5,1
391,Dan Burn,50,26,33,14,3,27,53,50.9,26,30,7,23,31,75,0
392,Patrick Burner,0,0,0,0,0,0,0,,0,0,0,0,0,0,0
393,Patrick Burner,25,11,14,10,1,13,26,50.0,13,10,3,7,24,41,1
394,Maxime Busi,23,13,19,3,1,11,28,39.3,17,14,1,13,16,32,0
395,Sergio Busquets,63,35,21,29,13,27,76,35.5,49,27,4,23,53,18,2
396,Jack Butland,0,0,0,0,0,0,0,,0,0,0,0,0,0,0
397,David Button,0,0,0,0,0,0,0,,0,0,0,0,0,0,0
398,Oskar Buur,0,0,0,0,0,0,2,0.0,2,0,0,0,0,0,0
399,Marcin Bułka,0,0,0,0,0,0,0,,0,0,0,0,0,0,1
400,Erick Cabaco,24,14,11,12,1,12,22,54.5,10,8,6,2,13,51,1
401,Willy Caballero,0,0,0,0,0,0,0,,0,0,0,0,0,0,0
402,Jimmy Cabot,26,13,8,14,4,11,36,30.6,25,8,0,8,12,6,0
403,Martín Cáceres,28,12,16,11,1,15,35,42.9,20,20,14,6,14,52,1
404,Anthony Caci,80,46,47,27,6,35,69,50.7,34,30,4,26,55,65,1
405,Mathieu Cafaro,40,17,15,19,6,13,43,30.2,30,11,0,11,17,12,0
406,Gary Cahill,13,9,10,3,0,7,11,63.6,4,27,22,5,13,88,0
407,Yannick Cahuzac,26,12,12,10,4,9,27,33.3,18,18,5,13,33,72,0
408,Felipe Caicedo,10,7,4,4,2,1,8,12.5,7,7,0,7,4,2,0
409,Marc-Aurèle Caillard,0,0,0,0,0,0,0,,0,0,0,0,0,2,0
410,Tom Cairney,9,3,1,4,4,1,4,25.0,3,6,0,6,0,3,0
411,Cala,21,12,15,6,0,11,21,52.4,10,18,8,10,35,91,0
412,Arturo Calabresi,0,0,0,0,0,0,0,,0,0,0,0,0,2,0
413,Arturo Calabresi,0,0,0,0,0,0,1,0.0,1,0,0,0,0,0,0
414,Davide Calabria,101,64,61,32,8,54,90,60.0,36,42,9,33,37,82,1
415,Riccardo Calafiori,1,0,1,0,0,1,4,25.0,3,1,0,1,0,0,0
416,Mattia Caldara,1,0,0,1,0,1,1,100.0,0,3,2,1,4,3,0
417,Luca Caldirola,21,13,13,6,2,10,22,45.5,12,20,15,5,20,56,0
418,Duje Ćaleta-Car,29,17,19,9,1,17,30,56.7,13,29,22,7,44,130,0
419,Hakan Çalhanoğlu,26,7,3,17,6,7,28,25.0,21,21,6,15,15,24,1
420,Kerim Calhanoglu,3,3,1,1,1,0,3,0.0,3,4,0,4,7,6,0
421,Fabrizio Caligara,6,4,2,2,2,6,9,66.7,3,9,2,7,3,3,0
422,Daniel Caligiuri,71,46,29,31,11,29,92,31.5,63,45,6,39,38,41,0
423,José Callejón,10,7,0,6,4,5,9,55.6,4,4,1,3,4,5,0
424,Jonathan Calleri,15,6,2,4,9,3,17,17.6,14,18,2,16,1,10,1
425,Dominic Calvert-Lewin,17,8,1,8,8,6,12,50.0,6,22,6,16,6,33,0
426,Dani Calvo,20,13,13,7,0,7,10,70.0,3,18,12,6,11,71,0
427,Drissa Camara,0,0,0,0,0,0,0,,0,0,0,0,0,0,0
428,Mahdi Camara,99,67,43,46,10,33,60,55.0,27,50,12,38,78,51,0
429,Eduardo Camavinga,98,58,39,48,11,38,77,49.4,39,36,2,34,23,15,1
430,José Campaña,14,6,3,6,5,5,14,35.7,9,2,0,2,13,4,0
431,Emre Can,43,34,20,20,3,20,37,54.1,17,35,10,25,48,52,0
432,Sergio Canales,16,9,9,6,1,3,21,14.3,18,18,0,18,13,5,0
433,João Cancelo,68,41,42,19,7,43,83,51.8,40,23,2,21,41,33,2
434,Antonio Candreva,28,19,17,9,2,21,53,39.6,32,24,3,21,9,27,1
435,Álex Cantero,2,1,0,2,0,1,2,50.0,1,1,0,1,0,3,0
436,Ander Capa,37,18,22,13,2,18,37,48.6,19,21,8,13,25,57,0
437,Pierrick Capelle,53,28,24,17,12,31,79,39.2,48,25,1,24,47,32,0
438,Étienne Capoue,20,10,14,6,0,8,18,44.4,10,7,1,6,20,23,0
439,Elio Capradossi,2,1,2,0,0,2,2,100.0,0,0,0,0,1,5,0
440,Gianluca Caprari,16,11,5,5,6,6,31,19.4,25,19,1,18,18,8,0
441,Francesco Caputo,0,0,0,0,0,0,2,0.0,2,4,0,4,1,3,0
442,Maxence Caqueret,72,45,17,39,16,35,106,33.0,71,35,3,32,23,5,2
443,Andrea Carboni,34,23,23,11,0,15,28,53.6,13,15,4,11,14,52,0
444,Isaac Carcelen,68,43,36,25,7,33,60,55.0,27,37,12,25,49,89,0
445,Cárdenas,0,0,0,0,0,0,1,0.0,1,0,0,0,3,5,1
446,Irvin Cardona,10,5,3,6,1,4,22,18.2,18,17,3,14,9,23,2
447,Marc Cardona,1,0,1,0,0,1,1,100.0,0,0,0,0,0,0,0
448,Ian Carlo Poveda,5,4,3,0,2,1,7,14.3,6,5,1,4,1,2,0
449,Diego Carlos,22,13,17,4,1,8,16,50.0,8,35,27,8,31,114,1
450,Juan Carlos,5,3,4,1,0,2,15,13.3,13,7,0,7,1,1,0
451,Lionel Carole,37,25,18,14,5,16,29,55.2,13,3,1,2,38,28,0
452,Yannick Carrasco,27,15,14,6,7,15,34,44.1,19,24,0,24,17,16,1
453,Sergio Carreira,3,0,2,1,0,1,1,100.0,0,2,0,2,1,7,0
454,Guido Carrillo,9,8,1,7,1,2,8,25.0,6,2,1,1,4,14,0
455,Andy Carroll,3,1,1,1,1,1,8,12.5,7,1,0,1,0,14,0
456,Scott Carson,0,0,0,0,0,0,0,,0,0,0,0,0,0,0
457,Dani Carvajal,27,20,12,10,5,11,20,55.0,9,19,1,18,13,27,0
458,Fabio Carvalho,9,6,4,4,1,5,9,55.6,4,2,0,2,1,1,1
459,William Carvalho,19,12,7,11,1,5,21,23.8,16,11,3,8,11,14,1
460,Casemiro,84,49,50,30,4,33,73,45.2,40,50,17,33,70,62,0
461,Matty Cash,71,40,43,22,6,41,74,55.4,33,50,11,39,60,95,0
462,Kiko Casilla,0,0,0,0,0,0,0,,0,0,0,0,0,0,0
463,Giuseppe Caso,0,0,0,0,0,0,0,,0,0,0,0,0,0,0
464,Moreto Cassamã,49,36,24,23,2,27,49,55.1,22,19,6,13,36,33,4
465,Francesco Cassata,7,6,7,0,0,4,7,57.1,3,0,0,0,3,1,0
466,Timothy Castagne,52,32,29,18,5,24,44,54.5,20,29,5,24,29,62,1
467,Koen Casteels,0,0,0,0,0,0,1,0.0,1,1,0,1,2,9,2
468,Jean-Charles Castelletto,32,18,20,11,1,18,31,58.1,13,25,19,6,42,79,0
469,Samu Castillejo,24,12,9,14,1,14,40,35.0,26,21,0,21,6,9,0
470,Gonzalo Castro,21,7,6,9,6,8,23,34.8,15,16,3,13,8,12,0
471,Jonny Castro,11,5,6,4,1,6,13,46.2,7,9,3,6,9,7,0
472,Gaetano Castrovilli,33,19,15,11,7,11,42,26.2,31,25,2,23,34,14,0
473,Danilo Cataldi,7,2,1,5,1,4,18,22.2,14,3,1,2,9,7,0
474,Ivan Cavaleiro,23,14,9,11,3,12,34,35.3,22,25,1,24,19,14,0
475,Edinson Cavani,12,8,1,8,3,2,13,15.4,11,2,0,2,6,11,0
476,Dani Ceballos,37,22,20,11,6,21,51,41.2,30,23,6,17,35,14,1
477,Federico Ceccherini,16,12,10,6,0,2,7,28.6,5,15,8,7,40,60,0
478,Federico Ceccherini,4,1,1,3,0,1,1,100.0,0,6,5,1,7,15,0
479,Zeki Çelik,72,33,30,30,12,44,81,54.3,37,32,6,26,38,52,0
480,Bersant Celina,20,12,8,8,4,7,38,18.4,31,20,2,18,8,10,0
481,Fabien Centonze,104,68,64,30,10,43,73,58.9,30,62,17,45,112,119,1
482,Luca Ceppitelli,25,19,13,10,2,14,26,53.8,12,23,12,11,25,58,1
483,Alberto Cerri,3,2,0,2,1,0,5,0.0,5,4,2,2,2,6,0
484,Sava Cestic,20,9,12,6,2,8,17,47.1,9,13,4,9,18,40,0
485,Julian Chabot,48,34,28,16,4,23,37,62.2,14,25,13,12,37,43,1
486,Nassim Chadli,2,1,2,0,0,0,1,0.0,1,1,0,1,0,0,0
487,Fouad Chafik,39,24,29,8,2,16,35,45.7,19,19,10,9,21,41,0
488,Mehdi Chahiri,18,8,7,5,6,8,20,40.0,12,9,0,9,6,5,0
489,Sofian Chakla,0,0,0,0,0,0,0,,0,0,0,0,0,0,0
490,Sofian Chakla,12,8,10,1,1,5,7,71.4,2,3,2,1,14,48,1
491,Aníbal Chalá,10,7,6,3,1,6,12,50.0,6,5,3,2,14,15,1
492,Trevoh Chalobah,45,26,32,13,0,24,50,48.0,26,20,7,13,69,56,0
493,Calum Chambers,7,3,3,2,2,3,8,37.5,5,6,2,4,10,37,0
494,Timothy Chandler,4,0,2,1,1,1,4,25.0,3,5,2,3,3,5,0
495,Kwon Chang-hoon,3,1,1,0,2,1,3,33.3,2,3,1,2,7,2,1
496,Gaëtan Charbonnier,24,15,6,11,7,12,32,37.5,20,15,1,14,9,19,0
497,Brendan Chardonnet,51,29,31,19,1,27,41,65.9,14,54,41,13,64,151,0
498,Xavier Chavalerin,92,50,47,38,7,26,74,35.1,48,43,9,34,43,29,1
499,Pape Cheikh Diop,24,14,15,6,3,13,33,39.4,20,14,2,12,6,6,0
500,Chema,11,5,6,5,0,5,7,71.4,2,1,0,1,10,23,0
501,Rayan Cherki,5,3,0,3,2,1,11,9.1,10,3,0,3,4,0,0
502,Denis Cheryshev,19,15,6,7,6,6,26,23.1,20,15,1,14,12,15,0
503,Giorgio Chiellini,12,9,9,3,0,5,11,45.5,6,18,13,5,27,56,0
504,Federico Chiesa,6,2,2,2,2,3,8,37.5,5,3,1,2,1,3,0
505,Federico Chiesa,47,26,21,14,12,19,50,38.0,31,23,1,22,12,16,0
506,Ben Chilwell,42,22,16,22,4,15,33,45.5,18,28,3,25,24,58,0
507,Vlad Chiricheș,38,23,34,3,1,21,35,60.0,14,31,21,10,50,59,2
508,Pedro Chirivella,26,8,7,13,6,14,49,28.6,35,23,4,19,41,19,0
509,Tahith Chong,11,6,1,9,1,4,8,50.0,4,4,0,4,5,1,0
510,Joris Chotard,12,8,5,6,1,6,31,19.4,25,12,3,9,11,15,0
511,Hamza Choudhury,8,7,3,5,0,4,10,40.0,6,4,1,3,4,9,1
512,Mounir Chouiar,22,12,10,9,3,6,18,33.3,12,10,0,10,11,8,0
513,Andreas Christensen,11,6,8,3,0,0,8,0.0,8,19,14,5,20,51,1
514,Carney Chukwuemeka,2,2,1,0,1,1,3,33.3,2,0,0,0,0,0,0
515,Samuel Chukwueze,12,7,4,4,4,3,17,17.6,14,8,0,8,10,3,0
516,Darko Churlinov,2,2,2,0,0,1,3,33.3,2,5,1,4,0,2,0
517,Víctor Chust,1,1,0,1,0,0,2,0.0,2,2,2,0,1,5,0
518,Sébastien Cibois,0,0,0,0,0,0,0,,0,0,0,0,0,0,1
519,Cifu,10,7,7,3,0,7,13,53.8,6,5,1,4,8,10,0
520,Alberto Cifuentes,0,0,0,0,0,0,0,,0,0,0,0,0,0,0
521,Luca Cigarini,26,14,11,12,3,12,28,42.9,16,10,1,9,12,9,0
522,Jasper Cillessen,0,0,0,0,0,0,0,,0,0,0,0,0,0,0
523,Antonio Cioffi,0,0,0,0,0,0,0,,0,1,0,1,1,0,0
524,Tim Civeja,0,0,0,0,0,0,1,0.0,1,0,0,0,3,0,0
525,Ciaran Clark,24,14,15,6,3,6,13,46.2,7,27,20,7,29,104,1
526,Alexis Claude-Maurice,40,19,17,14,9,14,48,29.2,34,16,2,14,14,3,0
527,Jonathan Clauss,43,20,12,20,11,17,38,44.7,21,24,1,23,45,46,0
528,Carlos Clerc,56,29,33,16,7,22,39,56.4,17,26,4,22,37,55,1
529,Nathaniel Clyne,17,10,8,8,1,9,16,56.3,7,7,2,5,18,25,1
530,Conor Coady,35,23,25,10,0,19,35,54.3,16,40,32,8,27,134,2
531,Marcus Coco,36,21,17,15,4,16,36,44.4,20,16,3,13,20,17,0
532,Coke,24,10,14,7,3,14,27,51.9,13,13,1,12,14,27,0
533,Séamus Coleman,39,26,21,14,4,21,30,70.0,9,22,6,16,13,37,2
534,Ebrima Colley,11,4,2,6,3,3,11,27.3,8,6,0,6,6,1,0
535,Omar Colley,28,16,19,8,1,13,23,56.5,10,43,29,14,68,133,1
536,Simone Colombi,0,0,0,0,0,0,0,,0,0,0,0,0,2,0
537,Lorenzo Colombo,2,1,1,1,0,0,3,0.0,3,0,0,0,0,3,0
538,Racine Coly,0,0,0,0,0,0,0,,0,0,0,0,0,0,0
539,Kingsley Coman,14,8,6,7,1,2,21,9.5,19,22,0,22,4,3,0
540,Daniel Congré,59,35,45,12,2,36,70,51.4,34,50,33,17,69,144,3
541,Aaron Connolly,6,3,1,3,2,0,2,0.0,2,4,0,4,0,2,0
542,Andrea Consigli,2,2,2,0,0,2,2,100.0,0,0,0,0,0,14,4
543,Andrea Conti,1,1,1,0,0,0,1,0.0,1,0,0,0,1,0,0
544,Andrea Conti,21,10,16,4,1,13,26,50.0,13,13,4,9,16,23,0
545,Liam Cooper,68,45,39,27,2,37,59,62.7,22,39,32,7,61,70,1
546,Francis Coquelin,19,14,4,12,3,8,19,42.1,11,8,2,6,21,11,1
547,Theo Corbeanu,2,1,0,2,0,1,1,100.0,0,0,0,0,1,0,0
548,Sébastien Corchia,55,30,29,17,9,33,60,55.0,27,28,10,18,38,40,1
549,Alex Cordaz,0,0,0,0,0,0,0,,0,0,0,0,1,7,2
550,Iñigo Córdoba,0,0,0,0,0,0,3,0.0,3,4,0,4,2,1,0
551,Iñigo Córdoba,6,4,1,3,2,2,10,20.0,8,7,0,7,3,2,0
552,Jhon Córdoba,9,4,1,5,3,2,4,50.0,2,13,2,11,6,4,0
553,Sergio Córdova,16,8,0,10,6,2,15,13.3,13,14,3,11,9,9,0
554,Jack Cork,26,10,5,17,4,11,31,35.5,20,15,4,11,16,20,0
555,Andreas Cornelius,11,4,1,5,5,2,12,16.7,10,9,2,7,1,25,1
556,Maxwel Cornet,70,41,39,24,7,33,58,56.9,25,23,5,18,43,47,2
557,Ángel Correa,38,21,10,23,5,15,45,33.3,30,18,1,17,22,16,0
558,Joaquín Correa,21,12,6,11,4,7,25,28.0,18,14,0,14,7,12,0
559,Rober Correa,16,9,8,6,2,8,12,66.7,4,9,1,8,20,31,0
560,Félix Correia,0,0,0,0,0,0,0,,0,0,0,0,0,1,0
561,Thierry Correia,47,27,32,10,5,21,43,48.8,22,24,6,18,42,63,1
562,Danny da Costa,22,16,6,9,7,13,27,48.1,14,17,2,15,17,27,0
563,Danny da Costa,0,0,0,0,0,0,1,0.0,1,3,1,2,0,4,0
564,David Pereira da Costa,4,4,1,2,1,2,3,66.7,1,2,0,2,0,4,0
565,Diego Costa,1,0,1,0,0,1,3,33.3,2,0,0,0,0,2,0
566,Douglas Costa,1,0,1,0,0,1,3,33.3,2,0,0,0,0,0,0
567,Douglas Costa,2,1,1,1,0,1,3,33.3,2,7,0,7,2,1,0
568,Hélder Costa,25,11,12,5,8,11,32,34.4,21,11,0,11,3,5,1
569,Jaume Costa,10,6,4,6,0,7,9,77.8,2,7,1,6,6,8,0
570,Angelo da Costa Júnior,0,0,0,0,0,0,0,,0,0,0,0,0,2,3
571,Charles Costes,0,0,0,0,0,0,0,,0,0,0,0,0,0,0
572,Benoît Costil,1,1,1,0,0,1,3,33.3,2,1,0,1,1,17,0
573,Vladimír Coufal,73,36,50,15,8,52,89,58.4,37,41,7,34,41,102,1
574,Kalifa Coulibaly,3,1,0,1,2,2,8,25.0,6,3,1,2,2,12,0
575,Lassana Coulibaly,78,41,33,34,11,39,75,52.0,36,29,4,25,33,17,0
576,Mamadou Coulibaly,10,8,5,5,0,0,0,,0,2,0,2,1,0,0
577,Senou Coulibaly,33,21,23,10,0,12,24,50.0,12,18,12,6,30,89,0
578,Tanguy Coulibaly,26,15,10,7,9,11,23,47.8,12,20,0,20,10,11,0
579,Thibaut Courtois,0,0,0,0,0,0,1,0.0,1,1,0,1,1,17,2
580,Philippe Coutinho,8,6,2,5,1,3,9,33.3,6,7,0,7,2,1,0
581,Nicolas Cozza,39,30,27,11,1,20,40,50.0,20,20,11,9,26,62,0
582,Alessio Cragno,0,0,0,0,0,0,1,0.0,1,0,0,0,1,10,0
583,Gian Crespi,0,0,0,0,0,0,0,,0,0,0,0,0,0,0
584,Aaron Cresswell,32,13,15,15,2,18,32,56.3,14,29,14,15,32,79,2
585,Domenico Criscito,43,22,29,11,3,22,39,56.4,17,27,14,13,44,51,0
586,Bryan Cristante,27,20,10,14,3,10,28,35.7,18,21,7,14,40,61,1
587,Giovanni Crociata,1,0,0,1,0,0,1,0.0,1,1,0,1,0,0,0
588,Juan Cruz Armada,36,22,17,16,3,19,35,54.3,16,19,5,14,15,50,0
589,Juan Cuadrado,43,25,22,15,6,29,60,48.3,31,16,2,14,43,22,2
590,Andrés Cubas,80,47,30,44,6,33,74,44.6,41,37,10,27,50,29,3
591,Sergio Cubero Ezcurra,0,0,0,0,0,0,0,,0,0,0,0,0,0,0
592,Cucho,19,10,1,14,4,2,23,8.7,21,18,1,17,6,8,0
593,Marc Cucurella,64,51,19,40,5,25,66,37.9,41,45,4,41,40,27,0
594,Mickaël Cuisance,24,11,2,15,7,10,33,30.3,23,13,1,12,3,4,0
595,Mickaël Cuisance,0,0,0,0,0,0,0,,0,1,0,1,0,0,0
596,Matheus Cunha,36,16,10,19,7,13,49,26.5,36,29,2,27,31,9,0
597,Giuseppe Cuomo,26,19,17,9,0,9,14,64.3,5,10,2,8,18,19,1
598,Patrick Cutrone,0,0,0,0,0,0,0,,0,0,0,0,0,0,0
599,Patrick Cutrone,4,3,1,2,1,1,2,50.0,1,1,0,1,1,0,0
600,Patrick Cutrone,0,0,0,0,0,0,1,0.0,1,0,0,0,1,0,0
601,Wylan Cyprien,9,4,5,3,1,2,4,50.0,2,13,8,5,5,6,1
602,Rafael Czichos,48,24,33,13,2,23,42,54.8,19,25,9,16,53,109,0
603,Lennart-Marten Czyborra,19,10,7,7,5,11,19,57.9,8,6,1,5,17,27,0
604,Danilo D'Ambrosio,15,9,6,7,2,6,15,40.0,9,9,7,2,4,15,0
605,Damien Da Silva,22,13,13,8,1,12,18,66.7,6,17,13,4,44,99,1
606,Moanes Dabbur,6,3,3,1,2,1,13,7.7,12,6,0,6,9,7,0
607,Bryan Dabo,11,8,5,3,3,5,16,31.3,11,7,1,6,13,16,0
608,Colin Dagba,23,11,4,17,2,14,19,73.7,5,18,5,13,16,18,1
609,Finn Dahmen,0,0,0,0,0,0,1,0.0,1,0,0,0,0,1,0
610,Mahmoud Dahoud,30,18,9,20,1,14,38,36.8,24,23,5,18,18,11,1
611,Leon Dajaku,0,0,0,0,0,0,0,,0,0,0,0,0,0,0
612,Stuart Dallas,74,45,46,22,6,30,88,34.1,58,41,3,38,44,52,1
613,Diogo Dalot,32,17,23,6,3,17,34,50.0,17,18,5,13,25,42,0
614,Mikkel Damsgaard,42,21,14,20,8,22,70,31.4,48,40,4,36,24,17,0
615,Flavius Daniliuc,23,15,15,5,3,10,21,47.6,11,17,6,11,14,32,0
616,Danilo,62,31,37,16,9,35,66,53.0,31,32,12,20,66,68,2
617,Scott Dann,6,4,5,1,0,4,11,36.4,7,16,14,2,18,59,1
618,Tiago Dantas,1,1,0,0,1,0,0,,0,0,0,0,0,0,0
619,Dante,10,5,6,4,0,3,7,42.9,4,6,4,2,10,20,0
620,Andrea Danzi,0,0,0,0,0,0,1,0.0,1,0,0,0,3,1,0
621,Ebrima Darboe,5,2,3,1,1,3,10,30.0,7,3,0,3,8,0,1
622,Márton Dárdai,17,10,10,6,1,9,16,56.3,7,7,3,4,16,31,0
623,Vladimír Darida,34,19,11,19,4,9,31,29.0,22,34,2,32,27,18,0
624,Karl Darlow,0,0,0,0,0,0,0,,0,0,0,0,0,17,0
625,Matteo Darmian,6,5,3,3,0,4,7,57.1,3,2,0,2,6,7,0
626,Matteo Darmian,30,16,12,7,11,16,28,57.1,12,9,2,7,17,35,0
627,Jonathan David,17,10,5,5,7,9,24,37.5,15,19,1,18,3,9,0
628,Alphonso Davies,39,27,16,17,6,28,40,70.0,12,21,1,20,28,33,1
629,Ben Davies,27,17,10,11,6,13,30,43.3,17,10,5,5,18,49,2
630,Tom Davies,31,18,17,12,2,16,39,41.0,23,15,9,6,34,21,2
631,Keinan Davis,2,1,1,0,1,0,1,0.0,1,1,0,1,0,2,0
632,Leif Davis,0,0,0,0,0,0,3,0.0,3,1,0,1,1,0,0
633,Paweł Dawidowicz,42,28,30,10,2,14,24,58.3,10,28,19,9,27,62,1
634,Craig Dawson,11,8,7,4,0,5,12,41.7,7,26,22,4,32,88,3
635,Kevin De Bruyne,34,21,6,18,10,13,48,27.1,35,26,1,25,9,10,0
636,Sebastien De Maio,15,10,6,9,0,4,5,80.0,1,16,9,7,18,41,0
637,Rodrigo De Paul,41,24,17,22,2,15,60,25.0,45,32,1,31,17,20,1
638,Mattia De Sciglio,0,0,0,0,0,0,0,,0,0,0,0,0,1,0
639,Mattia De Sciglio,29,17,15,11,3,18,27,66.7,9,13,4,9,27,44,0
640,Lorenzo De Silvestri,34,24,18,13,3,16,37,43.2,21,37,10,27,30,62,3
641,Thibault De Smet,11,6,8,3,0,6,15,40.0,9,8,1,7,6,16,0
642,Lucas Deaux,47,32,20,22,5,16,49,32.7,33,20,3,17,20,30,4
643,Mathieu Debuchy,58,33,37,17,4,40,62,64.5,22,27,9,18,45,61,0
644,Grégoire Defrel,13,8,5,5,3,5,13,38.5,8,9,0,9,7,5,0
645,Alessandro Deiola,6,3,2,3,1,5,13,38.5,8,3,1,2,3,1,0
646,Alessandro Deiola,13,5,5,4,4,8,23,34.8,15,7,2,5,11,11,0
647,Romain Del Castillo,30,11,5,14,11,5,25,20.0,20,6,0,6,3,4,1
648,Lorenzo Del Pinto,0,0,0,0,0,0,2,0.0,2,0,0,0,0,0,0
649,Thomas Delaine,32,18,19,11,2,20,35,57.1,15,22,5,17,24,30,1
650,Thomas Delaney,40,30,15,20,5,11,31,35.5,20,28,10,18,22,15,1
651,Liam Delap,0,0,0,0,0,0,0,,0,0,0,0,0,0,0
652,Jonathan Delaplace,8,5,5,1,2,7,13,53.8,6,12,5,7,17,19,1
653,Sacha Delaye,0,0,0,0,0,0,1,0.0,1,0,0,0,1,1,0
654,Cristian Dell'Orco,1,0,1,0,0,1,3,33.3,2,8,5,3,7,9,1
655,Andy Delort,12,7,1,9,2,8,18,44.4,10,11,1,10,4,34,0
656,Fabian Delph,5,2,3,2,0,1,3,33.3,2,2,0,2,4,8,1
657,Moussa Dembélé,0,0,0,0,0,0,1,0.0,1,0,0,0,1,0,0
658,Moussa Dembélé,2,2,0,1,1,0,4,0.0,4,4,2,2,5,9,0
659,Ousmane Dembélé,14,9,4,9,1,6,17,35.3,11,10,0,10,9,3,1
660,Merih Demiral,12,9,8,4,0,5,13,38.5,8,16,9,7,21,40,0
661,Kerem Demirbay,46,31,15,26,5,19,38,50.0,19,21,4,17,8,6,1
662,Ermedin Demirović,15,9,4,6,5,2,16,12.5,14,29,5,24,0,27,0
663,Diego Demme,56,32,26,22,8,23,63,36.5,40,14,1,13,11,15,1
664,Jason Denayer,25,16,16,9,0,6,13,46.2,7,36,25,11,27,91,1
665,Leander Dendoncker,54,29,29,22,3,31,60,51.7,29,38,15,23,27,52,2
666,Kévin Denkey,4,2,0,3,1,0,3,0.0,3,2,0,2,1,2,0
667,Emmanuel Dennis,13,7,6,5,2,1,6,16.7,5,6,0,6,0,0,1
668,Stefano Denswil,2,1,1,1,0,0,1,0.0,1,1,0,1,1,1,0
669,Fabio Depaoli,25,13,15,6,4,15,32,46.9,17,16,4,12,12,38,0
670,Fabio Depaoli,1,0,0,1,0,0,2,0.0,2,0,0,0,1,1,0
671,Fabio Depaoli,3,2,0,1,2,1,2,50.0,1,4,0,4,3,2,0
672,Clément Depres,0,0,0,0,0,0,0,,0,0,0,0,0,0,0
673,Mike van der Hoorn,8,4,3,5,0,1,3,33.3,2,12,8,4,27,73,0
674,Kastriot Dermaku,1,1,1,0,0,0,0,,0,2,1,1,2,8,0
675,Kiril Despodov,1,1,0,1,0,1,1,100.0,0,0,0,0,0,0,0
676,Sergiño Dest,31,16,23,6,2,18,32,56.3,14,25,4,21,10,24,1
677,Mattia Destro,6,3,0,3,3,2,9,22.2,7,11,0,11,4,8,0
678,Gerard Deulofeu,2,2,1,1,0,2,12,16.7,10,2,0,2,3,0,0
679,Deyverson,6,4,3,1,2,2,13,15.4,11,9,0,9,9,13,0
680,Jacopo Dezi,4,3,0,2,2,3,6,50.0,3,2,0,2,0,0,0
681,Samuel Di Carmine,1,2,0,1,0,0,3,0.0,3,1,0,1,0,5,0
682,Samuel Di Carmine,2,2,1,0,1,1,3,33.3,2,2,0,2,0,5,0
683,Giovanni Di Lorenzo,79,50,54,21,4,43,75,57.3,32,37,13,24,35,64,1
684,Ángel Di María,26,17,6,8,12,11,45,24.4,34,14,1,13,6,7,0
685,Alessandro Di Pardo,0,0,0,0,0,0,0,,0,1,1,0,0,0,0
686,Giuseppe Di Serio,2,2,1,1,0,0,4,0.0,4,5,0,5,0,4,0
687,Boulaye Dia,23,12,3,11,9,4,22,18.2,18,19,5,14,12,37,1
688,Abdoulay Diaby,2,0,0,2,0,0,0,,0,2,0,2,0,0,0
689,Moussa Diaby,10,6,4,5,1,6,20,30.0,14,11,0,11,12,5,0
690,Mbaye Diagne,4,3,3,0,1,1,4,25.0,3,2,1,1,1,16,0
691,Mouctar Diakhaby,16,8,10,6,0,8,12,66.7,4,28,21,7,27,102,1
692,Abdou Diallo,16,11,9,5,2,8,13,61.5,5,15,8,7,25,36,0
693,Amad Diallo,3,3,1,2,0,0,0,,0,2,1,1,0,1,0
694,Amad Diallo,0,0,0,0,0,0,0,,0,0,0,0,0,0,0
695,Habib Diallo,11,6,3,6,2,7,18,38.9,11,12,2,10,13,12,0
696,Habib Diallo,1,1,0,1,0,1,1,100.0,0,0,0,0,0,5,0
697,Ibrahima Diallo,29,16,11,17,1,9,16,56.3,7,10,1,9,10,12,2
698,Ibrahima Diallo,14,9,2,9,3,4,8,50.0,4,4,0,4,3,3,0
699,Amadou Diambo,0,0,0,0,0,0,0,,0,0,0,0,0,0,0
700,Grady Diangana,35,19,19,9,7,19,43,44.2,24,16,2,14,16,9,0
701,Stéphane Diarra,0,0,0,0,0,0,7,0.0,7,6,1,5,4,1,0
702,Rúben Dias,24,13,13,8,3,4,16,25.0,12,31,23,8,35,92,0
703,Krépin Diatta,4,3,1,1,2,1,3,33.3,2,5,1,4,4,1,0
704,Amadou Diawara,10,8,4,6,0,2,8,25.0,6,11,2,9,12,4,0
705,Brahim Díaz,18,10,7,7,4,10,23,43.5,13,10,0,10,2,2,0
706,Víctor Díaz,21,10,13,6,2,10,19,52.6,9,14,8,6,16,39,0
707,Daniel Didavi,16,6,2,9,5,7,12,58.3,5,10,0,10,3,8,0
708,Bamba Dieng,5,3,3,2,0,2,4,50.0,2,2,0,2,0,0,0
709,Eric Dier,23,14,13,10,0,11,18,61.1,7,37,31,6,23,123,3
710,Daan Dierckx,5,4,5,0,0,3,5,60.0,2,10,6,4,13,21,0
711,Lucas Digne,63,38,40,16,7,29,54,53.7,25,42,4,38,31,87,0
712,Mitchell Dijks,21,14,15,5,1,12,21,57.1,9,17,2,15,17,35,0
713,Javairô Dilrosun,5,3,2,2,1,1,6,16.7,5,5,0,5,4,3,0
714,Federico Dimarco,32,19,23,7,2,13,28,46.4,15,18,9,9,47,50,1
715,Junior Dina Ebimbe,38,25,14,19,5,15,45,33.3,30,17,1,16,14,9,0
716,Tristan Dingomé,0,0,0,0,0,0,1,0.0,1,0,0,0,0,0,0
717,Eren Dinkçi,1,1,1,0,0,0,1,0.0,1,4,0,4,2,1,0
718,Sinaly Diomande,10,7,8,1,1,5,14,35.7,9,19,15,4,33,53,1
719,Lois Diony,15,10,3,9,3,4,18,22.2,14,6,3,3,5,16,0
720,Issa Diop,20,14,12,8,0,7,18,38.9,11,32,22,10,22,59,0
721,Papakouli Diop,43,29,15,22,6,12,41,29.3,29,23,5,18,39,34,1
722,Sofiane Diop,49,34,17,25,7,18,53,34.0,35,25,1,24,31,15,0
723,Andy Diouf,0,0,0,0,0,0,0,,0,0,0,0,0,0,0
724,Yehvann Diouf,0,0,0,0,0,0,0,,0,0,0,0,0,0,0
725,Assane Dioussé,0,0,0,0,0,0,0,,0,0,0,0,0,0,0
726,Jonas Dirkner,0,0,0,0,0,0,0,,0,0,0,0,0,0,0
727,Axel Disasi,29,20,17,12,0,20,35,57.1,15,18,11,7,26,66,1
728,Tiago Djaló,22,13,14,5,3,15,23,65.2,8,10,4,6,9,23,0
729,Djené,61,39,31,26,4,26,34,76.5,8,24,11,13,42,96,0
730,Moussa Djenepo,52,27,27,17,8,28,63,44.4,35,24,2,22,10,14,0
731,Koffi Djidji,39,28,30,8,1,10,20,50.0,10,35,20,15,28,73,0
732,Alexander Djiku,60,41,45,13,2,32,52,61.5,20,28,10,18,91,104,0
733,Berat Djimsiti,41,29,27,12,2,17,34,50.0,17,34,20,14,62,89,1
734,Marko Dmitrović,4,3,4,0,0,2,4,50.0,2,0,0,0,0,16,2
735,Ritsu Doan,53,31,22,19,12,19,52,36.5,33,42,1,41,31,11,0
736,Mihai Dobre,12,5,6,2,4,7,14,50.0,7,5,0,5,10,3,0
737,Matt Doherty,29,15,15,10,4,13,33,39.4,20,20,5,15,23,46,0
738,Jeremy Doku,44,25,9,24,11,11,26,42.3,15,18,1,17,11,1,0
739,Kasper Dolberg,6,2,1,3,2,2,11,18.2,9,11,2,9,6,19,1
740,Keagan Dolly,7,2,6,0,1,4,8,50.0,4,3,0,3,5,2,0
741,Jaume Doménech,1,1,1,0,0,1,2,50.0,1,1,0,1,0,16,2
742,Carlos Dominguez,5,4,4,1,0,3,6,50.0,3,5,3,2,6,24,0
743,Nicolás Domínguez,48,28,26,17,5,15,37,40.5,22,26,7,19,24,20,0
744,John Donald,0,0,0,0,0,0,0,,0,0,0,0,0,1,0
745,Ji Dong-won,1,1,1,0,0,0,0,,0,1,0,1,2,0,0
746,Anastasios Donis,4,1,2,0,2,1,1,100.0,0,0,0,0,0,0,0
747,Gianluigi Donnarumma,0,0,0,0,0,0,1,0.0,1,1,0,1,1,23,2
748,Bas Dost,3,2,1,1,1,2,5,40.0,3,5,1,4,2,8,0
749,Abdoulaye Doucouré,52,32,25,19,8,14,43,32.6,29,24,7,17,39,31,1
750,Cheick Doucouré,87,47,40,42,5,32,65,49.2,33,20,4,16,52,26,1
751,Fodé Doucouré,11,8,7,4,0,4,9,44.4,5,2,0,2,4,11,0
752,Mahamadou Doucouré,1,1,1,0,0,1,1,100.0,0,0,0,0,0,0,0
753,Cheick Doukouré,5,4,2,1,2,3,4,75.0,1,2,0,2,3,0,0
754,Idrissa Doumbia,15,8,6,7,2,5,13,38.5,8,6,3,3,7,9,0
755,Moussa Doumbia,10,6,4,4,2,4,22,18.2,18,5,1,4,10,4,0
756,Souleyman Doumbia,48,33,25,19,4,22,36,61.1,14,18,4,14,42,50,0
757,Aleksandar Dragović,11,7,5,5,1,9,13,69.2,4,17,5,12,13,33,0
758,Bartłomiej Drągowski,1,0,1,0,0,1,1,100.0,0,0,0,0,1,13,1
759,Denis Drăguș,3,1,0,0,3,0,4,0.0,4,4,0,4,1,0,0
760,Radu Drăgușin,0,0,0,0,0,0,0,,0,0,0,0,0,0,0
761,Mouhamadou Drammeh,0,0,0,0,0,0,2,0.0,2,0,0,0,2,7,0
762,Julian Draxler,13,6,5,6,2,5,20,25.0,15,4,0,4,14,0,0
763,Dominick Drexler,36,26,15,18,3,12,30,40.0,18,5,1,4,14,15,0
764,Matthieu Dreyer,0,0,0,0,0,0,0,,0,0,0,0,0,4,2
765,Domingos Duarte,32,20,18,12,2,14,21,66.7,7,29,20,9,29,86,0
766,Léo Duarte,1,1,0,1,0,0,0,,0,0,0,0,1,0,0
767,Óscar Duarte,22,13,17,5,0,10,18,55.6,8,23,15,8,36,97,1
768,Rubén Duarte,55,30,28,21,6,23,52,44.2,29,44,6,38,66,72,0
769,Leo Dubois,38,26,19,16,3,18,36,50.0,18,27,9,18,31,69,2
770,Martin Dúbravka,0,0,0,0,0,0,0,,0,0,0,0,0,3,0
771,Ondrej Duda,36,14,13,18,5,8,39,20.5,31,28,2,26,19,20,0
772,Unai Dufur,2,2,2,0,0,2,4,50.0,2,0,0,0,1,0,0
773,Haris Duljević,15,9,4,7,4,6,22,27.3,16,3,0,3,8,1,0
774,Paul Dummett,16,7,11,5,0,13,21,61.9,8,12,7,5,16,74,0
775,Alfred Duncan,3,0,1,1,1,0,2,0.0,2,2,0,2,2,0,0
776,Alfred Duncan,18,10,8,9,1,4,21,19.0,17,8,0,8,16,8,1
777,Lewis Dunk,30,15,20,8,2,16,23,69.6,7,29,20,9,32,106,0
778,Jimmy Dunne,3,3,2,1,0,1,2,50.0,1,3,2,1,6,16,1
779,Erik Durm,17,13,7,9,1,8,21,38.1,13,19,5,14,29,26,0
780,Hugo Duro,0,0,0,0,0,0,0,,0,1,0,1,0,0,0
781,Jean-Kevin Duverne,38,21,24,14,0,15,32,46.9,17,24,16,8,30,70,0
782,Paulo Dybala,14,8,3,4,7,2,14,14.3,12,15,0,15,1,1,0
783,Edin Džeko,8,6,2,3,3,3,9,33.3,6,9,4,5,1,11,0
784,Steeve-Mike Ebongue,2,1,1,0,1,0,3,0.0,3,1,0,1,0,0,0
785,Enzo Ebosse,5,3,5,0,0,3,4,75.0,1,1,1,0,2,13,0
786,Bruno Ecuele Manga,52,38,46,6,0,29,40,72.5,11,50,33,17,57,165,3
787,Simone Edera,3,1,2,1,0,3,4,75.0,1,0,0,0,1,1,0
788,Ederson,3,1,3,0,0,3,4,75.0,1,0,0,0,0,11,4
789,Kyle Edwards,3,2,1,1,1,0,0,,0,2,0,2,1,0,0
790,John Egan,41,21,29,12,0,22,39,56.4,17,43,31,12,41,131,0
791,Johannes Eggestein,0,0,0,0,0,0,1,0.0,1,0,0,0,1,2,0
792,Maximilian Eggestein,57,42,22,29,6,21,46,45.7,25,30,5,25,43,36,0
793,Lilian Egloff,0,0,0,0,0,0,0,,0,0,0,0,0,0,0
794,Kingsley Ehizibue,32,19,22,9,1,10,17,58.8,7,19,5,14,18,42,0
795,Albin Ekdal,56,29,21,32,3,23,65,35.4,42,31,12,19,49,35,0
796,Hugo Ekitike,1,1,0,0,1,0,1,0.0,1,0,0,0,0,0,0
797,Anthony Elanga,4,2,3,1,0,4,5,80.0,1,1,1,0,1,1,0
798,Niclas Eliasson,28,14,9,12,7,11,24,45.8,13,20,1,19,23,16,0
799,Elif Elmas,15,4,3,6,6,7,12,58.3,5,11,1,10,2,10,0
800,Ahmed Elmohamady,17,13,12,4,1,9,14,64.3,5,6,3,3,17,26,0
801,Mohamed Elneny,14,6,7,7,0,7,28,25.0,21,11,4,7,24,20,2
802,Aritz Elustondo,30,16,21,7,2,18,22,81.8,4,12,5,7,15,63,0
803,Nico Elvedi,49,35,36,12,1,25,37,67.6,12,38,22,16,65,123,0
804,Rodrigo Ely,5,2,3,2,0,3,4,75.0,1,2,1,1,7,23,1
805,Breel Embolo,15,10,1,13,1,0,6,0.0,6,16,1,15,8,8,0
806,Emerson,91,52,62,25,4,43,78,55.1,35,33,6,27,61,102,2
807,Renaud Emond,0,0,0,0,0,0,1,0.0,1,2,0,2,0,1,0
808,Alan Empereur,0,0,0,0,0,0,0,,0,1,1,0,6,7,1
809,Youssef En-Nesyri,17,11,2,9,6,4,21,19.0,17,15,0,15,8,23,0
810,Keita Endo,8,3,1,5,2,3,9,33.3,6,5,2,3,6,4,0
811,Wataru Endo,65,44,25,34,6,29,71,40.8,42,53,14,39,51,59,0
812,Sergi Enrich,21,15,6,7,8,9,22,40.9,13,11,0,11,6,5,0
813,Christian Eriksen,12,6,6,4,2,7,20,35.0,13,16,1,15,9,13,1
814,Martin Erlic,23,14,16,6,1,11,20,55.0,9,22,16,6,41,71,2
815,Patrick Erras,0,0,0,0,0,0,1,0.0,1,0,0,0,0,0,0
816,Gonzalo Escalante,26,13,11,14,1,8,28,28.6,20,10,3,7,19,13,0
817,Aarón Escandell,1,1,1,0,0,1,1,100.0,0,0,0,0,0,6,0
818,Dani Escriche,9,7,5,2,2,3,10,30.0,7,11,0,11,8,5,0
819,Sergio Escudero,12,8,6,5,1,6,12,50.0,6,5,2,3,9,7,0
820,Alfonso Espino,92,48,63,28,1,43,85,50.6,42,30,5,25,41,74,0
821,Vicente Esquerdo,7,4,5,2,0,4,6,66.7,2,4,2,2,8,1,0
822,Nahuel Estévez,13,5,4,6,3,5,32,15.6,27,23,5,18,20,22,1
823,Pervis Estupiñán,37,17,23,12,2,14,23,60.9,9,10,2,8,35,14,2
824,Yoann Etienne,2,0,1,1,0,1,1,100.0,0,1,0,1,1,2,0
825,Xabier Etxeita,8,4,5,3,0,7,14,50.0,7,6,3,3,13,38,0
826,Jonny Evans,25,12,22,2,1,14,20,70.0,6,8,3,5,46,98,1
827,Edu Expósito,51,30,16,31,4,20,66,30.3,46,25,4,21,22,17,0
828,Valentin Eysseric,14,8,6,7,1,5,11,45.5,6,11,0,11,7,8,0
829,Eberechi Eze,27,14,11,13,3,16,35,45.7,19,19,3,16,24,9,1
830,Jokin Ezkieta,0,0,0,0,0,0,0,,0,0,0,0,0,0,0
831,Łukasz Fabiański,1,0,1,0,0,1,1,100.0,0,1,0,1,1,12,3
832,Fabinho,58,31,21,29,8,27,54,50.0,27,28,10,18,44,66,1
833,Fábio,62,37,37,23,2,35,61,57.4,26,29,8,21,37,49,0
834,Cesc Fàbregas,20,12,6,9,5,9,22,40.9,13,11,1,10,13,3,0
835,Bandiougou Fadiga,1,0,1,0,0,0,0,,0,0,0,0,0,0,0
836,Bandiougou Fadiga,0,0,0,0,0,0,2,0.0,2,0,0,0,0,0,0
837,Wout Faes,35,22,26,9,0,20,39,51.3,19,40,31,9,68,144,1
838,Nicolò Fagioli,0,0,0,0,0,0,0,,0,0,0,0,0,1,0
839,Ralf Fährmann,2,1,2,0,0,1,2,50.0,1,0,0,0,1,9,3
840,Romain Faivre,54,27,26,23,5,21,54,38.9,33,30,0,30,30,18,0
841,Fali,42,25,24,15,3,16,37,43.2,21,28,15,13,32,119,0
842,Iago Falque,4,2,2,2,0,1,6,16.7,5,4,1,3,0,1,0
843,Andri Fannar Baldursson,6,6,1,2,3,1,3,33.3,2,3,1,2,3,7,0
844,Paolo Faragò,1,1,1,0,0,1,2,50.0,1,1,0,1,0,0,0
845,Paolo Faragò,13,9,10,3,0,9,20,45.0,11,3,2,1,6,15,0
846,Davide Faraoni,62,33,36,19,7,28,51,54.9,23,48,17,31,49,83,1
847,Mohamed Fares,20,15,9,7,4,11,19,57.9,8,14,1,13,16,21,0
848,Diego Farias,9,5,4,1,4,4,21,19.0,17,12,0,12,13,3,0
849,Wuilker Faríñez,0,0,0,0,0,0,0,,0,0,0,0,0,1,0
850,Noah Fatar,1,0,0,0,1,0,0,,0,0,0,0,0,0,0
851,Ansu Fati,9,4,2,4,3,2,10,20.0,8,4,0,4,3,1,0
852,Julien Faussurier,16,11,6,8,2,11,25,44.0,14,12,4,8,9,10,0
853,Andrea Favilli,3,1,0,1,2,2,3,66.7,1,2,0,2,0,2,0
854,Federico Fazio,3,2,3,0,0,3,4,75.0,1,3,3,0,7,18,1
855,Nabil Fekir,45,23,9,22,14,7,43,16.3,36,31,2,29,8,2,0
856,Felipe,29,17,19,10,0,18,23,78.3,5,30,15,15,36,128,2
857,Luiz Felipe,32,20,19,11,2,16,24,66.7,8,20,9,11,21,29,1
858,João Félix,8,4,1,6,1,4,17,23.5,13,3,0,3,5,2,0
859,Ohis Felix Uduokhai,33,24,19,10,4,18,27,66.7,9,48,25,23,54,164,2
860,Zinedine Ferhat,36,21,18,9,9,18,39,46.2,21,22,0,22,32,38,0
861,Bruno Fernandes,57,30,16,29,12,26,100,26.0,74,38,0,38,26,29,0
862,Edimilson Fernandes,8,4,4,4,0,4,7,57.1,3,12,4,8,29,25,0
863,Aitor Fernández,0,0,0,0,0,0,0,,0,0,0,0,2,17,1
864,Álex Fernández,19,9,8,8,3,8,30,26.7,22,14,1,13,22,15,0
865,Álvaro Fernández,1,1,0,1,0,1,3,33.3,2,0,0,0,2,7,0
866,Andrés Fernández,0,0,0,0,0,0,0,,0,0,0,0,0,3,2
867,Augusto Fernández,11,3,5,6,0,2,13,15.4,11,5,1,4,9,5,0
868,Carlos Fernández,1,0,1,0,0,0,2,0.0,2,3,1,2,1,0,0
869,Carlos Fernández,3,2,0,2,1,1,8,12.5,7,6,1,5,0,6,0
870,Federico Fernández,29,22,23,5,1,17,21,81.0,4,41,31,10,17,147,0
871,Joaquín Fernández,30,16,21,8,1,12,21,57.1,9,24,15,9,43,113,0
872,Fernandinho,31,17,8,14,9,20,43,46.5,23,11,2,9,23,17,0
873,Fernando,54,28,24,25,5,23,43,53.5,20,25,11,14,41,70,0
874,Alex Ferrari,27,15,16,9,2,15,24,62.5,9,18,6,12,23,26,0
875,David Ferreiro,25,12,12,8,5,8,49,16.3,41,21,1,20,25,15,0
876,Salvador Ferrer,20,10,10,8,2,8,22,36.4,14,13,4,9,24,37,1
877,Facundo Ferreyra,4,3,1,2,1,0,2,0.0,2,5,0,5,2,2,0
878,Jordan Ferri,58,40,34,22,2,31,103,30.1,72,30,5,25,8,18,1
879,Marco Festa,0,0,0,0,0,0,0,,0,0,0,0,0,0,0
880,Fidel,46,30,28,15,3,25,64,39.1,39,22,2,20,16,14,0
881,Sam Field,5,5,3,2,0,0,0,,0,4,1,3,2,4,0
882,Alfreð Finnbogason,2,1,0,1,1,0,1,0.0,1,7,1,6,1,4,0
883,Roberto Firmino,33,15,3,17,13,6,32,18.8,26,42,5,37,11,12,0
884,Junior Firpo,1,1,1,0,0,0,1,0.0,1,5,3,2,4,7,0
885,John Fleck,51,33,28,18,5,26,83,31.3,57,26,4,22,28,12,1
886,Mark Flekken,0,0,0,0,0,0,0,,0,0,0,0,0,1,0
887,Florian Flick,10,7,4,6,0,7,16,43.8,9,4,3,1,7,5,1
888,Alexis Flips,0,0,0,0,0,0,2,0.0,2,0,0,0,0,1,0
889,Alessandro Florenzi,24,16,9,9,6,12,29,41.4,17,7,1,6,17,25,0
890,Kingsley Fobi,0,0,0,0,0,0,0,,0,0,0,0,1,1,0
891,Phil Foden,22,11,12,8,2,9,23,39.1,14,9,0,9,11,11,0
892,Mamadou Fofana,25,11,17,8,0,7,31,22.6,24,14,2,12,18,36,0
893,Seko Fofana,16,8,3,10,3,4,26,15.4,22,16,5,11,34,23,1
894,Wesley Fofana,51,37,27,22,2,31,46,67.4,15,28,16,12,61,94,0
895,Wesley Fofana,6,4,6,0,0,3,4,75.0,1,3,3,0,8,14,1
896,Youssouf Fofana,90,51,31,51,8,42,82,51.2,40,43,7,36,34,14,2
897,Thomas Foket,77,43,50,20,7,40,69,58.0,29,28,7,21,69,92,2
898,Ramón Folch,0,0,0,0,0,0,0,,0,0,0,0,0,0,0
899,Lamine Fomba,66,36,30,25,11,30,65,46.2,35,48,19,29,59,39,2
900,Thomas Fontaine,5,2,5,0,0,2,2,100.0,0,3,2,1,5,14,0
901,José Fontán,12,9,8,4,0,5,11,45.5,6,4,3,1,13,27,0
902,José Fonte,40,29,28,10,2,27,33,81.8,6,36,23,13,36,137,1
903,Fernando Forestieri,9,7,4,4,1,3,7,42.9,4,7,0,7,2,0,0
904,Pablo Fornals,44,26,14,24,6,11,73,15.1,62,43,1,42,36,9,0
905,Emil Forsberg,11,6,1,6,4,5,27,18.5,22,10,1,9,11,4,0
906,Fraser Forster,1,0,1,0,0,1,2,50.0,1,0,0,0,0,9,0
907,Philipp Förster,22,13,7,12,3,6,25,24.0,19,18,1,17,15,2,0
908,Steven Fortes,33,20,20,10,3,16,22,72.7,6,25,10,15,27,52,0
909,Yassin Fortune,0,0,0,0,0,0,0,,0,0,0,0,0,0,0
910,Timothy Fosu-Mensah,2,0,1,1,0,1,1,100.0,0,0,0,0,3,1,0
911,Timothy Fosu-Mensah,4,2,1,2,1,2,4,50.0,2,7,3,4,7,4,0
912,Daam Foulon,26,15,21,5,0,16,28,57.1,12,12,3,9,14,34,0
913,Dimitri Foulquier,35,21,20,12,3,15,26,57.7,11,24,7,17,26,60,0
914,Juan Foyth,40,22,22,14,4,12,29,41.4,17,21,6,15,19,24,1
915,Gianluca Frabotta,7,4,5,0,2,5,12,41.7,7,9,1,8,14,15,0
916,Raphael Framberger,42,23,26,11,5,19,25,76.0,6,24,2,22,36,62,1
917,Tyrese Francois,0,0,0,0,0,0,0,,0,0,0,0,0,0,0
918,Ryan Fraser,4,1,3,1,0,2,5,40.0,3,1,0,1,6,7,0
919,Fred,81,39,39,38,4,29,89,32.6,60,49,9,40,45,26,1
920,Ryan Fredericks,9,5,5,4,0,3,7,42.9,4,6,2,4,11,20,0
921,Remo Freuler,63,39,17,38,8,32,76,42.1,44,52,4,48,39,27,2
922,Marco Friedl,50,34,31,17,2,30,62,48.4,32,38,17,21,55,118,1
923,Marvin Friedrich,47,29,35,11,1,18,32,56.3,14,38,18,20,52,109,0
924,Jeremie Frimpong,7,4,4,3,0,4,8,50.0,4,4,0,4,1,7,0
925,Jorge de Frutos,48,24,21,21,6,11,41,26.8,30,25,2,23,16,18,0
926,Christian Fuchs,18,7,15,2,1,8,15,53.3,7,6,4,2,16,34,1
927,Angelo Fulgini,22,13,4,12,6,12,34,35.3,22,17,0,17,15,9,0
928,Niclas Füllkrug,7,3,2,4,1,1,13,7.7,12,10,4,6,3,13,0
929,Ramiro Funes Mori,12,8,7,5,0,7,11,63.6,4,7,5,2,8,42,1
930,Darnell Furlong,45,27,27,12,6,21,44,47.7,23,39,16,23,49,90,0
931,Daniel Fuzato,0,0,0,0,0,0,0,,0,1,0,1,0,1,1
932,Baptiste Gabard,4,3,1,3,0,1,5,20.0,4,4,0,4,1,0,0
933,Matteo Gabbia,9,5,3,6,0,2,2,100.0,0,8,6,2,3,21,0
934,Manolo Gabbiadini,2,2,0,2,0,0,1,0.0,1,3,1,2,3,5,0
935,Mijat Gaćinović,18,10,6,11,1,9,24,37.5,15,13,0,13,18,15,0
936,Roberto Gagliardini,30,17,17,8,5,5,28,17.9,23,15,3,12,19,16,0
937,Riccardo Gagliolo,45,18,35,8,2,28,45,62.2,17,34,7,27,36,64,1
938,Adolfo Gaich,9,4,1,7,1,1,13,7.7,12,4,0,4,2,4,0
939,Andrey Galabinov,2,1,1,1,0,1,3,33.3,2,2,0,2,0,5,0
940,Javi Galán,88,54,47,35,6,46,72,63.9,26,30,4,26,39,61,0
941,Conor Gallagher,81,41,30,39,12,29,97,29.9,68,47,8,39,27,31,0
942,Enric Gallego,6,3,2,2,2,2,14,14.3,12,5,1,4,1,9,0
943,Kévin Gameiro,7,4,3,2,2,3,11,27.3,8,10,0,10,0,3,0
944,Idrissa Gana Gueye,63,35,20,34,9,26,50,52.0,24,26,7,19,20,9,3
945,Ignatius Ganago,4,3,0,2,2,3,12,25.0,9,7,1,6,6,3,0
946,Aleix García,5,4,2,2,1,1,10,10.0,9,5,0,5,8,2,0
947,Borja García,13,7,4,6,3,6,12,50.0,6,12,0,12,10,4,1
948,Dani García,39,19,10,23,6,15,46,32.6,31,20,7,13,33,34,0
949,David García,26,17,13,13,0,13,24,54.2,11,36,19,17,59,171,0
950,Eric García,8,7,5,3,0,5,7,71.4,2,4,1,3,4,10,0
951,Manu García,24,13,10,13,1,8,35,22.9,27,16,1,15,12,21,0
952,Raúl García,10,8,5,5,0,6,20,30.0,14,5,1,4,9,10,0
953,Raúl García,34,19,9,19,6,7,22,31.8,15,30,1,29,15,20,0
954,Rubén García,50,29,21,22,7,14,45,31.1,31,28,2,26,29,20,0
955,Sergi García,1,1,0,1,0,0,1,0.0,1,0,0,0,0,0,0
956,Unai García,19,9,14,4,1,9,15,60.0,6,16,8,8,14,40,0
957,Mario Gaspar,55,34,22,24,9,21,40,52.5,19,26,4,22,30,47,1
958,Manuel Gasparini,0,0,0,0,0,0,0,,0,0,0,0,0,0,0
959,Dwight Gayle,2,0,1,1,0,0,7,0.0,7,3,1,2,1,2,0
960,Paulo Gazzaniga,1,1,1,0,0,0,0,,0,0,0,0,1,4,0
961,Jean-Philippe Gbamin,1,0,0,1,0,0,0,,0,1,0,1,0,1,0
962,Yann Gboho,6,3,3,1,2,3,8,37.5,5,1,0,1,1,3,1
963,David de Gea,0,0,0,0,0,0,0,,0,0,0,0,0,8,3
964,Christian Gebauer,9,4,2,5,2,4,11,36.4,7,4,1,3,6,14,0
965,Theodor Gebre Selassie,61,35,39,17,5,28,64,43.8,36,33,11,22,58,98,1
966,Emrehan Gedikli,0,0,0,0,0,0,0,,0,0,0,0,0,0,0
967,Dennis Geiger,13,10,3,8,2,5,8,62.5,3,10,0,10,3,0,0
968,Christian Gentner,17,8,9,5,3,5,18,27.8,13,13,1,12,17,16,0
969,Yannick Gerhardt,52,32,14,32,6,21,52,40.4,31,34,4,30,21,30,0
970,Valère Germain,8,6,2,4,2,3,11,27.3,8,7,2,5,11,22,0
971,Gervinho,5,1,2,2,1,1,14,7.1,13,11,1,10,10,3,0
972,Willem Geubbels,12,8,5,7,0,5,13,38.5,8,9,0,9,3,5,0
973,Hamadi Al Ghaddioui,0,0,0,0,0,0,1,0.0,1,0,0,0,0,0,0
974,Anwar El Ghazi,16,13,6,7,3,7,23,30.4,16,11,0,11,6,11,0
975,Paolo Ghiglione,27,15,17,8,2,13,28,46.4,15,14,2,12,13,25,0
976,Faouzi Ghoulam,6,5,3,2,1,0,1,0.0,1,4,2,2,3,1,0
977,Kieran Gibbs,15,11,11,3,1,8,10,80.0,2,8,6,2,16,30,1
978,Morgan Gibbs-White,9,7,3,4,2,5,12,41.7,7,6,0,6,3,1,0
979,Niko Gießelmann,12,9,7,4,1,5,8,62.5,3,9,3,6,8,13,1
980,Rafał Gikiewicz,0,0,0,0,0,0,3,0.0,3,0,0,0,3,9,1
981,Bryan Gil,1,1,0,1,0,0,0,,0,0,0,0,0,0,0
982,Bryan Gil,28,18,12,11,5,6,23,26.1,17,20,0,20,17,6,0
983,David Gil,0,0,0,0,0,0,1,0.0,1,0,0,0,0,2,0
984,Billy Gilmour,4,2,1,2,1,2,7,28.6,5,3,2,1,3,1,0
985,Álvaro Giménez,4,2,2,2,0,0,3,0.0,3,2,0,2,2,3,0
986,Daniel Ginczek,2,2,1,1,0,2,8,25.0,6,2,0,2,1,2,0
987,Matthias Ginter,26,16,15,10,1,14,24,58.3,10,43,32,11,51,121,0
988,Andrei Girotto,65,41,50,15,0,39,70,55.7,31,34,15,19,59,103,0
989,Olivier Giroud,4,2,0,1,3,1,7,14.3,6,4,1,3,5,10,0
990,Robert Glatzel,1,0,1,0,0,0,2,0.0,2,2,0,2,0,2,0
991,Kamil Glik,44,24,33,10,1,25,53,47.2,28,37,31,6,62,153,0
992,Serge Gnabry,39,19,7,19,13,12,32,37.5,20,17,0,17,26,3,0
993,Ben Godfrey,55,33,37,15,3,27,41,65.9,14,56,37,19,33,120,0
994,Diego Godín,60,32,51,9,0,24,39,61.5,15,41,24,17,56,117,0
995,Akaki Gogia,1,0,0,1,0,0,2,0.0,2,0,0,0,1,0,0
996,Amer Gojak,1,0,1,0,0,1,7,14.3,6,5,0,5,3,1,0
997,Edoardo Goldaniga,28,18,21,7,0,14,23,60.9,9,17,7,10,38,62,1
998,Vladimir Golemić,33,16,17,13,3,14,19,73.7,5,38,26,12,40,97,2
999,Pierluigi Gollini,1,0,1,0,0,1,2,50.0,1,1,0,1,1,11,0
1000,Aleksandr Golovin,28,16,6,18,4,8,39,20.5,31,21,0,21,11,3,0
1001,Tomislav Gomelt,1,1,0,1,0,0,0,,0,0,0,0,1,0,0
1002,André Gomes,35,23,16,16,3,17,58,29.3,41,19,1,18,10,12,1
1003,Dani Gómez,4,3,2,1,1,0,11,0.0,11,3,0,3,2,4,0
1004,Ibai Gómez,6,4,2,3,1,4,7,57.1,3,3,0,3,2,4,0
1005,Joe Gomez,3,2,1,1,1,0,4,0.0,4,3,2,1,4,29,0
1006,Maxi Gómez,11,9,3,7,1,3,14,21.4,11,13,3,10,2,34,0
1007,Moi Gómez,21,12,6,8,7,14,35,40.0,21,20,3,17,11,16,0
1008,Papu Gómez,3,2,2,1,0,2,8,25.0,6,8,1,7,1,1,0
1009,Papu Gómez,9,6,2,4,3,2,12,16.7,10,13,2,11,7,6,0
1010,Sergi Gómez,4,3,2,2,0,1,1,100.0,0,5,4,1,6,34,0
1011,Sergio Gómez,29,10,17,9,3,11,22,50.0,11,15,0,15,14,9,0
1012,Alfred Gomis,1,0,1,0,0,1,2,50.0,1,0,0,0,1,7,0
1013,Alfred Gomis,1,1,1,0,0,1,1,100.0,0,0,0,0,3,10,1
1014,Maxime Gonalons,53,37,18,33,2,15,37,40.5,22,17,0,17,25,21,1
1015,Vagner Gonçalves,16,9,5,5,6,2,15,13.3,13,6,0,6,4,1,1
1016,Álvaro González,26,17,20,6,0,19,31,61.3,12,30,18,12,33,119,1
1017,Bruno González,26,17,18,8,0,17,31,54.8,14,22,14,8,37,112,1
1018,Diego González,11,7,7,3,1,5,11,45.5,6,16,9,7,20,49,1
1019,Nicolás González,5,5,1,2,2,0,6,0.0,6,10,3,7,4,6,0
1020,Sergio González,1,0,0,1,0,1,2,50.0,1,0,0,0,2,0,0
1021,Urko González,0,0,0,0,0,0,1,0.0,1,1,1,0,0,1,0
1022,Anthony Gordon,3,3,3,0,0,0,2,0.0,2,1,0,1,1,3,0
1023,Leon Goretzka,37,23,12,21,4,16,39,41.0,23,30,2,28,44,11,0
1024,Andoni Gorosabel,76,43,45,20,11,27,64,42.2,37,25,4,21,23,42,0
1025,Robin Gosens,46,35,20,15,11,17,41,41.5,24,50,7,43,41,34,0
1026,Amine Gouiri,31,18,7,16,8,10,41,24.4,31,22,6,16,17,23,0
1027,Lucas Gourna-Douath,32,22,18,11,3,15,28,53.6,13,10,0,10,24,18,0
1028,Jeffrey Gouweleeuw,36,20,24,11,1,16,33,48.5,17,37,18,19,69,149,2
1029,Jonathan Gradit,60,39,26,28,6,22,38,57.9,16,37,19,18,56,81,1
1030,Karlan Grant,5,3,3,2,0,2,4,50.0,2,7,0,7,5,17,0
1031,Alberto Grassi,30,11,14,13,3,8,29,27.6,21,22,9,13,26,32,0
1032,Andrew Gravillon,26,17,17,9,0,13,28,46.4,15,44,31,13,59,118,4
1033,Demarai Gray,1,1,1,0,0,0,0,,0,0,0,0,0,0,0
1034,Demarai Gray,3,2,1,2,0,1,1,100.0,0,3,0,3,4,3,0
1035,Adrian Grbić,6,4,2,2,2,1,7,14.3,6,6,0,6,5,7,0
1036,Jack Grealish,31,14,8,16,7,15,24,62.5,9,20,3,17,12,5,3
1037,Etienne Green,0,0,0,0,0,0,0,,0,0,0,0,0,3,0
1038,Mason Greenwood,13,10,6,4,3,5,22,22.7,17,9,0,9,5,1,0
1039,Michael Gregoritsch,13,10,6,7,0,3,10,30.0,7,2,0,2,3,17,0
1040,Clément Grenier,20,8,9,8,3,7,31,22.6,24,7,0,7,5,3,0
1041,Sebastian Griesbeck,20,9,8,11,1,8,19,42.1,11,13,3,10,5,8,0
1042,Antoine Griezmann,37,22,10,18,9,12,40,30.0,28,20,1,19,12,11,0
1043,Vincenzo Grifo,18,7,6,7,5,14,34,41.2,20,13,0,13,27,18,1
1044,Lennart Grill,0,0,0,0,0,0,0,,0,0,0,0,0,2,0
1045,Florian Grillitsch,37,21,21,13,3,19,52,36.5,33,38,7,31,51,47,1
1046,Christian Groß,44,28,17,25,2,15,37,40.5,22,12,2,10,24,37,0
1047,Pascal Groß,45,24,24,15,6,24,53,45.3,29,25,4,21,23,18,1
1048,Kamil Grosicki,2,1,2,0,0,2,8,25.0,6,1,0,1,2,1,0
1049,Ilia Gruev,0,0,0,0,0,0,0,,0,0,0,0,0,0,0
1050,Carlos Gruezo,57,32,20,32,5,20,52,38.5,32,32,5,27,35,29,1
1051,Vicente Guaita,1,1,1,0,0,1,1,100.0,0,0,0,0,1,11,1
1052,Andrés Guardado,25,12,10,11,4,10,25,40.0,15,13,3,10,18,19,0
1053,Sergi Guardiola,11,5,1,5,5,2,27,7.4,25,12,1,11,7,16,3
1054,Nemanja Gudelj,23,12,16,5,2,4,10,40.0,6,10,6,4,24,24,2
1055,Gonçalo Guedes,18,12,8,7,3,10,45,22.2,35,24,1,23,8,7,0
1056,Mattéo Guendouzi,24,13,10,12,2,9,25,36.0,16,15,4,11,21,24,1
1057,Raphaël Guerreiro,30,13,14,8,8,16,31,51.6,15,21,4,17,28,31,1
1058,Evann Guessand,0,0,0,0,0,0,1,0.0,1,1,1,0,1,1,0
1059,Kelyan Guessoum,13,7,11,1,1,11,16,68.8,5,8,6,2,24,51,0
1060,Ander Guevara,35,23,15,16,4,15,30,50.0,15,19,5,14,25,35,1
1061,Lamine Gueye,18,9,4,11,3,7,24,29.2,17,7,2,5,21,5,0
1062,Pape Gueye,49,21,25,19,5,15,45,33.3,30,25,6,19,47,34,0
1063,John Guidetti,2,2,0,2,0,0,2,0.0,2,0,0,0,1,2,0
1064,Josuha Guilavogui,17,9,9,8,0,5,12,41.7,7,12,5,7,29,25,0
1065,Frederic Guilbert,37,19,23,11,3,21,34,61.8,13,14,1,13,33,32,0
1066,Hugo Guillamón,23,13,17,6,0,8,20,40.0,12,19,14,5,27,102,3
1067,Bruno Guimarães,76,34,26,41,9,30,64,46.9,34,24,4,20,14,13,0
1068,Serhou Guirassy,4,1,1,3,0,1,3,33.3,2,10,1,9,5,17,0
1069,Péter Gulácsi,1,0,1,0,0,1,2,50.0,1,0,0,0,2,7,0
1070,Manuel Gulde,27,15,12,12,3,5,21,23.8,16,25,15,10,37,64,0
1071,Robert Gumny,24,15,12,9,3,15,23,65.2,8,12,2,10,18,31,0
1072,İlkay Gündoğan,25,15,8,12,5,10,39,25.6,29,13,4,9,20,9,0
1073,Christian Günter,34,19,18,13,3,15,43,34.9,28,38,9,29,29,40,0
1074,Koray Günter,20,10,10,9,1,4,9,44.4,5,27,21,6,70,87,0
1075,Jon Guridi,19,9,10,6,3,8,22,36.4,14,8,1,7,10,9,0
1076,Malo Gusto,0,0,0,0,0,0,0,,0,0,0,0,0,0,0
1077,Raúl Guti,48,28,21,22,5,16,52,30.8,36,25,3,22,49,25,0
1078,Marcos Mauro López Gutiérrez,23,15,15,8,0,15,24,62.5,9,18,12,6,22,78,0
1079,Miguel Gutiérrez,4,0,0,3,1,1,7,14.3,6,3,0,3,5,5,0
1080,Manu Gyabuaa,0,0,0,0,0,0,0,,0,0,0,0,0,0,0
1081,Emmanuel Gyasi,30,16,16,10,4,9,31,29.0,22,13,2,11,14,8,0
1082,Erling Haaland,7,2,1,3,3,1,4,25.0,3,19,4,15,4,16,0
1083,Janik Haberer,7,4,4,3,0,3,15,20.0,12,4,1,3,7,9,0
1084,Alexander Hack,32,21,23,8,1,18,31,58.1,13,26,17,9,41,91,2
1085,Antwoine Hackford,0,0,0,0,0,0,0,,0,0,0,0,0,0,0
1086,Munir El Haddadi,12,8,5,5,2,2,12,16.7,10,6,0,6,5,6,0
1087,André Hahn,31,17,14,13,4,9,44,20.5,35,35,3,32,14,24,0
1088,Amadou Haidara,50,28,20,21,9,11,36,30.6,25,33,1,32,30,24,0
1089,Massadio Haïdara,48,32,21,21,6,23,37,62.2,14,29,6,23,35,60,0
1090,Achraf Hakimi,53,32,23,19,11,23,48,47.9,25,31,1,30,22,23,1
1091,Sébastien Haller,14,9,1,6,7,4,20,20.0,16,7,1,6,5,7,0
1092,Marcel Halstenberg,29,18,20,8,1,19,41,46.3,22,15,3,12,16,35,0
1093,Pierre-Yves Hamel,15,8,3,9,3,1,6,16.7,5,12,1,11,10,6,0
1094,Romain Hamouma,12,7,5,6,1,4,24,16.7,20,17,1,16,7,11,0
1095,Samir Handanović,1,0,1,0,0,1,1,100.0,0,0,0,0,0,6,3
1096,Lukáš Haraslín,8,4,2,5,1,2,5,40.0,3,1,0,1,0,2,0
1097,Amine Harit,22,13,8,11,3,10,23,43.5,13,9,1,8,17,7,1
1098,Rekeem Harper,0,0,0,0,0,0,0,,0,2,0,2,1,0,0
1099,Jack Harrison,63,38,20,30,13,26,59,44.1,33,30,2,28,15,21,0
1100,Marcel Hartel,35,19,15,18,2,20,40,50.0,20,17,4,13,26,16,1
1101,Makoto Hasebe,43,29,21,20,2,25,51,49.0,26,31,12,19,31,68,2
1102,Hans Hateboer,28,17,12,14,2,13,23,56.5,10,8,1,7,17,9,0
1103,Kortney Hause,4,2,3,1,0,0,3,0.0,3,4,2,2,8,53,0
1104,Kai Havertz,18,9,6,10,2,6,27,22.2,21,25,0,25,4,22,1
1105,Isaac Hayden,52,29,23,22,7,14,35,40.0,21,32,9,23,43,47,0
1106,Eden Hazard,3,2,1,2,0,0,3,0.0,3,3,0,3,3,0,0
1107,Thorgan Hazard,8,2,6,1,1,3,13,23.1,10,4,0,4,10,1,0
1108,Jonas Hector,34,22,8,21,5,15,35,42.9,20,24,5,19,19,20,1
1109,Michael Hector,3,2,1,2,0,1,6,16.7,5,4,2,2,0,6,0
1110,Hwang Hee-chan,3,2,1,0,2,1,7,14.3,6,4,0,4,1,1,0
1111,Ahmed Hegazi,0,0,0,0,0,0,0,,0,2,0,2,1,7,0
1112,Dominique Heintz,22,11,19,3,0,10,19,52.6,9,10,8,2,35,49,0
1113,Dean Henderson,1,1,1,0,0,1,2,50.0,1,0,0,0,0,3,2
1114,Jordan Henderson,24,15,12,9,3,10,26,38.5,16,12,1,11,34,30,0
1115,Jeff Hendrick,8,3,5,3,0,1,13,7.7,12,14,9,5,19,18,0
1116,Benjamin Henrichs,12,7,4,5,3,2,9,22.2,7,9,1,8,8,8,0
1117,Dalbert Henrique,7,6,4,2,1,6,8,75.0,2,8,2,6,5,8,0
1118,Eduardo Henrique,5,2,1,4,0,3,12,25.0,9,6,1,5,7,7,1
1119,Luis Henrique,5,4,3,1,1,4,9,44.4,5,5,1,4,7,4,0
1120,Christophe Hérelle,19,13,12,6,1,10,12,83.3,2,13,9,4,31,41,2
1121,Jérôme Hergault,38,23,22,10,6,17,31,54.8,14,16,2,14,22,34,0
1122,Mario Hermoso,55,31,40,11,4,37,61,60.7,24,23,10,13,36,73,0
1123,Aridane Hernández,20,11,13,6,1,7,12,58.3,5,22,19,3,34,127,1
1124,Lucas Hernández,41,31,16,17,8,17,31,54.8,14,24,6,18,19,38,0
1125,Pablo Hernández,5,3,2,1,2,5,16,31.3,11,2,0,2,0,0,1
1126,Theo Hernández,48,29,22,21,5,19,38,50.0,19,29,6,23,34,64,5
1127,Hernani,51,25,21,27,3,29,66,43.9,37,35,4,31,31,40,1
1128,Ander Herrera,53,35,17,26,10,30,77,39.0,47,31,5,26,31,22,1
1129,Héctor Herrera,12,7,5,6,1,7,13,53.8,6,7,2,5,14,8,0
1130,Sergio Herrera,0,0,0,0,0,0,2,0.0,2,0,0,0,3,29,3
1131,Yangel Herrera,59,26,19,32,8,11,41,26.8,30,53,17,36,26,32,1
1132,Patrick Herrmann,9,6,4,3,2,2,14,14.3,12,16,0,16,10,8,0
1133,Pablo Hervías,19,12,7,9,3,9,26,34.6,17,6,0,6,11,8,0
1134,Përparim Hetemaj,44,27,21,18,5,26,61,42.6,35,41,5,36,22,24,1
1135,Son Heung-min,32,18,11,14,7,18,72,25.0,54,28,3,25,14,8,0
1136,Aaron Hickey,12,8,10,2,0,7,17,41.2,10,6,1,5,15,15,1
1137,Vitorino Hilton,15,10,10,4,1,3,14,21.4,11,34,26,8,38,104,3
1138,Martin Hinteregger,77,49,53,22,2,37,63,58.7,26,31,12,19,44,92,0
1139,Marwin Hitz,1,1,1,0,0,1,1,100.0,0,0,0,0,0,7,1
1140,Wesley Hoedt,22,16,18,4,0,10,17,58.8,7,9,5,4,17,48,1
1141,Ki-Jana Hoever,14,6,11,2,1,10,22,45.5,12,2,0,2,9,23,0
1142,Nicolas Höfler,54,28,16,31,7,23,59,39.0,36,34,10,24,66,41,2
1143,Jonas Hofmann,26,20,12,12,2,10,53,18.9,43,27,2,25,27,9,0
1144,Marco Höger,1,0,0,1,0,1,2,50.0,1,2,0,2,2,1,0
1145,Rob Holding,43,20,28,13,2,17,35,48.6,18,37,27,10,24,120,0
1146,Lucas Höler,36,24,13,19,4,12,32,37.5,20,19,2,17,16,14,0
1147,Mason Holgate,56,36,31,18,7,20,50,40.0,30,37,13,24,35,90,3
1148,Jordan Holsgrove,6,4,4,1,1,5,8,62.5,3,2,0,2,2,1,0
1149,Franck Honorat,28,13,12,10,6,14,37,37.8,23,15,3,12,11,24,0
1150,Matthew Hoppe,6,6,1,3,2,2,12,16.7,10,8,2,6,4,15,0
1151,Jannes Horn,35,19,23,11,1,23,31,74.2,8,19,2,17,10,45,0
1152,Timo Horn,1,0,1,0,0,1,4,25.0,3,1,0,1,0,11,2
1153,Fraser Hornby,0,0,0,0,0,0,0,,0,0,0,0,1,0,0
1154,Conor Hourihane,0,0,0,0,0,0,2,0.0,2,3,0,3,0,2,0
1155,Lukáš Hrádecký,0,0,0,0,0,0,1,0.0,1,0,0,0,1,11,3
1156,Ajdin Hrustic,6,5,2,3,1,3,10,30.0,7,2,0,2,4,3,0
1157,Florian Hübner,10,5,7,3,0,7,15,46.7,8,7,3,4,13,21,0
1158,Callum Hudson-Odoi,23,15,11,7,5,8,21,38.1,13,15,1,14,6,6,0
1159,Niall Huggins,0,0,0,0,0,0,1,0.0,1,0,0,0,0,1,0
1160,Mats Hummels,58,40,34,18,6,26,42,61.9,16,31,22,9,73,122,2
1161,Adrien Hunou,6,3,2,2,2,2,8,25.0,6,7,0,7,1,2,0
1162,Klaas-Jan Huntelaar,4,2,0,2,2,0,2,0.0,2,3,1,2,2,3,0
1163,Elseid Hysaj,29,17,16,11,2,17,33,51.5,16,18,4,14,30,52,0
1164,Pierre Højbjerg,98,51,45,42,11,54,129,41.9,75,51,9,42,48,66,0
1165,Simone Iacoponi,22,12,16,5,1,13,26,50.0,13,9,4,5,11,42,1
1166,Iago,37,27,21,13,3,17,29,58.6,12,17,5,12,22,55,0
1167,Roger Ibanez,59,37,28,25,6,25,45,55.6,20,38,17,21,68,78,3
1168,Vedad Ibišević,0,0,0,0,0,0,0,,0,1,0,1,1,1,0
1169,Vicente Iborra,18,8,8,7,3,8,24,33.3,16,14,7,7,14,25,1
1170,Didier Ibrahim Ndong,53,32,22,30,1,25,70,35.7,45,35,7,28,37,40,0
1171,Zlatan Ibrahimović,5,4,0,4,1,3,6,50.0,3,5,3,2,6,27,1
1172,Mauro Icardi,6,2,1,2,3,4,13,30.8,9,3,1,2,3,7,0
1173,Oussama Idrissi,1,1,0,1,0,1,2,50.0,1,2,0,2,1,0,0
1174,Blendi Idrizi,8,4,1,6,1,1,1,100.0,0,6,2,4,3,1,0
1175,Odion Ighalo,0,0,0,0,0,0,1,0.0,1,0,0,0,0,0,0
1176,Iglesias,27,15,14,10,3,11,19,57.9,8,11,1,10,17,19,0
1177,Borja Iglesias,1,1,0,0,1,1,8,12.5,7,7,2,5,3,9,0
1178,Igor,15,9,9,6,0,7,12,58.3,5,17,9,8,23,34,0
1179,Kelechi Iheanacho,12,5,2,4,6,4,17,23.5,13,14,0,14,2,1,1
1180,Jonathan Ikone,18,12,3,8,7,9,22,40.9,13,16,1,15,7,9,0
1181,Yun Il-lok,0,0,0,0,0,0,4,0.0,4,0,0,0,5,1,0
1182,Ivan Ilić,26,14,11,11,4,7,21,33.3,14,17,5,12,27,26,0
1183,Josip Iličić,9,4,1,5,3,5,21,23.8,16,12,0,12,2,0,1
1184,Asier Illarramendi,5,2,1,4,0,1,5,20.0,4,2,0,2,5,7,0
1185,Stefan Ilsanker,33,20,17,15,1,21,42,50.0,21,30,8,22,30,51,2
1186,Ciro Immobile,14,13,4,6,4,7,22,31.8,15,13,1,12,6,9,0
1187,Riccardo Improta,39,23,25,8,6,21,45,46.7,24,23,4,19,28,47,0
1188,Roberto Inglese,5,2,1,2,2,2,11,18.2,9,10,0,10,0,3,0
1189,Danny Ings,22,13,3,16,3,12,28,42.9,16,39,2,37,3,27,1
1190,Marcus Ingvartsen,17,11,5,6,6,8,26,30.8,18,22,0,22,18,10,0
1191,Lorenzo Insigne,26,18,8,12,6,13,72,18.1,59,30,1,29,37,6,1
1192,Roberto Insigne,16,10,8,3,5,7,27,25.9,20,10,0,10,7,9,0
1193,Pablo Insua,37,18,26,9,2,14,31,45.2,17,14,8,6,24,68,0
1194,Takashi Inui,13,8,6,3,4,3,12,25.0,9,19,0,19,12,7,0
1195,Artur Ioniță,47,22,11,31,5,17,63,27.0,46,38,14,24,19,28,0
1196,Alexander Isak,9,5,0,3,6,3,8,37.5,5,17,1,16,3,7,0
1197,Isco,13,9,5,5,3,2,14,14.3,12,7,1,6,2,2,0
1198,Ardian Ismajli,19,9,10,8,1,8,13,61.5,5,10,7,3,23,52,1
1199,Abass Issah,0,0,0,0,0,0,0,,0,0,0,0,0,0,0
1200,Branislav Ivanović,14,5,11,3,0,7,13,53.8,6,11,5,6,8,25,0
1201,Alex Iwobi,27,10,10,14,3,13,25,52.0,12,20,1,19,16,14,0
1202,Jairo Izquierdo,21,13,13,8,0,12,31,38.7,19,7,1,6,14,12,0
1203,José Izquierdo,0,0,0,0,0,0,0,,0,0,0,0,0,0,0
1204,Armando Izzo,30,16,13,13,4,13,33,39.4,20,22,9,13,53,62,0
1205,Phil Jagielka,5,4,4,0,1,2,7,28.6,5,11,5,6,10,26,2
1206,Alireza Jahanbakhsh,9,7,3,5,1,2,12,16.7,10,8,0,8,8,1,0
1207,Mato Jajalo,1,1,1,0,0,1,1,100.0,0,1,0,1,2,0,0
1208,Ismail Jakobs,25,10,17,4,4,11,21,52.4,10,18,1,17,16,36,0
1209,Daniel James,15,9,4,7,4,3,18,16.7,15,10,1,9,0,6,0
1210,Reece James,55,35,24,22,9,21,44,47.7,23,36,7,29,17,52,0
1211,Alexandre Jankewitz,2,1,2,0,0,1,1,100.0,0,0,0,0,0,0,0
1212,Saidy Janko,19,10,12,5,2,8,14,57.1,6,9,1,8,18,47,0
1213,Jakub Jankto,28,17,14,7,7,11,35,31.4,24,16,1,15,24,34,0
1214,Tony Jantschke,2,2,1,1,0,1,3,33.3,2,6,4,2,4,7,0
1215,Adnan Januzaj,9,8,0,6,3,3,8,37.5,5,7,2,5,3,4,0
1216,Rune Jarstein,0,0,0,0,0,0,0,,0,0,0,0,0,7,1
1217,Jason,9,3,5,2,2,4,16,25.0,12,6,1,5,10,4,0
1218,Luis Javier Suárez,19,11,5,7,7,6,17,35.3,11,10,1,9,8,11,0
1219,Corentin Jean,4,3,1,1,2,0,5,0.0,5,4,0,4,2,2,0
1220,Daniel Jebbison,6,2,1,3,2,3,7,42.9,4,6,1,5,1,0,0
1221,Tin Jedvaj,5,2,2,3,0,1,3,33.3,2,2,1,1,2,9,0
1222,Fredrik Jensen,3,2,1,2,0,3,6,50.0,3,4,1,3,2,6,0
1223,Jesé,0,0,0,0,0,0,1,0.0,1,0,0,0,0,0,0
1224,Gabriel Jesus,17,6,5,5,7,11,28,39.3,17,16,0,16,15,5,0
1225,Juan Jesus,3,1,2,1,0,2,4,50.0,2,1,0,1,2,5,0
1226,Raúl Jiménez,3,2,1,2,0,0,7,0.0,7,2,0,2,8,12,0
1227,Joaquín,9,3,1,5,3,4,12,33.3,8,8,0,8,17,11,0
1228,John Joe,2,0,0,2,0,0,0,,0,0,0,0,0,0,0
1229,Joelinton,33,21,7,21,5,14,37,37.8,23,30,2,28,9,24,0
1230,Marco John,21,15,9,5,7,10,22,45.5,12,18,1,17,16,21,0
1231,Ben Johnson,11,5,5,3,3,7,9,77.8,2,5,1,4,11,9,0
1232,Sam Johnstone,0,0,0,0,0,0,0,,0,0,0,0,2,15,2
1233,Curtis Jones,16,6,6,7,3,12,25,48.0,13,13,0,13,19,11,1
1234,Frenkie de Jong,44,27,21,19,4,15,35,42.9,20,20,4,16,38,29,2
1235,Luuk de Jong,9,5,3,2,4,1,7,14.3,6,11,3,8,5,15,0
1236,Jony,7,3,1,2,4,5,20,25.0,15,5,0,5,14,3,0
1237,Joan Jordán,52,28,17,29,6,17,76,22.4,59,22,3,19,27,25,0
1238,Jorginho,57,30,22,31,4,31,76,40.8,45,33,5,28,40,21,3
1239,Josan,34,18,23,11,0,13,39,33.3,26,24,1,23,21,26,1
1240,Willian José,2,1,1,1,0,1,4,25.0,3,6,1,5,1,12,0
1241,Willian José,3,1,0,3,0,1,3,33.3,2,3,1,2,0,8,0
1242,Joselu,27,14,6,15,6,8,28,28.6,20,26,3,23,15,58,1
1243,Josema,43,28,33,10,0,10,18,55.6,8,17,7,10,37,92,0
1244,Jota,7,3,1,4,2,5,10,50.0,5,4,0,4,6,5,1
1245,Jota,19,14,6,7,6,3,29,10.3,26,12,0,12,9,9,0
1246,Diogo Jota,12,6,4,7,1,2,29,6.9,27,9,0,9,5,3,0
1247,Stevan Jovetić,8,4,2,3,3,3,13,23.1,10,1,0,1,3,3,0
1248,Luka Jović,0,0,0,0,0,0,0,,0,0,0,0,0,0,0
1249,Luka Jović,2,0,0,2,0,0,4,0.0,4,3,0,3,1,7,0
1250,Juanmi,13,9,3,5,5,4,18,22.2,14,4,0,4,2,4,0
1251,Hamed Junior Traorè,29,17,10,10,9,14,35,40.0,21,27,3,24,18,9,0
1252,Vinicius Júnior,32,22,14,10,8,11,43,25.6,32,28,0,28,7,4,0
1253,James Justin,61,37,38,18,5,20,41,48.8,21,36,10,26,30,58,1
1254,Musa Juwara,2,2,2,0,0,1,3,33.3,2,1,0,1,0,0,0
1255,Jens Jønsson,55,29,25,25,5,22,52,42.3,30,39,7,32,51,45,0
1256,Ozan Kabak,19,10,11,4,4,6,9,66.7,3,2,2,0,12,28,1
1257,Ozan Kabak,17,9,11,5,1,6,13,46.2,7,20,11,9,13,57,0
1258,Abdoul Kader Bamba,18,3,7,8,3,11,18,61.1,7,10,0,10,7,4,1
1259,Pavel Kadeřábek,15,12,7,6,2,6,15,40.0,9,12,3,9,18,31,0
1260,Tino Kadewere,35,22,12,16,7,17,49,34.7,32,16,3,13,21,31,0
1261,Damian Kądzior,1,0,0,1,0,1,5,20.0,4,1,0,1,0,0,0
1262,Florian Kainz,4,2,0,4,0,2,8,25.0,6,7,0,7,3,3,0
1263,Gaël Kakuta,38,23,10,18,10,8,44,18.2,36,24,3,21,17,4,0
1264,Sasa Kalajdzic,16,12,4,5,7,2,17,11.8,15,10,1,9,9,21,0
1265,Arnaud Kalimuendo,0,0,0,0,0,0,0,,0,0,0,0,0,0,0
1266,Arnaud Kalimuendo,8,2,2,2,4,1,7,14.3,6,11,0,11,2,2,0
1267,Nikola Kalinić,5,1,2,2,1,0,3,0.0,3,6,0,6,1,7,0
1268,Yayah Kallon,0,0,0,0,0,0,0,,0,0,0,0,0,0,0
1269,Samuel Kalu,21,12,11,8,2,4,13,30.8,9,14,0,14,9,2,0
1270,Pierre Kalulu,18,14,11,6,1,10,14,71.4,4,9,3,6,19,20,0
1271,Daichi Kamada,48,28,21,16,11,16,49,32.7,33,18,1,17,14,22,0
1272,Aboubakar Kamara,2,2,1,1,0,0,5,0.0,5,6,0,6,1,0,0
1273,Aboubakar Kamara,3,1,0,2,1,1,7,14.3,6,1,0,1,0,2,0
1274,Bingourou Kamara,1,1,1,0,0,1,3,33.3,2,0,0,0,1,2,1
1275,Boubacar Kamara,88,51,31,49,8,40,74,54.1,34,36,13,23,34,51,0
1276,Hassane Kamara,65,39,40,16,9,27,49,55.1,22,39,12,27,55,61,1
1277,Marcin Kamiński,1,1,0,0,1,0,0,,0,2,1,1,1,10,0
1278,Kevin Kampl,38,26,9,24,5,18,35,51.4,17,20,2,18,29,14,0
1279,Harry Kane,22,12,1,17,4,8,26,30.8,18,28,11,17,11,40,0
1280,Lee Kang-in,15,11,8,4,3,3,31,9.7,28,12,0,12,2,0,0
1281,Wilfried Kanga,0,0,0,0,0,0,1,0.0,1,1,0,1,0,2,0
1282,N'Golo Kanté,79,42,39,35,5,27,56,48.2,29,42,4,38,59,34,0
1283,Jimmy Kaparos,0,0,0,0,0,0,1,0.0,1,0,0,0,0,0,0
1284,Yann Karamoh,27,17,8,12,7,11,31,35.5,20,6,0,6,4,11,0
1285,Isaac Karamoko,1,0,0,0,1,1,1,100.0,0,0,0,0,0,0,0
1286,Atakan Karazor,20,12,12,7,1,13,22,59.1,9,18,8,10,21,50,2
1287,Augustus Kargbo,0,0,0,0,0,0,0,,0,0,0,0,0,0,0
1288,Loris Karius,0,0,0,0,0,0,0,,0,0,0,0,0,2,0
1289,Rick Karsdorp,36,23,19,12,5,21,48,43.8,27,18,1,17,30,32,0
1290,Silas Katompa,48,29,19,19,10,21,44,47.7,23,29,1,28,22,11,2
1291,Noah Katterbach,18,11,11,6,1,13,21,61.9,8,7,3,4,23,22,0
1292,Eiji Kawashima,1,0,1,0,0,1,1,100.0,0,0,0,0,0,4,2
1293,Moise Kean,0,0,0,0,0,0,0,,0,0,0,0,0,0,0
1294,Moise Kean,11,8,2,6,3,3,12,25.0,9,7,1,6,8,10,0
1295,Michael Keane,28,15,20,8,0,14,31,45.2,17,46,33,13,51,161,0
1296,Neeskens Kebano,0,0,0,0,0,0,1,0.0,1,3,0,3,0,0,0
1297,Thilo Kehrer,31,26,17,11,3,10,26,38.5,16,16,4,12,15,37,1
1298,Habib Keita,0,0,0,0,0,0,0,,0,0,0,0,0,0,0
1299,Naby Keïta,11,5,1,8,2,7,17,41.2,10,10,0,10,9,6,0
1300,Yannik Keitel,12,8,7,4,1,7,9,77.8,2,9,3,6,10,8,0
1301,Caoimhín Kelleher,0,0,0,0,0,0,0,,0,0,0,0,0,2,0
1302,Stephane Keller,1,0,1,0,0,1,1,100.0,0,0,0,0,0,0,0
1303,Martin Kelly,1,0,1,0,0,1,1,100.0,0,0,0,0,0,0,0
1304,Marc-Oliver Kempf,49,26,28,18,3,29,49,59.2,20,40,25,15,68,103,1
1305,Kenedy,22,12,10,7,5,5,25,20.0,20,21,4,17,26,15,1
1306,Jonjoe Kenny,2,1,1,0,1,2,2,100.0,0,0,0,0,1,3,0
1307,Franck Kessié,53,30,28,19,6,20,38,52.6,18,47,15,32,46,51,0
1308,Reda Khadra,0,0,0,0,0,0,0,,0,0,0,0,0,0,0
1309,Omar Khailoti,0,0,0,0,0,0,0,,0,2,0,2,1,0,0
1310,Saîf-Eddine Khaoui,19,11,7,6,6,7,16,43.8,9,8,0,8,12,1,0
1311,Wahbi Khazri,24,15,12,7,5,12,24,50.0,12,10,1,9,4,11,0
1312,Rani Khedira,29,10,13,15,1,10,20,50.0,10,14,5,9,31,47,0
1313,Sami Khedira,11,6,3,7,1,6,12,50.0,6,4,0,4,9,7,0
1314,Kiké,24,18,5,7,12,6,22,27.3,16,24,1,23,7,29,0
1315,Luca Kilian,14,7,10,4,0,9,17,52.9,8,3,1,2,13,12,0
1316,Max Kilman,21,14,13,4,4,8,14,57.1,6,17,8,9,19,46,0
1317,Joshua Kimmich,40,28,16,19,5,10,53,18.9,43,25,5,20,36,19,0
1318,Presnel Kimpembe,46,28,23,19,4,24,34,70.6,10,19,11,8,30,61,4
1319,Joshua King,4,1,2,1,1,0,0,,0,3,0,3,1,1,0
1320,Simon Kjær,45,26,23,20,2,18,30,60.0,12,42,26,16,42,125,0
1321,Davy Klaassen,3,1,0,1,2,0,5,0.0,5,5,1,4,3,4,0
1322,Felix Klaus,7,4,3,4,0,4,5,80.0,1,4,0,4,2,4,0
1323,Klauss,1,0,0,0,1,0,1,0.0,1,0,0,0,0,0,0
1324,Ragnar Klavan,15,9,9,5,1,7,11,63.6,4,9,4,5,8,34,0
1325,Philipp Klement,7,3,6,0,1,3,7,42.9,4,9,2,7,6,7,0
1326,Mateusz Klich,38,20,14,20,4,14,61,23.0,47,13,4,9,11,16,0
1327,Mateo Klimowicz,20,15,6,10,4,5,18,27.8,13,5,1,4,2,2,0
1328,Fabian Klos,24,13,9,11,4,7,26,26.9,19,20,6,14,4,29,0
1329,Lukas Klostermann,23,19,8,12,3,11,18,61.1,7,16,6,10,18,44,1
1330,Justin Kluivert,0,0,0,0,0,0,0,,0,0,0,0,0,0,0
1331,Justin Kluivert,2,1,1,1,0,0,2,0.0,2,4,0,4,5,3,0
1332,Lukas Klünter,10,5,6,4,0,5,10,50.0,5,3,1,2,11,29,1
1333,Ansgar Knauff,0,0,0,0,0,0,1,0.0,1,3,1,2,0,0,0
1334,Robin Knoche,44,29,30,12,2,23,39,59.0,16,43,27,16,49,118,2
1335,Gregor Kobel,2,2,2,0,0,2,2,100.0,0,0,0,0,2,8,1
1336,Robin Koch,27,16,17,10,0,10,19,52.6,9,18,12,6,27,34,2
1337,Giorgi Kochorashvili,1,0,1,0,0,0,0,,0,0,0,0,0,0,0
1338,Kenan Kodro,0,0,0,0,0,0,2,0.0,2,2,1,1,2,6,0
1339,Kenan Kodro,0,0,0,0,0,0,1,0.0,1,0,0,0,0,0,0
1340,Dominik Kohr,47,31,14,26,7,20,39,51.3,19,18,5,13,27,15,0
1341,Dominik Kohr,11,7,0,7,4,4,9,44.4,5,5,1,4,9,9,0
1342,Koba Koindredi,1,1,1,0,0,0,1,0.0,1,0,0,0,0,0,0
1343,Koke,64,42,22,31,11,28,98,28.6,70,35,6,29,36,40,0
1344,Aleksandr Kokorin,1,0,0,1,0,0,1,0.0,1,1,0,1,0,0,0
1345,Aleksandar Kolarov,4,4,0,4,0,1,2,50.0,1,2,0,2,7,8,0
1346,Sead Kolašinac,0,0,0,0,0,0,0,,0,0,0,0,1,0,0
1347,Sead Kolašinac,20,17,10,7,3,8,18,44.4,10,17,5,12,20,17,0
1348,Randal Kolo Muani,22,14,1,13,8,7,27,25.9,20,15,2,13,8,26,0
1349,Timothée Kolodziejczak,28,15,23,5,0,19,27,70.4,8,24,15,9,36,80,1
1350,Ghislain Konan,57,32,35,17,5,32,56,57.1,24,25,11,14,30,67,0
1351,Ibrahima Konaté,6,4,2,3,1,2,8,25.0,6,6,3,3,8,24,0
1352,Moussa Konaté,5,3,1,2,2,2,11,18.2,9,4,1,3,5,8,0
1353,Geoffrey Kondogbia,16,9,9,4,3,7,19,36.8,12,6,1,5,8,8,0
1354,Geoffrey Kondogbia,30,20,12,16,2,11,20,55.0,9,11,5,6,11,8,1
1355,Lamine Koné,9,6,5,4,0,5,8,62.5,3,4,3,1,15,36,0
1356,Moussa Koné,13,6,1,8,4,2,9,22.2,7,7,1,6,2,7,0
1357,Youssouf Koné,2,0,1,0,1,0,1,0.0,1,0,0,0,0,0,0
1358,Terence Kongolo,3,2,1,2,0,1,1,100.0,0,0,0,0,2,3,0
1359,Ezri Konsa,25,13,18,6,1,9,13,69.2,4,53,47,6,29,162,1
1360,Laurent Koscielny,29,17,18,11,0,16,24,66.7,8,44,34,10,54,115,1
1361,Filip Kostić,54,31,22,23,9,22,54,40.7,32,43,6,37,26,28,2
1362,Márk Kosznovszky,2,2,1,1,0,1,4,25.0,3,2,0,2,1,1,0
1363,Christian Kouamé,9,4,2,4,3,4,12,33.3,8,9,1,8,5,4,0
1364,Kalidou Koulibaly,36,24,25,7,4,19,32,59.4,13,46,26,20,29,64,2
1365,Jules Koundé,27,15,14,11,2,10,24,41.7,14,24,16,8,40,104,0
1366,Boubakar Kouyaté,60,35,45,15,0,32,58,55.2,26,44,27,17,60,132,1
1367,Cheikhou Kouyaté,58,37,44,12,2,25,43,58.1,18,42,26,16,32,125,2
1368,Mateo Kovačić,46,28,19,24,3,17,32,53.1,15,18,1,17,15,11,2
1369,Viktor Kovalenko,0,0,0,0,0,0,0,,0,0,0,0,0,1,0
1370,Emil Krafth,19,8,9,9,1,12,25,48.0,13,15,9,6,15,52,2
1371,Andrej Kramarić,7,4,4,0,3,3,8,37.5,5,8,1,7,7,5,1
1372,Christoph Kramer,55,37,22,28,5,28,58,48.3,30,32,11,21,34,39,0
1373,Jean-Philippe Krasso,5,3,1,4,0,2,4,50.0,2,5,0,5,1,3,0
1374,Toni Kroos,42,22,15,15,12,11,44,25.0,33,26,6,20,15,10,3
1375,Filip Krovinović,13,10,6,5,2,6,18,33.3,12,2,0,2,4,2,0
1376,Rade Krunić,15,12,6,6,3,7,17,41.2,10,12,2,10,10,9,0
1377,Max Kruse,7,3,1,5,1,2,9,22.2,7,11,0,11,3,3,0
1378,Lukas Kübler,15,8,9,5,1,9,14,64.3,5,9,3,6,21,31,0
1379,Takefusa Kubo,1,1,0,0,1,1,5,20.0,4,2,0,2,1,2,0
1380,Takefusa Kubo,7,4,2,3,2,1,14,7.1,13,14,0,14,14,4,0
1381,Juraj Kucka,67,36,21,37,9,26,74,35.1,48,25,3,22,28,25,0
1382,Kuki,1,1,0,0,1,0,1,0.0,1,0,0,0,0,0,0
1383,Dejan Kulusevski,33,19,12,10,11,14,43,32.6,29,22,0,22,9,2,1
1384,Marash Kumbulla,16,11,8,7,1,5,17,29.4,12,12,5,7,24,38,1
1385,Pierre Kunde,8,4,1,5,2,2,9,22.2,7,6,0,6,10,9,0
1386,Fabian Kunze,38,26,19,15,4,19,42,45.2,23,19,3,16,18,22,1
1387,Jasmin Kurtić,46,28,22,21,3,21,70,30.0,49,22,2,20,33,57,1
1388,Layvin Kurzawa,26,19,10,10,6,9,28,32.1,19,20,5,15,28,26,1
1389,Dereck Kutesa,15,7,7,3,5,5,14,35.7,9,7,1,6,7,3,0
1390,Ahmed Kutucu,1,0,0,0,1,1,2,50.0,1,1,0,1,0,0,0
1391,Enock Kwateng,21,12,15,4,2,14,27,51.9,13,15,3,12,26,27,0
1392,Giorgos Kyriakopoulos,35,18,17,12,6,8,28,28.6,20,16,5,11,15,42,0
1393,Antonino La Gumina,3,2,0,1,2,0,3,0.0,3,5,1,4,3,5,0
1394,Gaëtan Laborde,43,22,21,17,5,16,60,26.7,44,29,3,26,16,25,1
1395,Alexandre Lacazette,18,10,4,11,3,4,22,18.2,18,20,1,19,12,13,0
1396,Tom Lacoux,22,14,10,11,1,9,21,42.9,12,12,3,9,12,7,0
1397,Maxence Lacroix,49,29,37,12,0,24,45,53.3,21,51,21,30,65,140,1
1398,Alban Lafont,1,0,1,0,0,1,1,100.0,0,1,0,1,0,14,0
1399,Víctor Laguardia,20,12,13,6,1,14,31,45.2,17,25,13,12,37,104,0
1400,Konrad Laimer,2,0,0,1,1,0,4,0.0,4,2,0,2,1,0,0
1401,Stefan Lainer,62,37,30,22,10,27,60,45.0,33,34,5,29,35,85,1
1402,Diego Lainez,9,4,3,5,1,6,16,37.5,10,15,0,15,11,6,0
1403,Kenny Lala,22,13,13,8,1,11,22,50.0,11,12,6,6,23,33,1
1404,Adam Lallana,28,13,11,13,4,8,39,20.5,31,18,3,15,15,13,0
1405,Érik Lamela,17,9,1,11,5,8,21,38.1,13,11,1,10,6,2,0
1406,Sam Lammers,2,0,0,2,0,0,6,0.0,6,0,0,0,0,3,0
1407,Tariq Lamptey,17,9,7,6,4,6,13,46.2,7,8,1,7,19,12,1
1408,Loïck Landre,14,7,9,5,0,13,28,46.4,15,22,19,3,31,52,0
1409,Michael Langer,0,0,0,0,0,0,0,,0,0,0,0,0,3,0
1410,Manuel Lanzini,9,2,3,4,2,3,10,30.0,7,9,0,9,7,5,0
1411,Gianluca Lapadula,22,12,3,13,6,6,25,24.0,19,18,3,15,5,16,0
1412,Aymeric Laporte,13,6,10,3,0,7,11,63.6,4,12,7,5,11,28,0
1413,Julien Laporte,65,39,48,16,1,42,74,56.8,32,34,23,11,65,125,0
1414,Danilo Larangeira,33,24,23,10,0,8,29,27.6,21,58,36,22,51,127,2
1415,Gautier Larsonneur,1,1,1,0,0,1,1,100.0,0,2,0,2,0,16,3
1416,Kevin Lasagna,6,1,2,3,1,3,14,21.4,11,11,0,11,6,7,0
1417,Kevin Lasagna,7,3,0,5,2,1,5,20.0,4,12,1,11,1,11,0
1418,Jamaal Lascelles,14,7,5,9,0,3,6,50.0,3,27,17,10,12,86,0
1419,Paul Lasne,46,26,25,19,2,17,40,42.5,23,25,5,20,47,17,2
1420,Toni Lato,13,6,7,3,3,6,13,46.2,7,12,1,11,10,21,0
1421,Danny Latza,43,26,12,19,12,23,70,32.9,47,39,3,36,27,23,0
1422,Armand Lauriente,30,10,10,19,1,7,26,26.9,19,21,0,21,15,4,0
1423,Vincent Laurini,16,11,8,6,2,7,9,77.8,2,8,4,4,17,22,1
1424,Lauti,0,0,0,0,0,0,0,,0,0,0,0,0,1,0
1425,Wesley Lautoa,36,20,20,13,3,11,37,29.7,26,17,8,9,29,33,1
1426,Valentino Lazaro,17,11,7,5,5,12,19,63.2,7,18,1,17,15,20,0
1427,Darko Lazović,29,17,8,17,4,20,42,47.6,22,17,7,10,20,29,0
1428,Manuel Lazzari,24,14,15,4,5,14,39,35.9,25,22,3,19,18,28,0
1429,Jérémy Le Douaron,15,10,9,4,2,7,21,33.3,14,14,1,13,8,11,0
1430,Enzo Le Fée,51,28,23,23,5,27,73,37.0,46,30,6,24,25,10,0
1431,Vincent Le Goff,42,29,16,24,2,18,49,36.7,31,27,5,22,44,44,0
1432,Maxime Le Marchand,2,2,2,0,0,2,2,100.0,0,0,0,0,0,3,0
1433,Robin Le Normand,34,20,25,8,1,9,19,47.4,10,35,24,11,36,87,1
1434,Damien Le Tallec,16,10,10,4,2,10,30,33.3,20,15,8,7,25,21,2
1435,James Lea Siliki,5,2,1,3,1,2,2,100.0,0,3,0,3,1,1,1
1436,Rafael Leão,13,6,4,7,2,6,15,40.0,9,17,0,17,4,14,1
1437,Jean-Louis Leca,3,2,3,0,0,3,5,60.0,2,0,0,0,1,14,4
1438,Mathew Leckie,12,3,5,5,2,4,11,36.4,7,8,0,8,13,9,0
1439,Benjamin Lecomte,0,0,0,0,0,0,2,0.0,2,1,0,1,2,20,1
1440,Jeremías Ledesma,1,0,1,0,0,1,1,100.0,0,1,0,1,0,22,6
1441,Pierre Lees-Melou,67,39,33,31,3,25,83,30.1,58,50,14,36,29,31,1
1442,Lucas Leiva,68,32,38,28,2,30,86,34.9,56,21,0,21,57,21,0
1443,Florian Lejeune,43,32,36,7,0,21,35,60.0,14,38,24,14,51,149,1
1444,Iñigo Lekue,9,7,6,3,0,3,8,37.5,5,8,1,7,4,24,0
1445,Thomas Lemar,30,17,9,17,4,11,24,45.8,13,22,1,21,11,10,0
1446,Mario Lemina,62,35,25,30,7,23,44,52.3,21,26,5,21,30,21,0
1447,Fabien Lemoine,74,45,39,33,2,36,89,40.4,53,25,1,24,27,35,0
1448,Clément Lenglet,36,21,23,10,3,19,28,67.9,9,26,12,14,33,71,1
1449,Bernd Leno,1,0,1,0,0,1,1,100.0,0,1,0,1,0,11,2
1450,Christopher Lenz,74,41,39,30,5,35,71,49.3,36,34,5,29,35,50,0
1451,Pedro León,9,8,3,3,3,3,17,17.6,14,11,0,11,7,2,0
1452,Sergio León,6,2,0,4,2,2,8,25.0,6,4,0,4,3,2,0
1453,Lukas Lerager,24,13,14,9,1,11,30,36.7,19,13,3,10,14,25,1
1454,Mehdi Léris,11,5,6,4,1,6,16,37.5,10,12,2,10,12,15,0
1455,Khanya Leshabela,0,0,0,0,0,0,0,,0,0,0,0,0,0,0
1456,Karlo Letica,0,0,0,0,0,0,0,,0,0,0,0,0,2,0
1457,Gaetano Letizia,36,25,19,13,4,17,36,47.2,19,15,3,12,20,42,1
1458,Robert Lewandowski,15,9,0,7,8,2,13,15.4,11,9,1,8,3,11,0
1459,Jamal Lewis,37,20,23,13,1,16,38,42.1,22,21,7,14,11,44,1
1460,Aaron Leya Iseka,6,4,2,3,1,0,4,0.0,4,4,2,2,0,6,0
1461,Yanis Lhery,0,0,0,0,0,0,0,,0,0,0,0,0,0,0
1462,Dimitri Liénard,39,27,17,19,3,24,55,43.6,31,23,1,22,18,10,0
1463,Philipp Lienhart,21,13,12,7,2,9,20,45.0,11,30,21,9,42,100,0
1464,Matthijs de Ligt,37,19,20,16,1,18,28,64.3,10,42,21,21,31,64,0
1465,Isaac Lihadji,11,4,2,6,3,4,5,80.0,1,5,1,4,1,0,1
1466,Dimitris Limnios,9,6,3,5,1,5,6,83.3,1,5,0,5,2,1,0
1467,Victor Lindelöf,22,10,12,10,0,12,24,50.0,12,22,14,8,30,95,1
1468,Karol Linetty,38,28,13,19,6,16,45,35.6,29,19,5,14,15,7,0
1469,Jesse Lingard,12,6,4,8,0,5,14,35.7,9,7,1,6,4,0,0
1470,Pol Lirola,13,8,8,2,3,6,12,50.0,6,6,3,3,6,9,0
1471,Pol Lirola,28,16,11,15,2,16,28,57.1,12,18,5,13,25,26,0
1472,Jake Livermore,33,18,14,16,3,14,31,45.2,17,21,6,15,16,26,0
1473,Diego Llorente,34,21,21,13,0,19,32,59.4,13,18,13,5,20,40,2
1474,Diego Llorente,1,0,1,0,0,1,2,50.0,1,1,1,0,2,5,0
1475,Fernando Llorente,4,1,2,2,0,2,5,40.0,3,3,0,3,2,17,0
1476,Fernando Llorente,0,0,0,0,0,0,0,,0,0,0,0,0,0,0
1477,Marcos Llorente,71,42,21,40,10,26,62,41.9,36,40,3,37,29,28,0
1478,Hugo Lloris,0,0,0,0,0,0,1,0.0,1,0,0,0,0,10,1
1479,Giovani Lo Celso,28,22,12,11,5,10,29,34.5,19,12,1,11,7,5,0
1480,Stanislav Lobotka,1,1,0,1,0,0,1,0.0,1,1,1,0,0,1,1
1481,Manuel Locatelli,81,47,43,28,10,29,56,51.8,27,35,15,20,51,65,1
1482,Renan Lodi,30,17,13,12,5,17,26,65.4,9,15,0,15,16,18,0
1483,Ruben Loftus-Cheek,0,0,0,0,0,0,0,,0,0,0,0,0,0,0
1484,Ruben Loftus-Cheek,25,14,7,15,3,7,23,30.4,16,20,2,18,7,18,0
1485,Niklas Lomb,0,0,0,0,0,0,0,,0,0,0,0,0,0,2
1486,Kevin Long,11,6,9,2,0,7,9,77.8,2,11,7,4,6,24,0
1487,Shane Long,2,1,0,0,2,2,3,66.7,1,0,0,0,3,1,0
1488,Matthew Longstaff,3,2,2,1,0,2,8,25.0,6,7,0,7,7,2,0
1489,Sean Longstaff,31,14,13,15,3,18,42,42.9,24,26,5,21,19,14,2
1490,Ademola Lookman,35,11,18,9,8,13,44,29.5,31,31,1,30,20,9,0
1491,Anthony Lopes,1,1,1,0,0,1,2,50.0,1,1,0,1,1,20,1
1492,Rony Lopes,20,14,4,13,3,6,27,22.2,21,14,3,11,8,6,0
1493,Adrián López,3,3,0,1,2,1,5,20.0,4,3,0,3,0,3,0
1494,Javi López,5,5,3,2,0,2,3,66.7,1,2,0,2,3,3,1
1495,Maxime Lopez,24,13,15,6,3,14,41,34.1,27,9,0,9,16,10,1
1496,Maxime Lopez,1,1,1,0,0,0,2,0.0,2,0,0,0,2,2,0
1497,Pedro López Muñoz,23,15,10,8,5,15,22,68.2,7,10,4,6,16,23,1
1498,Pau López,2,0,2,0,0,2,2,100.0,0,1,0,1,0,7,4
1499,Roberto López,5,1,1,2,2,2,5,40.0,3,2,0,2,4,6,0
1500,Unai López,27,17,13,13,1,10,29,34.5,19,20,5,15,18,9,1
1501,Dion Lopy,1,1,0,1,0,0,0,,0,0,0,0,2,1,0
1502,Jordan Lotomba,35,25,19,11,5,20,34,58.8,14,19,7,12,33,52,1
1503,Adrien Louveau,0,0,0,0,0,0,0,,0,0,0,0,0,1,0
1504,Imran Louza,55,28,25,26,4,21,69,30.4,48,20,4,16,33,15,2
1505,Matteo Lovato,21,12,14,5,2,10,21,47.6,11,20,10,10,37,48,1
1506,Max Lowe,26,11,18,6,2,9,21,42.9,12,12,4,8,5,11,0
1507,Eduard Löwen,5,1,3,1,1,2,5,40.0,3,1,0,1,1,1,0
1508,Matthew Lowton,54,32,31,22,1,32,73,43.8,41,36,13,23,56,91,1
1509,Anthony Lozano,12,4,1,5,6,2,13,15.4,11,3,1,2,3,8,0
1510,Hirving Lozano,29,18,10,13,6,10,36,27.8,26,37,1,36,18,14,0
1511,Jan Luca Schuler,2,2,1,1,0,0,1,0.0,1,1,0,1,0,0,0
1512,Jean Lucas,3,2,2,1,0,1,4,25.0,3,3,1,2,2,1,0
1513,Jean Lucas,19,13,10,9,0,8,29,27.6,21,7,0,7,8,10,1
1514,Anderson Lucoqui,40,25,23,17,0,20,40,50.0,20,30,7,23,27,53,0
1515,Jeison Lucumí,1,1,0,1,0,0,0,,0,1,0,1,0,0,0
1516,Kilian Ludewig,16,6,10,5,1,8,25,32.0,17,7,0,7,3,14,0
1517,Florentino Luís,7,2,4,2,1,6,10,60.0,4,1,0,1,6,2,1
1518,José Luis Gayà,59,33,40,13,6,33,68,48.5,35,22,3,19,38,62,1
1519,José Luis Morales,18,10,7,9,2,8,36,22.2,28,17,0,17,11,11,0
1520,José Luis Palomino,67,33,41,19,7,24,48,50.0,24,30,16,14,79,60,2
1521,Luisinho,3,3,2,1,0,1,3,33.3,2,3,0,3,4,7,0
1522,Luismi,4,2,1,3,0,1,2,50.0,1,2,0,2,4,0,0
1523,David Luiz,12,9,5,7,0,4,4,100.0,0,16,9,7,16,50,2
1524,Douglas Luiz,49,18,22,26,1,20,58,34.5,38,52,17,35,43,44,2
1525,Romelu Lukaku,11,1,1,6,4,6,14,42.9,8,11,1,10,3,34,0
1526,Dodi Lukebakio,21,14,13,5,3,9,20,45.0,11,14,1,13,12,8,0
1527,Saša Lukić,32,13,11,18,3,15,50,30.0,35,23,5,18,17,17,0
1528,Senad Lulić,14,7,6,5,3,7,15,46.7,8,10,1,9,4,13,0
1529,John Lundstram,25,16,12,11,2,13,47,27.7,34,26,8,18,14,29,1
1530,Sebastiano Luperto,38,20,28,8,2,16,27,59.3,11,17,7,10,27,74,1
1531,Andreas Luthe,1,1,1,0,0,1,3,33.3,2,1,0,1,0,8,3
1532,Lyanco,21,14,13,6,2,8,14,57.1,6,36,26,10,46,76,0
1533,Charalambos Lykogiannis,34,21,22,9,3,22,38,57.9,16,34,13,21,32,94,0
1534,Yann M'Vila,0,0,0,0,0,0,2,0.0,2,0,0,0,1,0,0
1535,Alexis Mac Allister,26,12,6,16,4,11,38,28.9,27,25,4,21,9,4,0
1536,Darwin Machís,30,17,12,10,8,6,19,31.6,13,21,2,19,22,13,0
1537,Tim Maciejewski,0,0,0,0,0,0,0,,0,0,0,0,0,0,0
1538,Luca Mack,0,0,0,0,0,0,0,,0,0,0,0,0,1,0
1539,Yvann Macon,30,20,20,8,2,7,19,36.8,12,6,2,4,9,13,0
1540,James Maddison,32,16,5,16,11,14,41,34.1,27,14,1,13,9,5,0
1541,Mikail Maden,0,0,0,0,0,0,0,,0,0,0,0,0,0,0
1542,Pablo Maffeo,26,17,21,4,1,12,26,46.2,14,18,6,12,35,27,0
1543,Gabriel Magalhães,25,15,19,5,1,13,19,68.4,6,27,19,8,26,74,2
1544,Lisandro Magallán,54,31,28,24,2,17,42,40.5,25,29,15,14,44,78,1
1545,Christian Maggio,9,4,2,7,0,3,9,33.3,6,4,1,3,2,6,0
1546,Giulio Maggiore,61,36,26,28,7,21,53,39.6,32,33,6,27,19,25,1
1547,Francesco Magnanelli,7,5,2,5,0,3,10,30.0,7,6,2,4,13,10,0
1548,Giangiacomo Magnani,26,15,14,9,3,9,16,56.3,7,25,16,9,44,105,1
1549,Hugo Magnetti,24,12,10,13,1,20,40,50.0,20,6,1,5,14,8,0
1550,Harry Maguire,29,17,19,10,0,18,29,62.1,11,28,23,5,60,122,4
1551,Abdallahi Mahmoud,2,2,1,1,0,0,1,0.0,1,0,0,0,1,0,0
1552,Hicham Mahou,1,1,1,0,0,1,2,50.0,1,2,0,2,1,0,0
1553,Riyad Mahrez,20,5,2,10,8,6,30,20.0,24,19,0,19,8,4,0
1554,Arne Maier,13,9,5,7,1,4,11,36.4,7,10,3,7,8,11,1
1555,Arne Maier,1,1,0,1,0,0,1,0.0,1,0,0,0,0,0,0
1556,Habib Maïga,81,52,36,40,5,42,85,49.4,43,37,6,31,49,36,0
1557,Mike Maignan,0,0,0,0,0,0,0,,0,0,0,0,0,7,2
1558,Ainsley Maitland-Niles,11,7,6,5,0,8,12,66.7,4,12,2,10,14,7,1
1559,Ainsley Maitland-Niles,22,10,7,8,7,9,28,32.1,19,12,1,11,17,24,0
1560,Josh Maja,7,4,0,3,4,4,10,40.0,6,3,1,2,4,1,0
1561,Josh Maja,8,2,3,3,2,3,14,21.4,11,3,0,3,6,9,0
1562,Radosław Majecki,0,0,0,0,0,0,0,,0,0,0,0,0,1,0
1563,Abdul Majeed Waris,1,1,1,0,0,1,6,16.7,5,0,0,0,2,2,0
1564,Marco Majouga,1,1,1,0,0,1,3,33.3,2,0,0,0,0,0,0
1565,Jean-Victor Makengo,8,7,5,3,0,3,13,23.1,10,7,1,6,5,7,0
1566,Nemanja Maksimović,50,28,22,24,4,19,46,41.3,27,40,9,31,57,46,1
1567,Nikola Maksimović,18,9,11,6,1,9,18,50.0,9,15,6,9,21,49,3
1568,Filip Malbašić,12,7,4,5,3,6,18,33.3,12,10,0,10,4,2,0
1569,Kévin Malcuit,5,3,2,2,1,0,1,0.0,1,5,0,5,3,6,0
1570,Kévin Malcuit,2,1,2,0,0,0,1,0.0,1,0,0,0,2,2,0
1571,Daniel Maldini,1,0,0,1,0,0,2,0.0,2,0,0,0,0,0,0
1572,Ruslan Malinovskyi,19,8,2,13,4,8,23,34.8,15,16,1,15,2,4,0
1573,Yunus Mallı,1,0,0,1,0,1,1,100.0,0,0,0,0,0,0,0
1574,Hugo Mallo,58,40,34,23,1,24,52,46.2,28,42,11,31,37,77,0
1575,Mickael Malsa,55,26,28,24,3,23,51,45.1,28,38,9,29,43,36,2
1576,Dennis Man,12,6,6,4,2,6,21,28.6,15,5,0,5,2,6,0
1577,Hianga Mananga Mbock,4,3,2,2,0,2,9,22.2,7,2,0,2,3,6,0
1578,Vincent Manceau,42,27,23,17,2,30,63,47.6,33,23,2,21,35,61,0
1579,Gianluca Mancini,50,29,29,19,2,18,31,58.1,13,38,18,20,72,77,3
1580,Steve Mandanda,0,0,0,0,0,0,1,0.0,1,0,0,0,2,8,6
1581,Reinildo Mandava,79,43,39,32,8,35,58,60.3,23,26,3,23,45,53,0
1582,Aïssa Mandi,30,17,20,10,0,10,16,62.5,6,21,13,8,39,90,0
1583,Rolando Mandragora,8,5,3,4,1,3,10,30.0,7,10,3,7,6,5,0
1584,Rolando Mandragora,19,4,4,9,6,7,30,23.3,23,19,6,13,20,19,0
1585,Mario Mandžukić,7,6,2,4,1,2,3,66.7,1,0,0,0,2,3,0
1586,Sadio Mané,48,30,6,22,20,12,33,36.4,21,30,0,30,15,11,0
1587,Niccolò Manfredini,0,0,0,0,0,0,0,,0,0,0,0,0,2,1
1588,Eliaquim Mangala,0,0,0,0,0,0,1,0.0,1,8,6,2,6,12,0
1589,Orel Mangala,27,15,13,11,3,17,28,60.7,11,27,10,17,26,30,0
1590,Thomas Mangani,54,37,25,26,3,30,90,33.3,60,31,8,23,38,39,0
1591,Vito Mannone,0,0,0,0,0,0,0,,0,0,0,0,0,3,1
1592,Kostas Manolas,31,18,24,7,0,17,24,70.8,7,22,13,9,23,82,2
1593,Javier Manquillo,24,14,8,14,2,11,17,64.7,6,8,1,7,9,15,1
1594,Juan Manuel Ramos,5,0,3,0,2,4,7,57.1,3,1,0,1,2,6,0
1595,Myziane Maolida,13,8,4,4,5,4,11,36.4,7,6,1,5,6,4,0
1596,Faitout Maouassa,20,11,10,8,2,11,19,57.9,8,9,1,8,17,36,0
1597,Sekou Mara,5,3,1,3,1,2,10,20.0,8,0,0,0,1,1,0
1598,Fernando Marçal,13,5,6,7,0,6,11,54.5,5,11,2,9,12,25,0
1599,Fernando Marçal,1,0,0,1,0,0,0,,0,0,0,0,2,0,0
1600,Marcelo,25,21,11,6,8,11,24,45.8,13,13,1,12,10,15,0
1601,Marcelo,44,29,30,12,2,26,37,70.3,11,35,25,10,49,122,2
1602,Solly March,49,23,24,15,10,18,34,52.9,16,30,5,25,22,30,0
1603,Federico Marchetti,1,0,1,0,0,1,1,100.0,0,0,0,0,0,2,1
1604,Riccardo Marchizza,20,11,12,5,3,12,21,57.1,9,13,4,9,11,27,0
1605,Gian Marco Ferrari,32,20,15,14,3,10,23,43.5,13,46,37,9,50,100,1
1606,Iván Marcone,64,41,42,17,5,35,84,41.7,49,27,8,19,36,33,3
1607,Óscar de Marcos,28,17,12,10,6,10,25,40.0,15,12,1,11,12,38,0
1608,Dario Maresic,12,7,8,4,0,8,14,57.1,6,7,2,5,10,17,1
1609,José Mari,32,17,13,18,1,14,31,45.2,17,16,7,9,27,33,1
1610,Pablo Marí,15,9,12,3,0,5,10,50.0,5,8,7,1,9,30,2
1611,José María Giménez,20,7,14,5,1,12,17,70.6,5,17,11,6,21,65,0
1612,Mariano,4,2,2,1,1,0,9,0.0,9,3,1,2,0,3,0
1613,Jordan Marié,34,17,9,23,2,23,56,41.1,33,14,5,9,23,12,2
1614,Adrián Marín,1,1,0,1,0,0,2,0.0,2,1,0,1,2,2,0
1615,Adrián Marín,5,2,1,3,1,2,3,66.7,1,5,2,3,4,9,0
1616,Răzvan Marin,54,33,26,22,6,27,53,50.9,26,29,10,19,29,15,0
1617,Guillermo Maripán,26,11,17,9,0,15,27,55.6,12,18,11,7,27,66,1
1618,Marlon,19,13,13,6,0,13,18,72.2,5,23,17,6,27,44,2
1619,Omar Marmoush,0,0,0,0,0,0,0,,0,0,0,0,0,0,0
1620,Marquinhos,27,21,14,10,3,15,26,57.7,11,21,9,12,27,75,2
1621,Luca Marrone,25,18,16,9,0,13,21,61.9,8,22,11,11,26,56,1
1622,Roger Martí,11,7,5,4,2,6,23,26.1,17,10,3,7,4,6,0
1623,Anthony Martial,2,1,1,1,0,0,10,0.0,10,17,3,14,1,8,0
1624,Aarón Martín,34,20,15,16,3,10,33,30.3,23,15,4,11,13,37,0
1625,Aarón Martín,3,2,2,1,0,2,4,50.0,2,1,0,1,2,2,0
1626,Álex Martín,2,0,1,1,0,2,4,50.0,2,1,1,0,0,6,0
1627,Jonas Martin,11,9,5,4,2,5,14,35.7,9,11,2,9,13,2,1
1628,Gabriel Martinelli,7,1,2,3,2,4,10,40.0,6,6,0,6,8,4,0
1629,Emiliano Martínez,3,3,3,0,0,3,4,75.0,1,0,0,0,2,10,2
1630,Iñigo Martínez,22,15,16,6,0,9,27,33.3,18,17,7,10,28,96,0
1631,Javi Martínez,9,4,1,6,2,5,12,41.7,7,9,0,9,5,4,0
1632,Javi Martínez,10,5,4,4,2,7,9,77.8,2,8,4,4,13,19,0
1633,Josep Martinez,0,0,0,0,0,0,0,,0,0,0,0,0,0,0
1634,Lautaro Martínez,25,12,5,11,9,7,24,29.2,17,31,1,30,27,16,0
1635,Pablo Martinez,10,7,7,3,0,7,7,100.0,0,6,4,2,11,28,0
1636,Lucas Martínez Quarta,32,20,17,11,4,18,41,43.9,23,27,9,18,39,48,0
1637,Gelson Martins,41,26,12,16,13,15,37,40.5,22,20,0,20,13,8,0
1638,Adam Marušić,38,22,22,15,1,20,40,50.0,20,38,6,32,40,54,0
1639,Sylvain Marveaux,6,3,1,4,1,3,3,100.0,0,2,0,2,1,2,0
1640,Marvin,3,2,0,3,0,1,2,50.0,1,1,0,1,2,3,0
1641,Omar Mascarell,41,24,15,19,7,21,54,38.9,33,40,14,26,37,32,1
1642,Andrea Masiello,38,22,29,6,3,23,48,47.9,25,32,13,19,53,107,3
1643,Jordi Masip,0,0,0,0,0,0,2,0.0,2,2,0,2,2,8,1
1644,Roberto Massimo,21,11,13,5,3,11,24,45.8,13,5,1,4,11,13,0
1645,Giuseppe Mastinu,1,1,0,0,1,1,1,100.0,0,1,0,1,0,0,0
1646,Arthur Masuaku,20,12,14,6,0,11,34,32.4,23,12,0,12,8,28,2
1647,Jaime Mata,12,7,1,3,8,3,18,16.7,15,13,2,11,6,16,0
1648,Juan Mata,1,0,1,0,0,0,7,0.0,7,3,0,3,3,3,0
1649,Pape Matar Sarr,45,29,19,21,5,20,38,52.6,18,24,4,20,27,16,0
1650,Eliot Matazo,11,5,6,5,0,3,7,42.9,4,1,0,1,1,2,0
1651,Jean-Philippe Mateta,1,1,0,1,0,1,3,33.3,2,1,0,1,0,2,0
1652,Jean-Philippe Mateta,6,3,1,3,2,0,3,0.0,3,3,1,2,4,6,0
1653,Nemanja Matić,25,11,13,12,0,13,31,41.9,18,19,5,14,22,10,3
1654,Joël Matip,14,9,7,7,0,7,8,87.5,1,6,0,6,7,22,0
1655,Rabbi Matondo,3,2,0,3,0,2,3,66.7,1,1,0,1,1,1,0
1656,Ryder Matos,0,0,0,0,0,0,0,,0,0,0,0,0,0,0
1657,Henning Matriciani,1,1,1,0,0,1,1,100.0,0,1,0,1,0,1,0
1658,Chrislain Matsima,5,4,3,2,0,4,7,57.1,3,3,0,3,4,12,0
1659,Federico Mattiello,0,0,0,0,0,0,0,,0,0,0,0,0,0,0
1660,Neal Maupay,20,8,9,7,4,4,24,16.7,20,20,0,20,13,6,0
1661,Tony Mauricio,19,12,7,8,4,11,17,64.7,6,8,1,7,3,4,0
1662,Stephy Mavididi,18,5,7,10,1,8,23,34.8,15,12,0,12,14,6,0
1663,Konstantinos Mavropanos,42,29,29,12,1,27,46,58.7,19,25,10,15,59,66,1
1664,Eric Maxim Choupo-Moting,8,2,0,5,3,1,4,25.0,3,6,0,6,2,7,0
1665,Borja Mayoral,3,2,0,0,3,1,10,10.0,9,5,0,5,0,5,2
1666,Borja Mayoral,0,0,0,0,0,0,1,0.0,1,0,0,0,0,0,0
1667,Youssef Maziz,2,0,1,1,0,1,5,20.0,4,1,0,1,6,1,0
1668,Antonio Mazzotta,1,1,0,1,0,0,0,,0,0,0,0,0,1,0
1669,Kevin Mbabu,51,33,27,17,7,24,35,68.6,11,28,7,21,22,59,1
1670,Kylian Mbappé,4,2,0,1,3,2,9,22.2,7,7,1,6,3,4,1
1671,Ibrahima Mbaye,6,5,5,1,0,3,5,60.0,2,5,3,2,1,10,0
1672,Jean-Manuel Mbom,19,13,14,3,2,8,27,29.6,19,17,6,11,13,27,0
1673,Nathanael Mbuku,33,19,9,13,11,8,28,28.6,20,17,0,17,14,10,0
1674,James McArthur,57,32,25,27,5,15,39,38.5,24,28,3,25,23,31,0
1675,Oliver McBurnie,15,7,7,7,1,5,17,29.4,12,10,3,7,6,30,0
1676,Alex McCarthy,1,0,1,0,0,1,4,25.0,3,0,0,0,0,11,1
1677,James McCarthy,16,12,9,7,0,8,21,38.1,13,15,7,8,8,12,0
1678,John McGinn,61,37,23,31,7,27,84,32.1,57,38,6,32,43,23,2
1679,David McGoldrick,33,21,8,15,10,13,31,41.9,18,19,3,16,2,25,0
1680,Weston McKennie,34,19,9,20,5,12,33,36.4,21,21,3,18,28,26,0
1681,Dwight McNeil,47,24,24,18,5,18,56,32.1,38,44,6,38,32,32,1
1682,Scott McTominay,51,24,23,25,3,23,36,63.9,13,35,10,25,29,46,0
1683,Gary Medel,12,9,6,5,1,4,10,40.0,6,8,6,2,7,10,0
1684,Facundo Medina,39,22,22,15,2,24,38,63.2,14,25,9,16,39,51,3
1685,Nathan de Medina,16,10,9,6,1,3,10,30.0,7,12,2,10,11,22,0
1686,Ben Mee,32,15,16,14,2,14,29,48.3,15,54,45,9,43,148,2
1687,Joshua Mees,0,0,0,0,0,0,0,,0,0,0,0,0,0,0
1688,Admir Mehmedi,17,9,6,7,4,6,16,37.5,10,7,0,7,5,1,0
1689,Soualiho Meïté,11,7,6,4,1,5,16,31.3,11,18,1,17,10,9,1
1690,Soualiho Meïté,18,10,10,6,2,8,17,47.1,9,9,2,7,8,16,0
1691,Hannibal Mejbri,0,0,0,0,0,0,0,,0,0,0,0,0,0,0
1692,Farid El Melali,9,5,5,4,0,2,13,15.4,11,12,0,12,6,2,0
1693,Filippo Melegoni,7,6,2,5,0,3,6,50.0,3,5,0,5,5,8,0
1694,Gonzalo Melero,24,15,11,6,7,10,39,25.6,29,14,5,9,18,22,1
1695,Birger Meling,49,31,27,15,7,33,50,66.0,17,43,9,34,36,70,0
1696,Arthur Melo,17,9,7,10,0,12,31,38.7,19,6,1,5,18,9,1
1697,Memphis,4,3,0,3,1,1,20,5.0,19,11,1,10,5,3,0
1698,Houboulang Mendes,28,19,19,5,4,16,28,57.1,12,14,2,12,14,35,0
1699,Pedro Mendes,21,19,16,5,0,14,21,66.7,7,23,13,10,34,58,0
1700,Thiago Mendes,37,22,13,20,4,18,38,47.4,20,33,7,26,39,21,2
1701,Brais Méndez,59,31,23,27,9,16,65,24.6,49,27,2,25,32,34,0
1702,Édgar Méndez,39,29,18,13,8,15,48,31.3,33,20,3,17,19,14,0
1703,Eñaut Mendía,2,1,2,0,0,1,2,50.0,1,1,1,0,0,0,0
1704,Batista Mendy,1,1,0,1,0,0,1,0.0,1,3,1,2,1,1,0
1705,Benjamin Mendy,13,9,1,8,4,5,21,23.8,16,12,5,7,5,14,1
1706,Edouard Mendy,0,0,0,0,0,0,1,0.0,1,0,0,0,1,9,3
1707,Edouard Mendy,0,0,0,0,0,0,0,,0,0,0,0,0,0,0
1708,Ferland Mendy,26,16,17,6,3,12,24,50.0,12,16,4,12,26,32,1
1709,Nampalys Mendy,26,17,18,6,2,7,20,35.0,13,12,1,11,14,8,0
1710,Hamza Mendyl,2,2,2,0,0,0,2,0.0,2,2,0,2,0,2,0
1711,Levent Mercan,0,0,0,0,0,0,0,,0,0,0,0,0,0,0
1712,Jorge Meré,13,6,9,3,1,6,13,46.2,7,14,11,3,15,63,0
1713,Alex Meret,0,0,0,0,0,0,1,0.0,1,0,0,0,0,5,0
1714,Mikel Merino,61,36,14,36,11,18,45,40.0,27,36,8,28,32,26,0
1715,Martín Merquelanz,9,3,3,2,4,2,7,28.6,5,7,1,6,3,4,0
1716,Yıldırım Mert Çetin,8,4,3,5,0,2,6,33.3,4,7,5,2,14,11,1
1717,Dries Mertens,16,14,4,7,5,5,25,20.0,20,7,1,6,9,3,1
1718,Roque Mesa,46,29,18,24,4,20,47,42.6,27,11,2,9,14,23,1
1719,Illan Meslier,0,0,0,0,0,0,1,0.0,1,0,0,0,0,17,8
1720,Lionel Messi,18,10,3,9,6,6,17,35.3,11,12,0,12,6,0,2
1721,Junior Messias,60,35,26,24,10,22,70,31.4,48,32,12,20,35,40,0
1722,Thomas Meunier,30,21,19,6,5,20,29,69.0,9,16,6,10,18,29,2
1723,Mexer,9,6,8,0,1,5,10,50.0,5,8,5,3,17,22,0
1724,Max Meyer,7,4,3,3,1,4,8,50.0,4,4,1,3,3,1,0
1725,Omenuke Mfulu,18,12,10,8,0,5,15,33.3,10,7,1,6,11,18,0
1726,Míchel,18,11,10,3,5,5,22,22.7,17,10,1,9,9,12,1
1727,Jonas Michelbrink,0,0,0,0,0,0,0,,0,0,0,0,0,0,0
1728,Clément Michelin,25,19,13,9,3,9,16,56.3,7,13,4,9,25,32,0
1729,Edouard Michut,0,0,0,0,0,0,0,,0,0,0,0,0,0,0
1730,Petar Mićin,0,0,0,0,0,0,0,,0,0,0,0,0,0,0
1731,Florian Miguel,14,13,12,2,0,9,17,52.9,8,21,13,8,45,66,1
1732,Valentin Mihaila,2,1,1,1,0,0,10,0.0,10,8,1,7,5,8,0
1733,Nikola Milenković,49,29,33,14,2,21,33,63.6,12,42,33,9,44,122,1
1734,Arkadiusz Milik,14,9,0,7,7,2,12,16.7,10,5,1,4,2,9,0
1735,Sergej Milinković-Savić,59,40,20,30,9,27,84,32.1,57,52,12,40,33,47,0
1736,Vanja Milinković-Savić,1,1,1,0,0,1,1,100.0,0,0,0,0,0,1,3
1737,Éder Militão,20,8,13,6,1,8,14,57.1,6,19,6,13,19,42,0
1738,Luka Milivojević,65,34,25,31,9,42,77,54.5,35,29,6,23,35,47,2
1739,Luis Milla,22,11,11,10,1,6,28,21.4,22,10,0,10,24,16,1
1740,Pere Milla,24,17,12,10,2,8,37,21.6,29,17,5,12,13,17,1
1741,Álex Millán,0,0,0,0,0,0,0,,0,0,0,0,0,0,0
1742,Vincenzo Millico,0,0,0,0,0,0,0,,0,0,0,0,0,0,0
1743,Enzo Millot,2,0,0,1,1,1,1,100.0,0,0,0,0,2,0,0
1744,James Milner,26,19,9,14,3,11,33,33.3,22,30,3,27,14,16,1
1745,Santi Mina,31,13,9,12,10,6,37,16.2,31,15,3,12,6,17,0
1746,Yerry Mina,21,14,17,4,0,8,12,66.7,4,30,23,7,24,110,1
1747,Takumi Minamino,7,3,2,5,0,2,19,10.5,17,13,1,12,4,9,0
1748,Takumi Minamino,4,3,1,2,1,0,12,0.0,12,1,0,1,2,3,0
1749,Tyrone Mings,32,16,23,7,2,16,24,66.7,8,59,40,19,41,172,3
1750,Óscar Mingueza,52,33,28,17,7,30,53,56.6,23,19,6,13,20,48,2
1751,Rafa Mir,15,9,4,4,7,7,22,31.8,15,14,2,12,15,25,0
1752,Jorge Miramón,32,22,26,6,0,21,35,60.0,14,22,2,20,27,54,0
1753,Aleksei Miranchuk,24,13,8,9,7,6,9,66.7,3,1,0,1,3,1,0
1754,Juan Miranda,27,11,16,9,2,16,32,50.0,16,18,2,16,29,58,1
1755,Antonio Mirante,0,0,0,0,0,0,1,0.0,1,1,0,1,0,7,2
1756,Tyrick Mitchell,64,35,48,9,7,23,40,57.5,17,29,10,19,21,62,1
1757,Aleksandar Mitrović,7,4,0,3,4,2,8,25.0,6,12,3,9,3,8,0
1758,Stefan Mitrović,36,27,29,7,0,24,37,64.9,13,23,13,10,31,108,5
1759,Maximilian Mittelstädt,66,39,42,21,3,35,72,48.6,37,34,5,29,55,61,1
1760,Henrikh Mkhitaryan,58,24,13,27,18,13,62,21.0,49,34,0,34,39,10,0
1761,Jakub Moder,15,7,5,7,3,7,20,35.0,13,12,1,11,3,9,0
1762,Anthony Modeste,2,1,0,2,0,1,4,25.0,3,3,1,2,0,3,0
1763,Anthony Modeste,2,0,0,2,0,0,1,0.0,1,0,0,0,0,2,0
1764,Luka Modrić,37,23,18,16,3,13,36,36.1,23,14,2,12,48,14,1
1765,Terem Moffi,13,8,0,8,5,4,19,21.1,15,5,2,3,4,8,0
1766,Kevin Möhwald,15,9,9,5,1,4,18,22.2,14,10,3,7,32,19,2
1767,Niklas Moisander,14,11,11,3,0,8,14,57.1,6,15,8,7,22,61,0
1768,Dion Moise Sahi,1,0,0,1,0,1,1,100.0,0,1,0,1,0,0,0
1769,Johan Mojica,4,4,3,1,0,2,3,66.7,1,3,0,3,7,6,0
1770,Johan Mojica,21,10,15,5,1,8,18,44.4,10,15,4,11,15,27,0
1771,Guillem Molina,1,0,1,0,0,0,5,0.0,5,1,1,0,4,5,0
1772,Jorge Molina,11,4,3,5,3,8,22,36.4,14,5,1,4,3,19,0
1773,Nahuel Molina,27,18,13,10,4,16,42,38.1,26,26,4,22,21,49,1
1774,Salvatore Molina,39,22,18,14,7,29,45,64.4,16,30,8,22,17,41,0
1775,Victor Mollejo,2,1,1,0,1,0,1,0.0,1,0,0,0,0,0,0
1776,Florent Mollet,20,15,7,11,2,12,47,25.5,35,18,4,14,32,9,1
1777,Jayson Molumby,0,0,0,0,0,0,0,,0,0,0,0,0,0,0
1778,Alkhaly Momo Cissé,1,1,1,0,0,0,0,,0,1,0,1,0,0,0
1779,Jon Moncayola,61,36,27,23,11,24,67,35.8,43,27,9,18,23,38,0
1780,Gabriele Moncini,2,1,2,0,0,0,1,0.0,1,2,0,2,2,4,0
1781,Thomas Monconduit,28,15,9,16,3,15,41,36.6,26,10,3,7,13,21,1
1782,Kévin Monnet-Paquet,11,7,7,2,2,5,10,50.0,5,5,0,5,6,7,0
1783,Nacho Monreal,31,19,17,11,3,7,20,35.0,13,14,3,11,31,43,0
1784,Cristóbal Montiel,0,0,0,0,0,0,1,0.0,1,0,0,0,0,0,0
1785,Lorenzo Montipò,0,0,0,0,0,0,0,,0,1,0,1,0,16,3
1786,Ángel Montoro,15,9,7,7,1,4,16,25.0,12,13,3,10,22,21,0
1787,Martín Montoya,6,3,2,2,2,1,3,33.3,2,1,1,0,2,6,0
1788,Emre Mor,8,4,1,3,4,0,3,0.0,3,5,0,5,5,0,0
1789,Luca Mora,3,1,1,2,0,2,4,50.0,2,2,1,1,0,2,0
1790,Wesley Moraes,0,0,0,0,0,0,1,0.0,1,0,0,0,0,0,0
1791,Álvaro Morata,17,12,2,10,5,4,28,14.3,24,22,2,20,5,21,0
1792,Jan Morávek,5,3,4,1,0,1,8,12.5,7,3,0,3,7,2,0
1793,Jon Morcillo,16,9,3,6,7,7,30,23.3,23,9,0,9,15,11,0
1794,Jérémy Morel,31,19,21,10,0,20,39,51.3,19,26,11,15,44,81,1
1795,Alberto Moreno,7,4,7,0,0,2,5,40.0,3,2,1,1,3,2,0
1796,Álex Moreno,42,26,25,12,5,20,43,46.5,23,18,4,14,35,48,0
1797,Gerard Moreno,24,15,8,10,6,7,34,20.6,27,17,4,13,15,26,0
1798,Tete Morente,31,17,17,9,5,9,39,23.1,30,20,0,20,13,28,0
1799,Mateu Morey,13,7,4,7,2,9,12,75.0,3,6,1,5,18,7,1
1800,Wes Morgan,0,0,0,0,0,0,0,,0,0,0,0,0,1,0
1801,Ilaix Moriba,14,6,5,7,2,5,10,50.0,5,16,1,15,5,4,1
1802,Raúl Moro,0,0,0,0,0,0,1,0.0,1,0,0,0,0,0,0
1803,Loren Morón,11,7,2,6,3,1,16,6.3,15,11,0,11,3,14,0
1804,Pedro Mosquera,38,18,19,18,1,13,53,24.5,40,23,6,17,31,38,1
1805,Aimen Moueffek,25,15,16,6,3,13,32,40.6,19,17,2,15,9,18,0
1806,Youssoufa Moukoko,3,2,1,1,1,0,0,,0,3,0,3,0,2,0
1807,Harold Moukoudi,46,27,37,8,1,28,38,73.7,10,24,10,14,42,78,1
1808,Jessy Moulin,2,1,2,0,0,2,3,66.7,1,0,0,0,2,9,2
1809,Steve Mounié,15,11,3,11,1,3,28,10.7,25,18,3,15,12,40,0
1810,Mason Mount,75,35,22,38,15,25,69,36.2,44,40,2,38,31,14,0
1811,Lucas Moura,32,16,12,16,4,8,29,27.6,21,12,0,12,18,10,0
1812,Lys Mousset,1,0,0,0,1,0,2,0.0,2,1,0,1,0,1,1
1813,João Moutinho,75,40,34,35,6,35,91,38.5,56,18,3,15,47,28,0
1814,Samuel Moutoussamy,0,0,0,0,0,0,1,0.0,1,1,0,1,0,0,0
1815,Loris Mouyokolo,1,1,1,0,0,1,1,100.0,0,1,1,0,0,1,0
1816,Javi Moyano,0,0,0,0,0,0,0,,0,2,0,2,0,2,0
1817,Nordi Mukiele,44,30,14,28,2,21,37,56.8,16,33,1,32,23,33,2
1818,Mert Müldür,43,20,26,9,8,27,53,50.9,26,17,1,16,36,41,0
1819,Florian Müller,0,0,0,0,0,0,3,0.0,3,1,0,1,2,10,1
1820,Sebastian Müller,0,0,0,0,0,0,0,,0,0,0,0,0,0,0
1821,Thomas Müller,49,22,11,23,15,24,73,32.9,49,43,3,40,21,18,1
1822,Joel Mumbongo,0,0,0,0,0,0,0,,0,1,0,1,0,0,0
1823,Marshall Munetsi,35,19,19,14,2,21,41,51.2,20,33,25,8,57,85,3
1824,Iker Muniain,20,7,4,10,6,6,24,25.0,18,15,0,15,11,4,0
1825,Aihen Muñoz,23,16,15,5,3,11,19,57.9,8,12,2,10,10,31,0
1826,Joaquín Muñoz,0,0,0,0,0,0,2,0.0,2,0,0,0,1,0,0
1827,Luis Muriel,20,9,4,8,8,9,26,34.6,17,17,0,17,7,4,0
1828,Jeison Murillo,45,21,35,9,1,24,44,54.5,20,29,17,12,36,100,2
1829,Vedat Muriqi,3,1,0,2,1,0,8,0.0,8,9,2,7,3,20,0
1830,Jacob Murphy,39,24,25,12,2,24,49,49.0,25,27,3,24,14,29,0
1831,Nicola Murru,9,6,1,5,3,3,5,60.0,2,11,1,10,12,24,0
1832,Petar Musa,12,8,3,6,3,4,8,50.0,4,10,0,10,4,5,0
1833,Mateo Musacchio,1,1,1,0,0,0,0,,0,5,2,3,2,5,0
1834,Mateo Musacchio,2,1,2,0,0,2,3,66.7,1,1,0,1,3,0,0
1835,Yunus Musah,21,18,12,3,6,8,24,33.3,16,20,0,20,15,12,1
1836,Jamal Musiala,20,12,5,7,8,7,22,31.8,15,17,2,15,14,3,0
1837,Juan Musso,1,1,1,0,0,1,1,100.0,0,0,0,0,1,8,1
1838,Shkodran Mustafi,1,1,1,0,0,1,1,100.0,0,1,0,1,0,3,0
1839,Shkodran Mustafi,16,5,15,1,0,3,12,25.0,9,20,15,5,32,76,1
1840,Yoshinori Mutō,12,7,1,4,7,3,8,37.5,5,5,0,5,3,2,0
1841,Phillipp Mwene,36,23,21,11,4,19,38,50.0,19,26,3,23,24,33,0
1842,Joakim Mæhle,18,10,7,5,6,8,19,42.1,11,17,2,15,11,5,0
1843,Obite N'Dicka,31,23,16,15,0,16,28,57.1,12,27,6,21,47,85,0
1844,Kévin N'Doram,3,2,0,3,0,1,3,33.3,2,0,0,0,6,2,0
1845,Stanley N'Soki,27,19,15,9,3,13,22,59.1,9,17,4,13,26,38,2
1846,Nacho,43,21,29,10,4,24,52,46.2,28,21,1,20,29,47,0
1847,Nacho,27,14,13,11,3,12,35,34.3,23,19,9,10,40,58,0
1848,Yuto Nagatomo,23,16,12,8,3,9,18,50.0,9,14,3,11,29,43,0
1849,Kenny Nagera,0,0,0,0,0,0,0,,0,0,0,0,0,0,0
1850,Radja Nainggolan,41,26,22,14,5,19,34,55.9,15,18,0,18,15,15,1
1851,Radja Nainggolan,0,0,0,0,0,0,0,,0,0,0,0,1,0,0
1852,Marvelous Nakamba,22,14,10,11,1,7,12,58.3,5,16,5,11,17,9,1
1853,Nahitan Nández,56,28,23,23,10,25,68,36.8,43,26,4,22,23,49,0
1854,Nano,0,0,0,0,0,0,0,,0,0,0,0,0,0,0
1855,Paul Nardi,0,0,0,0,0,0,1,0.0,1,1,0,1,0,15,2
1856,Matija Nastasić,11,7,9,2,0,9,16,56.3,7,22,18,4,26,51,1
1857,Roberto Navarro,1,1,1,0,0,0,2,0.0,2,0,0,0,1,0,0
1858,Ximo Navarro,54,30,36,17,1,14,30,46.7,16,14,4,10,47,75,3
1859,Jesús Navas,27,21,15,11,1,15,22,68.2,7,10,3,7,37,62,1
1860,Keylor Navas,0,0,0,0,0,0,0,,0,0,0,0,0,10,0
1861,Raúl Navas,6,3,5,1,0,4,6,66.7,2,0,0,0,3,13,0
1862,Papa Ndiaga Yade,15,8,9,2,4,7,20,35.0,13,9,0,9,4,6,0
1863,Iliman Ndiaye,1,1,0,1,0,1,1,100.0,0,0,0,0,0,0,0
1864,Wilfred Ndidi,96,63,45,44,7,26,66,39.4,40,38,11,27,61,55,0
1865,Bridge Ndilu,0,0,0,0,0,0,2,0.0,2,2,0,2,0,0,0
1866,Tanguy Ndombele,41,20,11,21,9,18,44,40.9,26,28,4,24,19,15,0
1867,Dan Ndoye,7,6,3,4,0,1,8,12.5,7,4,0,4,7,4,0
1868,Paul Nebel,1,1,0,1,0,0,1,0.0,1,0,0,0,2,0,0
1869,Álvaro Negredo,11,5,3,4,4,5,11,45.5,6,7,2,5,3,19,0
1870,Reiss Nelson,1,0,0,0,1,0,0,,0,0,0,0,1,1,0
1871,Ilija Nestorovski,6,4,2,3,1,2,13,15.4,11,5,0,5,1,7,0
1872,Neto,0,0,0,0,0,0,1,0.0,1,0,0,0,0,3,1
1873,Pedro Neto,16,9,4,6,6,6,28,21.4,22,18,2,16,31,8,0
1874,Luca Netz,14,8,12,2,0,6,17,35.3,11,3,0,3,6,8,0
1875,Manuel Neuer,0,0,0,0,0,0,1,0.0,1,0,0,0,2,12,3
1876,Florian Neuhaus,48,28,19,26,3,19,63,30.2,44,35,7,28,50,20,1
1877,Carlos Neva,12,6,6,6,0,6,11,54.5,5,16,4,12,27,58,0
1878,Rúben Neves,86,46,42,38,6,36,88,40.9,52,55,11,44,65,46,2
1879,Neymar,14,11,1,6,7,8,37,21.6,29,8,0,8,9,0,0
1880,Yvan Neyou,58,31,24,33,1,25,60,41.7,35,34,5,29,31,13,1
1881,Jessic Ngankam,5,2,1,2,2,1,3,33.3,2,6,1,5,0,1,0
1882,Muzinga Ngonda,59,40,37,21,1,30,50,60.0,20,28,3,25,72,58,0
1883,Ahmad Ngouyamsa,6,4,5,1,0,4,8,50.0,4,2,1,1,2,8,0
1884,Opa Nguette,15,8,2,8,5,3,10,30.0,7,14,2,12,1,1,0
1885,Moussa Niakhate,42,22,28,13,1,14,29,48.3,15,31,15,16,49,79,0
1886,Ibrahima Niane,1,1,0,0,1,1,2,50.0,1,3,0,3,0,8,0
1887,M'Baye Niang,3,2,2,1,0,0,0,,0,2,0,2,1,2,0
1888,Mamor Niang,1,1,0,1,0,0,0,,0,1,0,1,0,0,0
1889,Tanguy Nianzou,3,1,3,0,0,1,1,100.0,0,0,0,0,3,1,0
1890,Florian Niederlechner,7,5,1,4,2,0,10,0.0,10,8,3,5,10,18,0
1891,Nieto,1,1,0,1,0,0,0,,0,0,0,0,0,1,0
1892,Saúl Ñíguez,57,34,27,23,7,30,59,50.8,29,35,2,33,19,43,0
1893,Joakim Nilsson,36,24,23,12,1,14,23,60.9,9,29,22,7,39,111,0
1894,Casimir Ninga,0,0,0,0,0,0,0,,0,0,0,0,0,1,0
1895,Nino,0,0,0,0,0,0,1,0.0,1,1,0,1,0,0,0
1896,Fernando Niño,8,3,0,4,4,2,9,22.2,7,1,0,1,2,2,0
1897,Eddie Nketiah,3,1,0,2,1,0,2,0.0,2,6,0,6,0,5,0
1898,Nicolas Nkoulou,14,9,11,3,0,7,12,58.3,5,28,14,14,33,71,1
1899,Niels Nkounkou,4,3,1,2,1,3,8,37.5,5,4,0,4,0,4,0
1900,Christopher Nkunku,16,11,3,7,6,8,18,44.4,10,27,1,26,9,14,0
1901,Dan Nlundulu,0,0,0,0,0,0,1,0.0,1,2,0,2,0,2,0
1902,Mark Noble,8,4,2,5,1,4,14,28.6,10,7,3,4,13,3,0
1903,Nolito,70,36,30,30,10,32,92,34.8,60,46,2,44,22,19,0
1904,Arnaud Nordin,14,8,5,5,4,6,21,28.6,15,13,2,11,9,10,0
1905,Håvard Nordtveit,6,2,5,1,0,6,8,75.0,2,4,2,2,13,42,0
1906,Will Norris,0,0,0,0,0,0,0,,0,0,0,0,0,0,0
1907,Oliver Norwood,49,22,16,28,5,21,72,29.2,51,29,12,17,36,51,1
1908,Olivier Ntcham,1,0,0,1,0,1,3,33.3,2,3,1,2,2,3,0
1909,Alexander Nübel,0,0,0,0,0,0,0,,0,0,0,0,0,1,0
1910,Kasim Nuhu,13,7,9,4,0,6,10,60.0,4,8,3,5,15,38,0
1911,Unai Núñez,23,12,16,7,0,10,15,66.7,5,19,14,5,32,110,0
1912,Bram Nuytinck,21,15,10,9,2,13,20,65.0,7,30,17,13,25,77,0
1913,Kelechi Nwakali,4,3,1,2,1,0,4,0.0,4,1,0,1,1,1,0
1914,Simeon Nwankwo,9,2,2,6,1,3,22,13.6,19,21,5,16,6,51,0
1915,Gerzino Nyamsi,12,10,2,8,2,4,6,66.7,2,8,5,3,10,32,1
1916,Allan Nyom,38,23,14,19,5,15,30,50.0,15,16,2,14,22,42,0
1917,M'Bala Nzola,12,5,2,6,4,4,7,57.1,3,15,1,14,3,20,0
1918,Steven Nzonzi,34,16,15,16,3,12,31,38.7,19,24,10,14,16,26,0
1919,Jack O'Connell,3,1,1,1,1,0,1,0.0,1,4,3,1,2,7,0
1920,Dara O'Shea,45,25,30,13,2,21,45,46.7,24,32,17,15,45,108,0
1921,Michael Obafemi,1,0,0,1,0,0,1,0.0,1,1,0,1,0,0,0
1922,Pedro Obiang,35,22,17,15,3,12,35,34.3,23,26,7,19,22,27,0
1923,Jan Oblak,0,0,0,0,0,0,0,,0,0,0,0,0,6,2
1924,Lucas Ocampos,36,24,12,16,8,13,37,35.1,24,33,1,32,19,30,1
1925,Bastian Oczipka,33,20,22,10,1,7,21,33.3,14,22,4,18,24,41,0
1926,Brian Oddei,2,1,1,1,0,2,3,66.7,1,1,0,1,0,1,0
1927,Denis Odoi,3,3,2,1,0,1,4,25.0,3,3,1,2,5,5,0
1928,Álvaro Odriozola,14,7,5,8,1,3,5,60.0,2,6,3,3,6,12,1
1929,Angelo Ogbonna,26,13,20,5,1,9,17,52.9,8,25,11,14,30,119,0
1930,Stefano Okaka,10,7,2,5,3,2,10,20.0,8,7,1,6,2,19,0
1931,Shinji Okazaki,7,5,5,0,2,0,5,0.0,5,5,0,5,4,6,0
1932,Masaya Okugawa,17,8,5,11,1,6,14,42.9,8,17,2,15,8,5,0
1933,Lucas Olaza,20,9,11,7,2,9,17,52.9,8,15,7,8,15,38,0
1934,Lucas Olaza,25,16,12,12,1,10,18,55.6,8,15,1,14,24,34,0
1935,Christian Oliva,10,4,6,3,1,6,17,35.3,11,11,1,10,8,7,0
1936,Christian Oliva,2,0,1,1,0,1,6,16.7,5,1,0,1,6,0,0
1937,Kiko Olivas,3,2,2,1,0,3,5,60.0,2,2,2,0,7,3,0
1938,Paulo Oliveira,42,21,32,8,2,19,36,52.8,17,39,14,25,59,112,0
1939,Mathías Olivera,61,33,31,21,9,32,56,57.1,24,33,3,30,31,55,0
1940,Maximiliano Olivera,2,0,1,1,0,1,1,100.0,0,3,1,2,0,8,0
1941,Dani Olmo,23,14,6,13,4,4,23,17.4,19,15,0,15,13,21,0
1942,Robin Olsen,0,0,0,0,0,0,0,,0,0,0,0,0,4,1
1943,Jonas Omlin,1,1,1,0,0,1,4,25.0,3,0,0,0,0,9,1
1944,Jérôme Onguéné,2,1,2,0,0,2,7,28.6,5,2,0,2,2,8,0
1945,Karim Onisiwo,31,20,7,15,9,14,23,60.9,9,20,1,19,5,12,0
1946,Josh Onomah,11,8,1,6,4,0,5,0.0,5,4,2,2,2,1,0
1947,Javier Ontiveros,21,14,10,10,1,9,26,34.6,17,12,0,12,9,6,0
1948,Henry Onyekuru,1,0,1,0,0,1,4,25.0,3,1,0,1,0,0,0
1949,Willi Orban,40,26,19,15,6,23,37,62.2,14,29,20,9,40,74,0
1950,Fabián Orellana,33,19,12,14,7,12,55,21.8,43,18,0,18,15,9,0
1951,Divock Origi,3,2,0,2,1,1,3,33.3,2,5,1,4,1,2,0
1952,Riccardo Orsolini,37,18,13,12,12,16,39,41.0,23,22,3,19,10,22,0
1953,Stefan Ortega,2,1,2,0,0,2,6,33.3,4,0,0,0,0,12,3
1954,Yuya Osako,12,8,2,5,5,2,9,22.2,7,6,1,5,5,7,0
1955,Ben Osborn,33,18,15,10,8,13,40,32.5,27,20,3,17,12,17,0
1956,Victor Osimhen,22,15,2,6,14,3,15,20.0,12,6,0,6,7,10,0
1957,Yordan Osorio,22,14,13,9,0,9,24,37.5,15,30,18,12,53,77,1
1958,David Ospina,0,0,0,0,0,0,0,,0,0,0,0,0,4,0
1959,Owen Otasowie,5,5,3,2,0,1,2,50.0,1,1,1,0,3,4,0
1960,Otávio,54,31,33,19,2,26,55,47.3,29,20,5,15,26,36,0
1961,Paulo Otávio,60,40,32,22,6,34,62,54.8,28,51,7,44,42,59,0
1962,Remi Oudin,34,16,22,7,5,15,36,41.7,21,22,2,20,51,40,1
1963,Alexandre Oukidja,0,0,0,0,0,0,1,0.0,1,1,0,1,0,17,3
1964,Zinédine Ould Khaled,0,0,0,0,0,0,0,,0,0,0,0,1,0,0
1965,Adam Ounas,9,4,4,4,1,0,7,0.0,7,12,1,11,3,4,0
1966,Adam Ounas,3,2,3,0,0,0,11,0.0,11,5,0,5,3,0,0
1967,Thomas Ouwejan,4,1,0,3,1,2,9,22.2,7,4,0,4,5,6,0
1968,Reece Oxford,26,18,15,11,0,10,17,58.8,7,28,22,6,29,89,0
1969,Alex Oxlade-Chamberlain,4,0,0,3,1,0,2,0.0,2,1,0,1,2,0,0
1970,Mikel Oyarzabal,30,17,14,12,4,10,31,32.3,21,30,5,25,15,17,0
1971,Ambroise Oyongo,13,6,10,3,0,9,15,60.0,6,3,2,1,8,26,1
1972,Salih Özcan,21,13,11,10,0,12,33,36.4,21,11,2,9,20,14,1
1973,Levin Öztunalı,24,18,14,8,2,8,17,47.1,9,15,0,15,15,16,0
1974,Pablo,17,11,13,4,0,8,14,57.1,6,17,12,5,25,46,1
1975,Fernando Pacheco,2,0,2,0,0,2,4,50.0,2,0,0,0,2,19,0
1976,Jon Pacheco,0,0,0,0,0,0,0,,0,0,0,0,1,0,0
1977,Gonçalo Paciência,8,3,4,1,3,4,16,25.0,12,4,1,3,1,3,0
1978,Daniele Padelli,0,0,0,0,0,0,0,,0,0,0,0,0,0,0
1979,Mattia Pagliuca,0,0,0,0,0,0,0,,0,0,0,0,1,0,0
1980,Vincent Pajot,35,20,19,11,5,10,18,55.6,8,9,2,7,42,11,0
1981,Rodrigo Palacio,13,6,2,3,8,1,15,6.7,14,18,0,18,7,29,0
1982,Exequiel Palacios,31,17,12,16,3,17,30,56.7,13,13,0,13,12,7,0
1983,Helibelton Palacios,20,10,16,3,1,8,13,61.5,5,9,1,8,5,21,0
1984,Ante Palaversa,0,0,0,0,0,0,1,0.0,1,0,0,0,0,0,0
1985,Alberto Paleari,0,0,0,0,0,0,0,,0,0,0,0,0,1,0
1986,Nicolas Pallois,58,36,42,14,2,38,72,52.8,34,44,20,24,37,155,1
1987,Emerson Palmieri,3,3,2,0,1,1,3,33.3,2,0,0,0,1,6,0
1988,Antonio Palumbo,0,0,0,0,0,0,1,0.0,1,0,0,0,0,0,0
1989,Martin Palumbo,0,0,0,0,0,0,0,,0,5,0,5,1,0,0
1990,Goran Pandev,9,5,1,6,2,4,10,40.0,6,6,0,6,2,7,1
1991,Ivor Pandur,0,0,0,0,0,0,0,,0,0,0,0,0,0,0
1992,Jonathan Panzo,17,12,13,4,0,8,11,72.7,3,27,13,14,59,91,2
1993,Matondo-Merveille Papela,0,0,0,0,0,0,1,0.0,1,0,0,0,0,0,0
1994,Lucas Paquetá,70,36,30,28,12,23,66,34.8,43,28,3,25,20,16,1
1995,Gaëtan Paquiez,21,12,12,7,2,12,29,41.4,17,10,3,7,16,28,0
1996,Rubén Pardo,0,0,0,0,0,0,0,,0,0,0,0,1,0,0
1997,Leandro Paredes,30,18,12,15,3,19,39,48.7,20,17,5,12,17,13,1
1998,Daniel Parejo,65,40,32,23,10,33,81,40.7,48,35,8,27,45,21,3
1999,Vittorio Parigini,5,2,4,0,1,0,1,0.0,1,0,0,0,0,0,0
2000,Marco Parolo,21,8,8,11,2,8,20,40.0,12,20,6,14,14,31,0
2001,Thomas Partey,44,21,16,24,4,24,56,42.9,32,17,5,12,23,18,0
2002,Thomas Partey,7,4,4,3,0,5,8,62.5,3,4,1,3,2,1,0
2003,Mario Pašalić,26,15,5,17,4,12,19,63.2,7,12,1,11,8,6,0
2004,Felix Passlack,9,6,4,2,3,4,8,50.0,4,11,1,10,3,2,0
2005,Christian Pastina,0,0,0,0,0,0,1,0.0,1,1,0,1,1,8,0
2006,Javier Pastore,2,2,2,0,0,2,2,100.0,0,0,0,0,0,0,0
2007,Patric,30,16,15,11,4,13,24,54.2,11,13,3,10,18,51,1
2008,Rui Patrício,0,0,0,0,0,0,1,0.0,1,0,0,0,1,3,3
2009,Paulinho,0,0,0,0,0,0,0,,0,0,0,0,0,0,0
2010,Gabriel Paulista,17,11,9,5,3,6,17,35.3,11,32,27,5,59,132,3
2011,Benjamin Pavard,44,27,20,16,8,23,40,57.5,17,29,5,24,48,31,1
2012,Jiří Pavlenka,2,0,2,0,0,2,2,100.0,0,0,0,0,1,17,4
2013,Vasileios Pavlidis,0,0,0,0,0,0,0,,0,0,0,0,0,0,0
2014,Mateo Pavlović,11,6,8,3,0,8,23,34.8,15,13,11,2,21,40,0
2015,Strahinja Pavlović,0,0,0,0,0,0,0,,0,0,0,0,0,0,0
2016,Leonardo Pavoletti,7,3,2,5,0,1,20,5.0,19,4,2,2,4,32,0
2017,Dimitri Payet,27,17,4,16,7,17,40,42.5,23,19,2,17,8,10,0
2018,Nehuén Paz,9,4,4,5,0,6,7,85.7,1,4,2,2,11,16,0
2019,Bailey Peacock-Farrell,0,0,0,0,0,0,0,,0,0,0,0,0,0,0
2020,Mads Pedersen,25,16,20,3,2,10,22,45.5,12,13,3,10,15,32,0
2021,Alfonso Pedraza,35,19,16,11,8,11,31,35.5,20,21,5,16,34,47,1
2022,Pedri,44,27,16,16,12,17,71,23.9,54,46,1,45,33,7,0
2023,Pedro,22,14,6,11,5,7,35,20.0,28,10,0,10,9,2,1
2024,João Pedro,13,6,2,6,5,2,27,7.4,25,32,6,26,13,28,0
2025,Gianluca Pegolo,0,0,0,0,0,0,0,,0,0,0,0,0,1,0
2026,Peter Pekarík,24,18,17,7,0,17,31,54.8,14,19,8,11,27,41,0
2027,Yohann Pelé,0,0,0,0,0,0,0,,0,0,0,0,0,0,0
2028,Graziano Pellè,2,2,0,1,1,1,8,12.5,7,3,0,3,2,8,0
2029,Pietro Pellegri,2,1,0,2,0,0,0,,0,1,0,1,0,0,0
2030,Lorenzo Pellegrini,40,24,13,20,7,21,60,35.0,39,37,2,35,42,23,1
2031,Luca Pellegrini,9,6,6,2,1,4,10,40.0,6,11,2,9,8,13,1
2032,Facundo Pellistri,8,5,2,4,2,3,13,23.1,10,0,0,0,4,3,0
2033,Andy Pelmard,18,12,12,5,1,9,12,75.0,3,11,3,8,20,35,0
2034,Lee Peltier,9,4,8,1,0,4,4,100.0,0,1,1,0,1,11,0
2035,Federico Peluso,1,1,1,0,0,1,2,50.0,1,2,2,0,3,12,0
2036,Timothee Pembele,8,7,4,4,0,5,14,35.7,9,4,0,4,5,8,1
2037,Rubén Peña,25,14,8,15,2,19,33,57.6,14,20,1,19,13,19,0
2038,Philipp Pentke,0,0,0,0,0,0,0,,0,0,0,0,0,0,0
2039,Nicolas Pépé,20,15,8,6,6,8,23,34.8,15,16,1,15,12,19,0
2040,Alberto Perea,28,17,12,10,6,9,35,25.7,26,26,1,25,21,9,0
2041,Andreas Pereira,5,0,1,3,1,2,12,16.7,10,6,0,6,1,4,0
2042,Danilo Pereira,21,11,6,11,4,6,14,42.9,8,14,6,8,29,33,4
2043,Mathias Pereira Lage,29,17,12,15,2,10,40,25.0,30,21,4,17,15,16,0
2044,Matheus Pereira,26,15,14,10,2,12,54,22.2,42,18,0,18,29,16,0
2045,Pedro Pereira,50,32,29,17,4,21,40,52.5,19,33,11,22,19,61,0
2046,Ricardo Pereira,31,22,16,8,7,14,35,40.0,21,24,1,23,15,23,0
2047,Gastón Pereiro,3,1,2,1,0,1,2,50.0,1,2,0,2,1,2,1
2048,Bruno Peres,21,11,11,7,3,13,24,54.2,11,18,4,14,27,11,0
2049,Roberto Pereyra,18,11,7,8,3,7,23,30.4,16,24,5,19,27,24,0
2050,Ayoze Pérez,32,15,6,20,6,13,48,27.1,35,28,0,28,10,7,0
2051,Carles Pérez,9,4,3,6,0,6,31,19.4,25,9,0,9,6,1,0
2052,Iñigo Pérez,20,10,9,6,5,10,16,62.5,6,12,0,12,15,8,1
2053,Juan Pérez,0,0,0,0,0,0,0,,0,0,0,0,0,1,0
2054,Kike Pérez,26,19,8,14,4,7,33,21.2,26,10,1,9,17,18,0
2055,Lucas Pérez,6,2,3,3,0,2,10,20.0,8,6,1,5,2,5,0
2056,Luis Pérez,33,17,16,17,0,18,30,60.0,12,26,8,18,14,54,1
2057,Manuel Perez,1,0,1,0,0,0,8,0.0,8,2,0,2,2,2,0
2058,Nehuén Pérez,6,3,6,0,0,4,6,66.7,2,5,4,1,12,33,0
2059,Mattia Perin,0,0,0,0,0,0,0,,0,0,0,0,1,6,0
2060,Ivan Perišić,22,13,11,6,5,12,33,36.4,21,33,4,29,19,36,1
2061,Romain Perraud,60,34,42,16,2,24,45,53.3,21,36,3,33,45,76,0
2062,Lucas Perrin,7,4,4,3,0,5,12,41.7,7,5,4,1,8,16,0
2063,Pavao Pervan,0,0,0,0,0,0,0,,0,0,0,0,0,1,0
2064,Matteo Pessina,14,7,4,6,4,7,24,29.2,17,17,2,15,17,7,1
2065,Andrea Petagna,2,0,0,2,0,2,7,28.6,5,4,0,4,1,7,0
2066,Nils Petersen,11,7,2,6,3,3,21,14.3,18,25,1,24,9,28,0
2067,Lukas Petkov,0,0,0,0,0,0,0,,0,0,0,0,0,0,0
2068,Jacopo Petriccione,14,8,6,7,1,9,24,37.5,15,11,2,9,8,11,0
2069,Jens Petter Hauge,7,4,3,3,1,6,10,60.0,4,4,0,4,1,3,0
2070,Germán Pezzella,34,20,22,12,0,18,32,56.3,14,26,14,12,36,109,1
2071,Giuseppe Pezzella,34,19,23,9,2,22,41,53.7,19,22,9,13,12,52,3
2072,Maximilian Philipp,15,6,3,6,6,5,21,23.8,16,17,0,17,6,3,0
2073,Rayan Philippe,3,1,1,1,1,2,2,100.0,0,0,0,0,0,0,0
2074,Romain Philippoteaux,1,1,1,0,0,1,5,20.0,4,2,0,2,2,1,0
2075,Romain Philippoteaux,11,6,6,3,2,6,9,66.7,3,4,0,4,10,2,0
2076,Kalvin Phillips,74,38,38,29,7,26,62,41.9,36,49,14,35,45,53,3
2077,Matt Phillips,15,8,4,11,0,7,23,30.4,16,32,4,28,10,32,1
2078,Nathaniel Phillips,22,14,15,7,0,11,24,45.8,13,17,14,3,20,81,0
2079,Jaden Philogene Bidace,0,0,0,0,0,0,0,,0,0,0,0,0,0,0
2080,Krzysztof Piątek,9,4,1,7,1,3,22,13.6,19,11,0,11,6,14,0
2081,Pablo Piatti,8,6,3,3,2,3,12,25.0,9,5,0,5,2,1,0
2082,Cristiano Piccini,1,1,1,0,0,0,1,0.0,1,1,0,1,0,0,0
2083,Cristiano Piccini,1,1,1,0,0,1,2,50.0,1,0,0,0,0,3,0
2084,Roberto Piccoli,7,3,0,4,3,2,4,50.0,2,4,0,4,2,5,0
2085,Jordan Pickford,0,0,0,0,0,0,2,0.0,2,2,0,2,3,16,4
2086,Jérémy Pied,7,0,3,3,1,4,9,44.4,5,3,1,2,6,8,0
2087,Amos Pieper,58,32,39,17,2,20,33,60.6,13,48,35,13,66,160,3
2088,Ronaël Pierre-Gabriel,60,40,42,16,2,35,52,67.3,17,17,7,10,30,57,0
2089,Erik Pieters,30,21,18,9,3,19,39,48.7,20,30,9,21,12,34,0
2090,Tomás Pina Isla,39,18,18,16,5,16,42,38.1,26,28,8,20,37,42,0
2091,Andrea Pinamonti,0,0,0,0,0,0,0,,0,1,0,1,1,2,0
2092,Yeremi Pino,19,11,10,7,2,8,28,28.6,20,20,1,19,9,8,0
2093,Carlo Pinsoglio,0,0,0,0,0,0,0,,0,0,0,0,0,0,0
2094,Gerard Piqué,16,11,11,5,0,9,12,75.0,3,9,4,5,26,46,0
2095,Fabio Pisacane,3,2,2,1,0,3,7,42.9,4,8,5,3,1,9,1
2096,Łukasz Piszczek,10,7,6,4,0,5,12,41.7,7,5,1,4,5,12,0
2097,Marko Pjaca,13,6,6,3,4,4,16,25.0,12,7,2,5,7,12,0
2098,Miralem Pjanić,13,8,7,4,2,7,13,53.8,6,5,1,4,11,5,0
2099,Óscar Plano,42,24,24,12,6,14,46,30.4,32,35,6,29,34,43,0
2100,Marvin Plattenhardt,15,10,6,7,2,5,9,55.6,4,9,1,8,1,19,1
2101,Alassane Pléa,19,9,4,10,5,5,20,25.0,15,1,0,1,5,7,0
2102,Dani Plomer,0,0,0,0,0,0,1,0.0,1,0,0,0,0,1,0
2103,Tommaso Pobega,24,13,7,13,4,11,31,35.5,20,10,2,8,9,22,0
2104,Daniel Podence,12,6,5,5,2,2,19,10.5,17,5,1,4,13,2,0
2105,Paul Pogba,36,26,15,16,5,11,33,33.3,22,24,2,22,26,37,0
2106,Joel Pohjanpalo,5,1,0,3,2,1,6,16.7,5,1,0,1,1,12,0
2107,Joel Pohjanpalo,0,0,0,0,0,0,0,,0,0,0,0,0,0,0
2108,Andrea Poli,9,7,4,2,3,6,12,50.0,6,7,1,6,7,7,0
2109,Matteo Politano,24,16,13,9,2,11,47,23.4,36,14,1,13,14,18,0
2110,Jorge Pombo,7,3,3,2,2,1,8,12.5,7,2,0,2,2,3,0
2111,Marin Pongračić,13,9,9,3,1,6,8,75.0,2,12,5,7,11,27,0
2112,Pere Pons,20,10,8,8,4,5,16,31.3,11,15,2,13,7,10,0
2113,Nick Pope,1,1,1,0,0,0,1,0.0,1,0,0,0,2,29,2
2114,Manolo Portanova,3,3,1,1,1,0,2,0.0,2,3,1,2,1,2,0
2115,Manolo Portanova,2,0,2,0,0,0,2,0.0,2,4,1,3,0,1,0
2116,Francisco Portillo,5,3,1,4,0,2,14,14.3,12,3,0,3,5,1,0
2117,Portu,18,8,4,10,4,7,36,19.4,29,24,2,22,8,5,0
2118,Stefan Posch,52,24,29,17,6,27,47,57.4,20,27,8,19,37,73,1
2119,Sergio Postigo,16,12,12,3,1,7,18,38.9,11,21,10,11,33,84,1
2120,Yussuf Poulsen,10,6,1,6,3,1,17,5.9,16,16,0,16,6,13,0
2121,Maxime Poundjé,10,7,9,1,0,2,6,33.3,4,7,3,4,11,5,0
2122,Darío Poveda,0,0,0,0,0,0,0,,0,1,0,1,0,0,0
2123,Alejandro Pozo Pozo,38,22,17,15,6,17,38,44.7,21,35,2,33,27,40,1
2124,Dennis Praet,14,7,4,7,3,6,15,40.0,9,12,2,10,7,3,0
2125,Sanjin Prcić,3,2,0,3,0,2,5,40.0,3,4,3,1,4,2,1
2126,Nicolas de Préville,19,14,7,6,6,9,42,21.4,33,15,0,15,13,7,0
2127,Manuel Prietl,65,44,33,28,4,12,73,16.4,61,34,7,27,45,24,0
2128,Grischa Prömel,39,23,14,23,2,18,34,52.9,16,20,2,18,24,22,0
2129,Davy Pröpper,6,5,0,6,0,2,5,40.0,3,3,0,3,1,0,0
2130,Ivan Provedel,2,0,2,0,0,2,6,33.3,4,0,0,0,2,20,1
2131,Antonio Puertas,27,13,9,12,6,10,32,31.3,22,24,5,19,12,25,0
2132,Riqui Puig,5,3,1,3,1,4,8,50.0,4,0,0,0,1,0,0
2133,Erick Pulgar,41,18,17,23,1,22,49,44.9,27,24,10,14,41,45,1
2134,Jorge Pulido,39,24,31,8,0,17,29,58.6,12,32,18,14,52,98,0
2135,Christian Pulisic,19,11,8,10,1,8,21,38.1,13,25,2,23,12,9,0
2136,Ignacio Pussetto,16,8,5,6,5,6,17,35.3,11,14,0,14,13,6,0
2137,Fabio Quagliarella,12,8,4,4,4,2,19,10.5,17,14,1,13,7,10,0
2138,Robin Quaison,14,6,3,6,5,7,14,50.0,7,10,0,10,13,10,0
2139,Domingos Quina,5,5,1,3,1,3,6,50.0,3,8,0,8,2,0,0
2140,Quini,33,22,23,7,3,19,36,52.8,17,15,6,9,15,39,0
2141,Quique,0,0,0,0,0,0,1,0.0,1,2,0,2,0,0,0
2142,Dani Raba,2,1,0,1,1,2,8,25.0,6,1,0,1,0,0,0
2143,Simone Rabbi,0,0,0,0,0,0,1,0.0,1,0,0,0,0,0,0
2144,Adrien Rabiot,72,42,24,41,7,28,60,46.7,32,32,11,21,43,29,1
2145,Uroš Račić,38,22,16,16,6,16,54,29.6,38,33,11,22,26,54,0
2146,Anthony Racioppi,0,0,0,0,0,0,2,0.0,2,0,0,0,2,12,4
2147,Nemanja Radoja,23,15,12,10,1,5,19,26.3,14,9,3,6,19,12,1
2148,Nemanja Radonjić,6,5,1,2,3,2,12,16.7,10,8,0,8,3,1,0
2149,Nemanja Radonjić,5,3,2,2,1,1,5,20.0,4,1,0,1,2,1,0
2150,Aleksandar Radovanović,1,1,0,1,0,0,0,,0,2,1,1,0,2,0
2151,Ivan Radovanović,18,15,13,5,0,12,31,38.7,19,39,21,18,37,114,2
2152,Ionuț Radu,0,0,0,0,0,0,0,,0,0,0,0,0,1,0
2153,Ștefan Radu,43,24,20,19,4,25,40,62.5,15,27,14,13,45,73,1
2154,Rafael,0,0,0,0,0,0,0,,0,0,0,0,0,0,0
2155,Rafinha,54,26,18,28,8,28,49,57.1,21,18,3,15,13,6,0
2156,Antonio Raimondo,0,0,0,0,0,0,0,,0,0,0,0,0,0,0
2157,Predrag Rajković,2,1,2,0,0,2,5,40.0,3,1,0,1,2,17,3
2158,Ivan Rakitić,32,18,18,10,4,12,41,29.3,29,19,4,15,26,29,1
2159,Jonás Ramalho,5,4,4,0,1,1,3,33.3,2,3,0,3,2,7,0
2160,Benito Raman,19,13,11,6,2,6,29,20.7,23,11,0,11,5,5,0
2161,Gastón Ramírez,31,15,10,17,4,8,27,29.6,19,19,3,16,4,13,0
2162,Sandro Ramírez,13,9,3,8,2,4,11,36.4,7,11,1,10,10,2,0
2163,Sergio Ramos,15,12,8,6,1,6,10,60.0,4,9,5,4,19,39,1
2164,Aaron Ramsdale,1,1,1,0,0,1,1,100.0,0,0,0,0,2,22,6
2165,Aaron Ramsey,22,14,8,13,1,8,25,32.0,17,13,2,11,7,8,2
2166,Jacob Ramsey,10,5,3,4,3,2,12,16.7,10,13,6,7,4,5,0
2167,Kayne Ramsey,5,2,4,1,0,3,3,100.0,0,0,0,0,0,3,0
2168,Darren Randolph,0,0,0,0,0,0,0,,0,0,0,0,0,1,0
2169,Andrea Ranocchia,13,10,6,6,1,7,8,87.5,1,5,3,2,12,19,0
2170,Raphinha,34,17,13,16,5,12,58,20.7,46,31,1,30,29,27,0
2171,Raphinha,5,2,1,3,1,1,4,25.0,3,5,0,5,3,4,0
2172,Marcus Rashford,18,9,2,8,8,7,27,25.9,20,22,2,20,8,10,0
2173,Milot Rashica,24,12,11,11,2,12,23,52.2,11,7,0,7,4,6,0
2174,Giacomo Raspadori,5,3,1,1,3,0,4,0.0,4,13,5,8,2,9,0
2175,Federico Ravaglia,0,0,0,0,0,0,1,0.0,1,0,0,0,0,2,0
2176,Tim Ream,12,5,9,3,0,8,11,72.7,3,8,5,3,6,26,1
2177,Ante Rebić,26,9,4,8,14,8,37,21.6,29,21,1,20,7,17,0
2178,Arkadiusz Reca,34,16,15,11,8,10,45,22.2,35,30,3,27,50,64,0
2179,Recio,17,5,4,8,5,8,18,44.4,10,6,0,6,4,1,0
2180,Daishawn Redan,0,0,0,0,0,0,0,,0,1,0,1,0,0,0
2181,Nathan Redmond,30,17,14,12,4,8,24,33.3,16,24,2,22,11,9,0
2182,Harrison Reed,63,38,28,28,7,29,73,39.7,44,34,11,23,50,31,1
2183,Vasco Regini,2,2,2,0,0,2,2,100.0,0,1,1,0,1,5,0
2184,Sergio Reguilón,47,25,30,13,4,23,48,47.9,25,39,7,32,32,50,1
2185,Bobby Reid,31,15,17,10,4,18,39,46.2,21,19,5,14,21,39,0
2186,Pepe Reina,0,0,0,0,0,0,1,0.0,1,0,0,0,1,6,0
2187,Jeff Reine-Adélaïde,7,4,1,4,2,2,9,22.2,7,10,1,9,4,6,0
2188,Jeff Reine-Adélaïde,0,0,0,0,0,0,0,,0,0,0,0,0,0,0
2189,Reinier,9,4,6,1,2,2,4,50.0,2,4,1,3,2,0,0
2190,Francisco Reis Ferreira,1,1,1,0,0,0,3,0.0,3,0,0,0,0,6,0
2191,Rocco Reitz,3,2,0,3,0,2,2,100.0,0,3,1,2,1,1,0
2192,Karim Rekik,7,5,2,5,0,1,4,25.0,3,8,3,5,6,17,0
2193,Álex Remiro,0,0,0,0,0,0,1,0.0,1,0,0,0,3,14,0
2194,Panagiotis Retsos,5,3,5,0,0,3,7,42.9,4,1,1,0,3,12,0
2195,Marco Reus,33,16,9,16,8,9,33,27.3,24,22,2,20,14,13,0
2196,Elvis Rexhbeçaj,53,32,17,27,9,19,53,35.8,34,32,7,25,26,18,0
2197,Oriol Rey,0,0,0,0,0,0,0,,0,0,0,0,1,0,0
2198,Gio Reyna,24,13,9,8,7,9,25,36.0,16,14,1,13,10,11,0
2199,Baptiste Reynet,2,1,2,0,0,2,4,50.0,2,1,0,1,1,9,2
2200,Bryan Reynolds,4,2,1,1,2,1,5,20.0,4,4,0,4,6,4,0
2201,Franck Ribéry,24,11,4,9,11,5,29,17.2,24,11,2,9,3,1,0
2202,Federico Ricci,0,0,0,0,0,0,0,,0,0,0,0,0,0,0
2203,Giacomo Ricci,3,1,1,2,0,0,0,,0,2,2,0,1,4,0
2204,Matteo Ricci,40,23,14,24,2,27,52,51.9,25,24,4,20,34,13,0
2205,Declan Rice,59,35,33,25,1,21,51,41.2,30,39,11,28,59,41,0
2206,Chris Richards,19,8,12,6,1,10,16,62.5,6,13,4,9,21,40,1
2207,Chris Richards,0,0,0,0,0,0,0,,0,0,0,0,1,1,0
2208,Lewis Richardson,0,0,0,0,0,0,0,,0,0,0,0,0,0,0
2209,Richarlison,50,32,21,22,7,16,51,31.4,35,28,3,25,14,36,1
2210,Marco Richter,17,9,3,12,2,7,23,30.4,16,10,0,10,6,9,0
2211,Mikel Rico,24,12,14,8,2,11,34,32.4,23,20,3,17,23,22,0
2212,Sergio Rico,0,0,0,0,0,0,0,,0,0,0,0,0,1,0
2213,Jaïro Riedewald,34,15,13,17,4,16,36,44.4,20,39,7,32,29,25,0
2214,Emiliano Rigoni,12,7,3,8,1,3,15,20.0,12,16,1,15,6,9,0
2215,Tomás Rincón,68,38,27,33,8,36,71,50.7,35,32,7,25,31,44,0
2216,Luis Rioja,21,14,11,7,3,7,39,17.9,32,23,1,22,20,30,0
2217,Renaud Ripart,52,30,25,19,8,26,84,31.0,58,58,12,46,36,53,0
2218,Andrea Rispoli,6,3,2,3,1,2,7,28.6,5,12,3,9,5,15,1
2219,Mihailo Ristić,45,22,25,13,7,28,44,63.6,16,30,9,21,26,57,0
2220,Matt Ritchie,10,3,5,3,2,3,17,17.6,14,17,2,15,12,47,0
2221,Maxence Rivera,12,10,6,4,2,4,10,40.0,6,5,0,5,1,0,0
2222,Emmanuel Rivière,2,1,2,0,0,0,3,0.0,3,5,1,4,1,0,0
2223,Rober,14,7,8,3,3,8,18,44.4,10,24,16,8,35,52,1
2224,Roberto,0,0,0,0,0,0,1,0.0,1,0,0,0,0,7,0
2225,Sergi Roberto,9,6,5,2,2,7,13,53.8,6,12,6,6,10,20,0
2226,Tyler Roberts,15,13,1,11,3,5,22,22.7,17,17,2,15,9,12,0
2227,Andrew Robertson,46,34,23,18,5,28,57,49.1,29,39,9,30,21,79,1
2228,Antonee Robinson,45,28,24,16,5,27,44,61.4,17,21,4,17,37,68,0
2229,Callum Robinson,7,5,5,1,1,3,19,15.8,16,9,0,9,7,8,0
2230,Jack Robinson,14,6,8,5,1,6,11,54.5,5,10,4,6,9,42,0
2231,Joel Robles,0,0,0,0,0,0,1,0.0,1,1,0,1,0,11,2
2232,Hal Robson-Kanu,2,1,1,0,1,0,1,0.0,1,2,0,2,2,7,0
2233,Marc Roca,2,2,0,0,2,0,4,0.0,4,4,1,3,2,1,0
2234,Christopher Rocchia,1,0,1,0,0,0,2,0.0,2,0,0,0,0,1,0
2235,Rubén Rochina,38,28,12,23,3,12,35,34.3,23,22,2,20,22,7,0
2236,Marek Rodák,0,0,0,0,0,0,0,,0,0,0,0,0,0,0
2237,Sebastian Rode,44,25,21,16,7,14,46,30.4,32,30,3,27,47,18,0
2238,Joe Rodon,14,9,11,2,1,3,4,75.0,1,10,8,2,21,36,2
2239,Rodri,72,40,24,40,8,33,66,50.0,33,23,9,14,36,54,3
2240,Rodri,3,3,1,2,0,1,6,16.7,5,7,0,7,2,0,0
2241,Rodrigo,14,7,8,3,3,4,22,18.2,18,7,0,7,5,16,0
2242,Kévin Rodrigues,16,8,8,5,3,7,23,30.4,16,10,1,9,20,15,1
2243,Ángel Rodríguez,7,4,1,4,2,1,16,6.3,15,7,0,7,2,8,0
2244,Óscar Rodríguez Arnaiz,15,9,3,8,4,6,13,46.2,7,2,0,2,10,1,0
2245,Guido Rodríguez,98,56,52,40,6,40,85,47.1,45,52,14,38,68,58,2
2246,James Rodríguez,28,17,8,15,5,11,46,23.9,35,17,0,17,15,3,0
2247,Jay Rodriguez,25,16,5,15,5,13,28,46.4,15,25,4,21,2,7,0
2248,Miguel Rodríguez,1,1,0,1,0,0,0,,0,0,0,0,0,0,0
2249,Ricardo Rodríguez,21,14,11,8,2,13,22,59.1,9,16,5,11,20,43,0
2250,Víctor Rodríguez,4,3,3,1,0,0,9,0.0,9,5,1,4,5,4,0
2251,Rodrygo,15,6,10,4,1,2,17,11.8,15,15,0,15,7,4,0
2252,Marko Rog,40,24,15,22,3,16,37,43.2,21,17,6,11,19,15,0
2253,Rogério,26,13,19,5,2,19,27,70.4,8,26,5,21,31,53,0
2254,Luis Rojas,1,0,0,1,0,1,2,50.0,1,2,0,2,1,0,0
2255,Alessio Romagnoli,17,7,8,7,2,8,19,42.1,11,29,22,7,24,80,0
2256,Cristian Romero,63,32,41,19,3,27,49,55.1,22,31,13,18,96,71,2
2257,Oriol Romeu,69,35,25,39,5,26,68,38.2,42,28,7,21,30,18,0
2258,Cristiano Ronaldo,6,3,1,3,2,3,15,20.0,12,11,3,8,5,15,1
2259,Facundo Roncaglia,25,14,14,11,0,11,20,55.0,9,11,6,5,25,26,0
2260,Valentin Rongier,93,59,31,55,7,43,85,50.6,42,32,2,30,28,21,1
2261,Marten de Roon,80,48,30,36,14,36,84,42.9,48,44,9,35,69,40,0
2262,Jérôme Roussillon,24,12,14,8,2,11,20,55.0,9,10,1,9,19,28,0
2263,Nolan Roux,7,3,1,4,2,3,8,37.5,5,6,0,6,5,4,0
2264,Nicolò Rovella,29,16,15,11,3,9,32,28.1,23,11,0,11,20,19,1
2265,Amir Rrahmani,13,8,7,6,0,6,9,66.7,3,17,14,3,8,39,1
2266,Rubén,0,0,0,0,0,0,0,,0,0,0,0,0,1,0
2267,Waldo Rubio,6,4,2,2,2,1,14,7.1,13,6,0,6,3,3,0
2268,John Ruddy,0,0,0,0,0,0,0,,0,0,0,0,0,0,0
2269,Antonio Rüdiger,31,23,16,14,1,12,15,80.0,3,17,10,7,18,51,0
2270,Sebastian Rudy,35,26,15,15,5,16,45,35.6,29,24,4,20,13,21,1
2271,Sebastian Rudy,4,2,2,0,2,4,7,57.1,3,6,4,2,1,4,0
2272,Kevin Rüegg,0,0,0,0,0,0,0,,0,3,0,3,2,3,0
2273,Daniele Rugani,24,11,10,12,2,10,20,50.0,10,15,10,5,15,46,0
2274,Daniele Rugani,0,0,0,0,0,0,1,0.0,1,1,1,0,1,1,0
2275,Matteo Ruggeri,3,0,1,2,0,2,3,66.7,1,2,0,2,4,2,0
2276,Mário Rui,24,13,17,6,1,17,33,51.5,16,17,4,13,28,29,1
2277,Aitor Ruibal,32,18,14,14,4,10,35,28.6,25,26,0,26,11,8,0
2278,Isma Ruiz,1,0,0,1,0,0,1,0.0,1,0,0,0,0,3,0
2279,Kays Ruiz,1,1,0,1,0,0,4,0.0,4,1,0,1,3,2,0
2280,Fabián Ruiz Peña,58,31,26,21,11,25,70,35.7,45,33,3,30,36,32,1
2281,Víctor Ruiz,11,7,7,4,0,4,13,30.8,9,17,13,4,44,85,0
2282,Gerónimo Rulli,0,0,0,0,0,0,0,,0,0,0,0,0,0,1
2283,Georginio Rutter,2,2,0,1,1,1,3,33.3,2,2,0,2,0,0,0
2284,Georginio Rutter,4,4,2,2,0,1,2,50.0,1,2,0,2,0,2,0
2285,Mathew Ryan,0,0,0,0,0,0,0,,0,0,0,0,0,1,0
2286,Mathew Ryan,1,0,1,0,0,0,0,,0,0,0,0,0,4,0
2287,Julian Ryerson,22,15,4,14,4,12,15,80.0,3,13,0,13,11,17,0
2288,Frederik Rønnow,0,0,0,0,0,0,0,,0,0,0,0,1,9,1
2289,João Victor Santos Sá,9,6,2,6,1,6,11,54.5,5,11,0,11,8,2,0
2290,Roli Pereira de Sa,4,3,1,3,0,3,4,75.0,1,2,0,2,0,0,0
2291,Idriss Saadi,0,0,0,0,0,0,2,0.0,2,0,0,0,0,0,0
2292,Youssouf Sabaly,47,33,24,17,6,27,45,60.0,18,31,8,23,49,57,2
2293,Mathys Saban,0,0,0,0,0,0,0,,0,0,0,0,0,0,0
2294,Marcel Sabitzer,29,21,12,16,1,12,37,32.4,25,7,2,5,35,27,0
2295,Alexis Saelemaekers,43,26,20,18,5,19,60,31.7,41,29,1,28,25,6,0
2296,Modibo Sagnan,12,7,6,6,0,4,6,66.7,2,7,2,5,6,25,1
2297,Allan Saint-Maximin,16,9,6,9,1,4,9,44.4,5,10,0,10,4,2,0
2298,Borja Sainz,7,3,3,2,2,4,16,25.0,12,4,0,4,6,1,0
2299,Romain Saïss,35,24,23,12,0,19,33,57.6,14,28,13,15,52,115,1
2300,Bukayo Saka,25,16,10,13,2,11,40,27.5,29,21,2,19,25,24,0
2301,Hiroki Sakai,81,48,34,35,12,39,51,76.5,12,21,5,16,54,65,0
2302,Moïse Sakava,0,0,0,0,0,0,0,,0,0,0,0,0,0,0
2303,Mamadou Sakho,3,2,1,2,0,3,3,100.0,0,3,2,1,3,11,0
2304,Jacopo Sala,17,9,14,1,2,8,22,36.4,14,5,2,3,5,6,0
2305,Mohamed Salah,18,9,4,4,10,7,16,43.8,9,10,0,10,1,10,1
2306,Eddie Salcedo,6,2,3,2,1,3,3,100.0,0,6,0,6,6,6,0
2307,William Saliba,15,9,8,5,2,5,6,83.3,1,17,16,1,26,80,2
2308,Romain Salin,0,0,0,0,0,0,1,0.0,1,0,0,0,1,6,3
2309,Mohammed Salisu,38,21,20,16,2,25,34,73.5,9,22,5,17,17,30,0
2310,Roland Sallai,18,14,7,9,2,5,13,38.5,8,11,1,10,11,8,0
2311,Salvi,18,10,14,3,1,8,26,30.8,18,14,1,13,20,24,0
2312,Lazar Samardzic,10,7,4,6,0,5,13,38.5,8,6,0,6,2,1,0
2313,Diadie Samassékou,71,41,22,42,7,33,90,36.7,57,41,12,29,78,50,0
2314,Mama Samba Baldé,23,9,4,13,6,9,22,40.9,13,16,1,15,4,26,0
2315,Junior Sambia,41,29,20,14,7,26,38,68.4,12,27,14,13,39,46,0
2316,Frédéric Sammaritano,15,10,9,5,1,9,26,34.6,17,6,0,6,9,3,0
2317,Fede San Emeterio,25,14,15,7,3,11,31,35.5,20,23,8,15,28,33,0
2318,Antonio Sanabria,8,3,0,4,4,2,9,22.2,7,5,0,5,5,8,0
2319,Antonio Sanabria,5,5,0,4,1,0,2,0.0,2,8,1,7,3,9,0
2320,Oihan Sancet,8,2,3,4,1,2,7,28.6,5,4,0,4,5,7,0
2321,Renato Sanches,13,7,4,8,1,5,25,20.0,20,13,2,11,13,8,0
2322,Ricard Sánchez,1,1,0,0,1,0,0,,0,1,0,1,0,1,0
2323,Alexis Sánchez,14,8,4,4,6,5,18,27.8,13,11,0,11,7,1,1
2324,Davinson Sánchez,40,20,31,9,0,21,32,65.6,11,18,13,5,14,85,2
2325,Germán Sánchez,24,11,13,9,2,11,23,47.8,12,28,26,2,38,130,1
2326,Javi Sánchez,15,10,10,4,1,9,10,90.0,1,15,7,8,15,37,0
2327,Manu Sánchez,27,15,10,10,7,11,25,44.0,14,8,0,8,8,14,0
2328,Manu Sánchez,0,0,0,0,0,0,1,0.0,1,1,0,1,0,1,0
2329,Juan Sánchez Miño,8,5,5,3,0,6,14,42.9,8,4,0,4,4,7,0
2330,Pepe Sánchez,4,2,2,2,0,3,4,75.0,1,5,2,3,4,9,0
2331,Robert Sánchez,1,0,1,0,0,1,1,100.0,0,1,0,1,1,11,2
2332,Jadon Sancho,18,11,4,10,4,7,16,43.8,9,20,1,19,16,9,0
2333,Alex Sandro,37,23,19,13,5,13,25,52.0,12,20,4,16,31,57,0
2334,Leroy Sané,18,10,2,10,6,13,30,43.3,17,23,1,22,9,8,1
2335,Salif Sané,17,9,9,7,1,13,23,56.5,10,25,13,12,25,66,0
2336,Oier Sanjurjo,39,16,8,27,4,17,60,28.3,43,24,6,18,29,41,0
2337,Mohamed Sankoh,0,0,0,0,0,0,0,,0,1,0,1,0,0,0
2338,Siriki Sanogo,0,0,0,0,0,0,0,,0,0,0,0,0,0,0
2339,Morgan Sanson,7,4,4,2,1,1,4,25.0,3,5,0,5,4,1,0
2340,Morgan Sanson,21,12,6,12,3,9,28,32.1,19,12,0,12,9,5,0
2341,Nicola Sansone,22,11,7,12,3,10,31,32.3,21,15,0,15,9,7,0
2342,Baptiste Santamaria,9,6,3,5,1,2,7,28.6,5,4,0,4,7,8,0
2343,Baptiste Santamaria,51,38,19,24,8,20,54,37.0,34,36,7,29,52,34,1
2344,Federico Santander,0,0,0,0,0,0,0,,0,0,0,0,0,0,0
2345,Davide Santon,4,3,2,2,0,3,7,42.9,4,10,1,9,4,12,0
2346,Samir Santos,40,23,26,12,2,13,29,44.8,16,33,17,16,58,60,1
2347,Riccardo Saponara,2,1,0,2,0,1,3,33.3,2,0,0,0,1,0,0
2348,Riccardo Saponara,4,1,1,0,3,1,3,33.3,2,1,0,1,1,4,0
2349,Ivan Šaponjić,1,0,0,1,0,0,2,0.0,2,2,0,2,1,4,0
2350,Pablo Sarabia,15,11,6,6,3,10,38,26.3,28,9,1,8,5,8,0
2351,Josh Sargent,32,19,13,13,6,13,27,48.1,14,39,4,35,17,36,0
2352,Bouna Sarr,1,1,0,0,1,1,1,100.0,0,1,1,0,1,1,0
2353,Bouna Sarr,9,8,4,3,2,3,6,50.0,3,7,0,7,10,7,1
2354,Sidy Sarr,10,6,4,6,0,2,5,40.0,3,1,1,0,7,4,0
2355,Marco Sau,6,2,0,6,0,1,16,6.3,15,7,0,7,5,3,0
2356,Téji Savanier,49,33,16,25,8,22,73,30.1,51,28,6,22,38,15,0
2357,Stefan Savić,40,25,32,7,1,21,34,61.8,13,33,19,14,42,110,0
2358,Romaine Sawyers,30,18,16,12,2,14,43,32.6,29,20,4,16,18,12,3
2359,Gianluca Scamacca,19,10,6,7,6,7,19,36.8,12,21,4,17,9,12,0
2360,Dane Scarlett,0,0,0,0,0,0,0,,0,0,0,0,0,0,0
2361,Fabian Schär,13,4,8,5,0,7,19,36.8,12,19,12,7,27,52,1
2362,Aurélien Scheidler,2,0,0,2,0,0,2,0.0,2,0,0,0,1,5,0
2363,Nicolás Schiappacasse,0,0,0,0,0,0,0,,0,0,0,0,0,0,0
2364,Pasquale Schiattarella,37,22,25,12,0,19,47,40.4,28,19,5,14,32,29,2
2365,Patrik Schick,7,2,0,5,2,1,4,25.0,3,5,2,3,3,20,0
2366,Sven Schipplock,15,8,7,6,2,6,27,22.2,21,13,2,11,6,8,0
2367,Xaver Schlager,66,40,20,38,8,22,68,32.4,46,50,6,44,54,38,0
2368,Keven Schlotterbeck,31,10,16,15,0,10,23,43.5,13,26,18,8,36,89,2
2369,Nico Schlotterbeck,34,19,14,19,1,18,28,64.3,10,13,6,7,31,29,1
2370,Jeffrey Schlupp,29,16,14,12,3,6,23,26.1,17,24,8,16,22,16,0
2371,Kasper Schmeichel,0,0,0,0,0,0,0,,0,0,0,0,0,10,0
2372,Jonathan Schmid,37,19,17,13,7,16,30,53.3,14,26,10,16,28,38,0
2373,Romano Schmid,22,16,8,10,4,8,35,22.9,27,21,0,21,8,6,0
2374,Benno Schmitz,14,7,6,7,1,7,13,53.8,6,8,2,6,6,7,0
2375,Morgan Schneiderlin,51,31,21,24,6,20,54,37.0,34,21,11,10,53,46,0
2376,Alessandro Schöpf,11,9,3,7,1,1,6,16.7,5,15,1,14,6,6,0
2377,Jerdy Schouten,50,25,23,25,2,16,37,43.2,21,36,13,23,79,37,6
2378,Nico Schulz,9,6,4,3,2,2,11,18.2,9,12,4,8,6,10,0
2379,Alexander Schwolow,0,0,0,0,0,0,0,,0,1,0,1,0,6,0
2380,Christopher Scott,2,1,0,1,1,2,2,100.0,0,0,0,0,0,1,0
2381,Matteo Scozzarella,4,0,3,1,0,2,3,66.7,1,3,1,2,6,0,0
2382,Simone Scuffet,0,0,0,0,0,0,0,,0,0,0,0,0,0,0
2383,Jacopo Segre,5,2,2,1,2,2,5,40.0,3,0,0,0,0,1,0
2384,Davie Selke,3,2,1,1,1,0,6,0.0,6,3,2,1,1,7,0
2385,Malik Sellouki,0,0,0,0,0,0,1,0.0,1,2,0,2,2,0,0
2386,Matz Sels,0,0,0,0,0,0,0,,0,0,0,0,0,4,0
2387,Nélson Semedo,85,48,53,23,9,42,72,58.3,30,30,10,20,41,78,2
2388,Léo Sena,22,12,7,10,5,12,26,46.2,14,19,4,15,11,5,0
2389,Stefano Sensi,9,6,3,5,1,4,11,36.4,7,6,1,5,7,1,0
2390,Jaime Seoane,50,30,20,23,7,24,65,36.9,41,27,6,21,17,14,0
2391,Luigi Sepe,0,0,0,0,0,0,2,0.0,2,0,0,0,2,13,2
2392,Suat Serdar,55,35,18,33,4,17,52,32.7,35,29,4,25,23,21,0
2393,Jean Seri,17,9,3,12,2,4,15,26.7,11,8,2,6,12,7,0
2394,Femi Seriki,0,0,0,0,0,0,0,,0,0,0,0,0,0,0
2395,Ryan Sessegnon,47,25,26,13,8,15,34,44.1,19,26,3,23,30,46,0
2396,Nils Seufert,12,9,2,5,5,2,8,25.0,6,3,1,2,5,6,0
2397,Edgar Sevikyan,0,0,0,0,0,0,0,,0,0,0,0,0,0,0
2398,Stephan El Shaarawy,4,3,0,3,1,2,9,22.2,7,3,1,2,3,2,0
2399,Jamie Shackleton,10,6,6,4,0,4,11,36.4,7,3,1,2,9,3,0
2400,Xherdan Shaqiri,7,4,3,1,3,2,7,28.6,5,4,0,4,2,0,0
2401,Billy Sharp,5,1,0,3,2,2,9,22.2,7,2,0,2,0,2,0
2402,Luke Shaw,44,28,21,16,7,21,36,58.3,15,34,9,25,20,44,2
2403,Jonjo Shelvey,39,14,18,19,2,10,37,27.0,27,26,14,12,36,42,0
2404,Eldor Shomurodov,28,14,7,13,8,9,37,24.3,28,17,2,15,6,11,0
2405,Shola Shoretire,0,0,0,0,0,0,0,,0,0,0,0,0,0,0
2406,Mahame Siby,0,0,0,0,0,0,1,0.0,1,0,0,0,0,1,0
2407,Abdoulaye Sidibé,1,1,1,0,0,1,2,50.0,1,0,0,0,0,0,0
2408,Djibril Sidibé,58,34,26,29,3,37,52,71.2,15,20,5,15,50,37,2
2409,Sidnei,9,3,6,3,0,4,9,44.4,5,6,4,2,16,28,0
2410,Kaj Sierhuis,7,2,1,2,4,2,9,22.2,7,2,1,1,2,5,0
2411,Tim Siersleben,2,2,2,0,0,1,1,100.0,0,1,0,1,0,0,0
2412,Gylfi Sigurðsson,30,20,9,14,7,13,44,29.5,31,31,2,29,34,21,1
2413,Luca Siligardi,4,2,0,3,1,1,5,20.0,4,0,0,0,0,0,0
2414,Luca Siligardi,0,0,0,0,0,0,2,0.0,2,0,0,0,0,0,0
2415,Adrien Silva,49,22,21,22,6,18,54,33.3,36,34,1,33,30,10,1
2416,André Silva,11,2,0,7,4,6,13,46.2,7,11,1,10,3,15,0
2417,Bernardo Silva,26,14,7,12,7,11,52,21.2,41,17,1,16,17,8,0
2418,Caio Henrique Oliveira Silva,50,34,25,20,5,31,51,60.8,20,20,3,17,16,37,0
2419,David Silva,19,12,2,14,3,8,21,38.1,13,14,1,13,13,8,2
2420,Fábio Silva,6,4,1,4,1,4,12,33.3,8,12,1,11,4,5,1
2421,Florent da Silva,0,0,0,0,0,0,0,,0,0,0,0,0,0,0
2422,Gabriel Silva,7,6,7,0,0,1,2,50.0,1,4,1,3,6,8,0
2423,Gastón Silva,16,12,11,5,0,8,14,57.1,6,10,4,6,11,16,0
2424,Rui Silva,1,0,1,0,0,1,3,33.3,2,0,0,0,2,14,0
2425,Thiago Silva,20,12,11,8,1,14,21,66.7,7,21,13,8,33,86,1
2426,Marco Silvestri,0,0,0,0,0,0,0,,0,0,0,0,0,14,1
2427,Mohamed Simakan,32,22,21,6,5,9,18,50.0,9,17,11,6,31,41,0
2428,Giovanni Simeone,24,11,2,15,7,7,31,22.6,24,23,1,22,10,18,0
2429,Moses Simon,27,14,11,9,7,17,36,47.2,19,24,1,23,15,15,1
2430,Unai Simón,1,0,1,0,0,1,2,50.0,1,0,0,0,0,7,7
2431,Xavi Simons,0,0,0,0,0,0,0,,0,0,0,0,0,0,0
2432,Jóan Símun Edmundsson,0,0,0,0,0,0,0,,0,1,0,1,1,0,0
2433,Wilfried Singo,29,14,16,6,7,17,33,51.5,16,13,3,10,29,40,0
2434,Daley Sinkgraven,32,17,13,16,3,18,35,51.4,17,22,5,17,23,23,0
2435,Dimitris Siovas,46,24,34,10,2,20,30,66.7,10,38,17,21,62,125,2
2436,Tobias Sippel,0,0,0,0,0,0,0,,0,0,0,0,1,4,0
2437,Salvatore Sirigu,1,0,1,0,0,1,2,50.0,1,0,0,0,0,6,2
2438,Issouf Sissokho,6,4,4,2,0,3,6,50.0,3,2,0,2,1,0,0
2439,Ibrahima Sissoko,68,48,25,35,8,28,68,41.2,40,22,5,17,48,44,0
2440,Moussa Sissoko,22,16,19,3,0,8,20,40.0,12,11,4,7,23,25,0
2441,Nelson Sissoko,12,6,6,3,3,7,12,58.3,5,2,1,1,12,16,1
2442,Antonio Sivera,0,0,0,0,0,0,0,,0,0,0,0,0,0,0
2443,Jacques Siwe,4,1,1,1,2,0,1,0.0,1,1,0,1,1,1,0
2444,Ellyes Skhiri,83,48,44,31,8,33,65,50.8,32,49,13,36,82,38,2
2445,Łukasz Skorupski,1,1,1,0,0,1,4,25.0,3,0,0,0,0,23,5
2446,Andreas Skov Olsen,19,10,11,4,4,11,21,52.4,10,15,0,15,3,25,0
2447,Robert Skov,19,10,9,7,3,7,16,43.8,9,9,2,7,15,10,1
2448,Milan Škriniar,48,32,29,16,3,23,34,67.6,11,30,19,11,30,89,1
2449,Steven Skrzybski,5,4,0,5,0,1,7,14.3,6,13,1,12,5,1,1
2450,Petar Škuletić,3,2,1,2,0,0,5,0.0,5,4,2,2,0,4,0
2451,Islam Slimani,0,0,0,0,0,0,0,,0,0,0,0,0,0,0
2452,Islam Slimani,7,5,3,1,3,3,12,25.0,9,4,1,3,1,6,0
2453,William Smallbone,6,3,2,4,0,1,3,33.3,2,5,0,5,2,1,0
2454,Chris Smalling,14,8,5,7,2,6,10,60.0,4,17,11,6,28,46,1
2455,Emile Smith Rowe,14,7,5,5,4,6,17,35.3,11,15,1,14,10,12,0
2456,Robert Snodgrass,17,12,12,4,1,10,16,62.5,6,11,2,9,1,12,0
2457,Robert Snodgrass,0,0,0,0,0,0,0,,0,0,0,0,0,0,0
2458,Cédric Soares,12,8,6,4,2,6,21,28.6,15,6,1,5,8,16,1
2459,Rafa Soares,28,17,16,8,4,15,21,71.4,6,14,4,10,20,32,0
2460,Rubén Sobrino,1,1,1,0,0,0,1,0.0,1,0,0,0,0,1,0
2461,Rubén Sobrino,29,13,8,16,5,8,18,44.4,10,19,0,19,15,11,0
2462,Simon Sohm,18,12,11,6,1,11,26,42.3,15,8,0,8,5,7,0
2463,Augusto Solari,18,13,9,8,1,6,26,23.1,20,13,1,12,6,5,0
2464,Roberto Soldado,7,4,1,4,2,2,11,18.2,9,8,0,8,4,13,1
2465,Carlos Soler,41,24,14,24,3,19,52,36.5,33,35,11,24,23,41,0
2466,Yann Sommer,1,1,1,0,0,1,1,100.0,0,0,0,0,2,9,2
2467,Son,18,10,11,6,1,9,19,47.4,10,11,2,9,12,20,0
2468,Brandon Soppy,21,15,16,5,0,10,16,62.5,6,3,0,3,6,12,0
2469,David Soria,2,2,2,0,0,1,3,33.3,2,0,0,0,1,12,0
2470,Roberto Soriano,48,26,15,20,13,15,64,23.4,49,31,8,23,18,43,0
2471,Alberto Soro,7,2,2,4,1,4,10,40.0,6,7,0,7,1,2,0
2472,Borna Sosa,14,10,6,6,2,8,25,32.0,17,23,4,19,31,74,0
2473,Hugo Sotelo,0,0,0,0,0,0,0,,0,0,0,0,0,0,0
2474,Florian Sotoca,31,20,3,20,8,6,22,27.3,16,27,0,27,9,24,0
2475,Riccardo Sottil,7,3,2,3,2,0,7,0.0,7,4,0,4,5,3,0
2476,Cheick Souaré,0,0,0,0,0,0,0,,0,1,1,0,1,0,0
2477,Tomáš Souček,78,41,37,36,5,28,77,36.4,49,43,18,25,62,107,0
2478,Rayan Souici,0,0,0,0,0,0,0,,0,0,0,0,0,0,0
2479,Cebio Soukou,12,8,5,5,2,6,11,54.5,5,3,0,3,3,4,0
2480,Adama Soumaoro,24,14,17,7,0,6,12,50.0,6,28,23,5,20,72,0
2481,Adama Soumaoro,1,0,0,0,1,0,0,,0,1,1,0,2,2,0
2482,Boubakary Soumaré,44,29,16,25,3,14,29,48.3,15,14,6,8,39,21,0
2483,Yaya Soumaré,1,1,1,0,0,1,2,50.0,1,0,0,0,2,0,0
2484,Arnaud Souquet,50,33,35,13,2,27,48,56.3,21,15,6,9,17,34,0
2485,Ansou Sow,0,0,0,0,0,0,0,,0,1,0,1,0,0,0
2486,Djibril Sow,58,33,19,32,7,18,41,43.9,23,31,8,23,51,17,0
2487,Saidou Sow,23,12,17,6,0,13,19,68.4,6,12,8,4,14,39,1
2488,Çağlar Söyüncü,27,17,13,14,0,17,30,56.7,13,12,9,3,28,80,1
2489,Leonardo Spinazzola,12,6,3,9,0,8,20,40.0,12,16,1,15,25,31,0
2490,Marco Sportiello,2,2,2,0,0,1,3,33.3,2,0,0,0,2,5,1
2491,Mattia Sprocati,1,0,0,1,0,1,1,100.0,0,0,0,0,1,0,0
2492,Jerry St. Juste,65,38,37,26,2,20,36,55.6,16,46,27,19,64,82,1
2493,Benjamin Stambouli,45,29,24,18,3,15,37,40.5,22,42,14,28,49,45,1
2494,Josip Stanišić,2,2,1,1,0,1,1,100.0,0,3,0,3,2,2,0
2495,Niklas Stark,49,28,20,27,2,13,31,41.9,18,43,16,27,42,101,0
2496,Renato Steffen,24,15,6,12,6,13,24,54.2,11,21,2,19,22,15,0
2497,Zack Steffen,0,0,0,0,0,0,0,,0,0,0,0,0,0,0
2498,Pascal Stenzel,33,14,15,17,1,22,50,44.0,28,19,4,15,26,39,1
2499,Dale Stephens,11,6,2,7,2,3,6,50.0,3,3,0,3,8,2,0
2500,Jack Stephens,34,19,19,15,0,17,38,44.7,21,25,14,11,28,64,2
2501,Raheem Sterling,21,10,5,12,4,5,12,41.7,7,15,0,15,15,4,0
2502,Enda Stevens,59,26,32,19,8,33,58,56.9,25,41,12,29,22,81,1
2503,Lars Stindl,24,17,3,16,5,7,32,21.9,25,26,3,23,13,14,0
2504,Kevin Stöger,12,6,2,9,1,5,16,31.3,11,5,0,5,6,4,0
2505,John Stones,21,10,13,5,3,9,14,64.3,5,23,15,8,18,56,1
2506,Thomas Strakosha,1,1,1,0,0,0,0,,0,0,0,0,1,4,0
2507,Tobias Strobl,21,10,12,9,0,10,30,33.3,20,21,8,13,28,27,0
2508,Kevin Strootman,30,18,13,15,2,14,32,43.8,18,35,3,32,25,18,0
2509,Kevin Strootman,9,6,5,4,0,4,8,50.0,4,5,2,3,5,7,0
2510,Pascal Struijk,49,30,28,19,2,17,28,60.7,11,35,21,14,47,92,0
2511,Jens Stryger Larsen,17,11,14,3,0,8,25,32.0,17,26,11,15,24,65,0
2512,Stefano Sturaro,4,3,3,0,1,2,8,25.0,6,5,1,4,5,10,0
2513,Stefano Sturaro,11,5,3,6,2,3,15,20.0,12,5,0,5,7,2,0
2514,Damián Suárez,59,39,29,23,7,30,81,37.0,51,43,2,41,31,42,0
2515,Denis Suárez,64,32,22,30,12,21,94,22.3,73,30,2,28,22,15,2
2516,Luis Suárez,11,7,0,4,7,3,12,25.0,9,7,0,7,5,13,0
2517,Marek Suchý,4,2,1,3,0,1,2,50.0,1,3,3,0,4,9,0
2518,Niklas Süle,32,21,15,14,3,13,21,61.9,8,24,12,12,21,36,1
2519,Suso,20,10,8,6,6,10,41,24.4,31,12,0,12,8,8,0
2520,Bosko Sutalo,5,5,0,3,2,4,5,80.0,1,2,1,1,2,7,1
2521,Mattias Svanberg,38,17,21,9,8,16,45,35.6,29,25,4,21,30,25,1
2522,Abdoulaye Sylla,2,1,2,0,0,1,1,100.0,0,1,0,1,0,1,0
2523,Issiaga Sylla,28,20,11,17,0,11,21,52.4,10,13,3,10,16,21,0
2524,Eddy Sylvestre,1,1,1,0,0,0,1,0.0,1,1,0,1,1,0,0
2525,Ádám Szalai,7,6,3,2,2,2,8,25.0,6,4,1,3,2,4,0
2526,Wojciech Szczęsny,0,0,0,0,0,0,0,,0,2,0,2,3,5,1
2527,Frederik Sørensen,2,1,0,2,0,1,1,100.0,0,2,0,2,0,0,0
2528,Alexander Sørloth,7,5,0,5,2,2,14,14.3,12,13,2,11,3,13,0
2529,Tachi,11,9,9,2,0,6,14,42.9,8,9,6,3,11,32,0
2530,Jonathan Tah,30,17,19,9,2,11,21,52.4,10,19,12,7,33,89,1
2531,Waniss Taibi,0,0,0,0,0,0,2,0.0,2,1,0,1,0,0,0
2532,Flavien Tait,26,11,11,12,3,10,32,31.3,22,17,3,14,13,2,0
2533,Adrien Tameze,39,25,23,15,1,11,27,40.7,16,31,8,23,32,46,2
2534,Japhet Tanganga,5,4,3,2,0,1,3,33.3,2,6,5,1,3,15,0
2535,Renato Tapia,93,44,50,34,9,32,83,38.6,51,56,13,43,53,75,2
2536,Edmond Tapsoba,54,28,35,18,1,21,45,46.7,24,55,29,26,48,96,0
2537,Matt Targett,83,39,52,20,11,56,88,63.6,32,40,14,26,55,102,1
2538,James Tarkowski,66,39,52,11,3,25,49,51.0,24,54,42,12,44,163,1
2539,Ciprian Tătărușanu,0,0,0,0,0,0,0,,0,0,0,0,0,0,1
2540,Percy Tau,1,1,1,0,0,0,2,0.0,2,1,0,1,0,1,0
2541,Niklas Tauer,1,1,0,1,0,1,2,50.0,1,3,1,2,3,1,0
2542,Heriberto Tavares,2,0,0,0,2,1,3,33.3,2,0,0,0,1,1,0
2543,Sidnei Tavares,1,1,0,1,0,0,0,,0,1,1,0,0,0,0
2544,Tomás Tavares,2,1,2,0,0,2,2,100.0,0,1,0,1,0,1,0
2545,Charlie Taylor,48,28,30,15,3,25,46,54.3,21,36,19,17,29,87,2
2546,Neil Taylor,1,1,1,0,0,0,0,,0,1,0,1,0,0,0
2547,Allan Tchaptchet,0,0,0,0,0,0,0,,0,0,0,0,0,0,0
2548,Warren Tchimbembé,7,4,4,3,0,3,9,33.3,6,6,1,5,2,3,0
2549,Aurélien Tchouaméni,127,68,47,62,18,48,92,52.2,44,39,11,28,60,47,0
2550,Álvaro Tejero,1,1,0,0,1,1,3,33.3,2,1,0,1,3,6,0
2551,Nathan Tella,8,5,1,4,3,6,15,40.0,9,13,0,13,3,2,0
2552,Alex Telles,14,7,10,3,1,8,17,47.1,9,7,2,5,16,20,0
2553,Andrés Tello,9,6,8,0,1,5,20,25.0,15,8,1,7,6,6,0
2554,Cristian Tello,16,10,5,9,2,4,22,18.2,18,14,0,14,11,8,0
2555,Lino Tempelmann,5,3,2,2,1,0,4,0.0,4,6,1,5,2,6,0
2556,Hidde ter Avest,5,2,3,2,0,2,5,40.0,3,3,1,2,2,5,0
2557,Marc-André ter Stegen,0,0,0,0,0,0,2,0.0,2,0,0,0,0,12,2
2558,Pietro Terracciano,0,0,0,0,0,0,0,,0,0,0,0,0,1,0
2559,Martin Terrier,33,15,5,15,13,10,36,27.8,26,23,0,23,16,7,0
2560,Claudio Terzi,34,21,19,14,1,19,28,67.9,9,23,12,11,35,55,1
2561,Kenny Tete,48,30,27,16,5,10,18,55.6,8,14,5,9,27,49,0
2562,Kenny Tete,2,0,1,1,0,0,0,,0,0,0,0,2,0,0
2563,Cedric Teuchert,7,5,2,4,1,3,16,18.8,13,12,0,12,5,6,0
2564,Florian Thauvin,40,22,14,21,5,20,54,37.0,34,26,2,24,14,11,0
2565,Malick Thiaw,42,27,24,17,1,15,26,57.7,11,17,12,5,33,70,0
2566,Jan Thielmann,11,6,1,8,2,5,9,55.6,4,10,1,9,9,2,0
2567,Sada Thioub,17,14,7,6,4,7,23,30.4,16,10,0,10,9,3,0
2568,William Thomas Fish,0,0,0,0,0,0,0,,0,0,0,0,0,0,0
2569,Luke Thomas,23,14,11,5,7,14,21,66.7,7,15,2,13,17,21,0
2570,Romain Thomas,47,25,34,11,2,20,35,57.1,15,35,20,15,50,138,0
2571,Adrien Thomasson,36,17,8,16,12,12,58,20.7,46,44,5,39,22,2,0
2572,Erik Thommy,3,1,0,3,0,0,3,0.0,3,3,0,3,3,4,0
2573,Morten Thorsby,76,42,32,36,8,20,60,33.3,40,51,16,35,25,30,0
2574,Khéphren Thuram,32,16,5,21,6,9,27,33.3,18,21,9,12,18,22,1
2575,Marcus Thuram,24,14,9,10,5,10,23,43.5,13,27,4,23,15,13,1
2576,Cheikh Tidiane Sabaly,0,0,0,0,0,0,0,,0,0,0,0,0,0,0
2577,Youri Tielemans,86,45,32,38,16,45,108,41.7,63,35,8,27,46,20,1
2578,Kieran Tierney,27,15,5,14,8,11,31,35.5,20,31,10,21,16,63,0
2579,Steffen Tigges,4,4,0,1,3,2,3,66.7,1,1,0,1,0,1,0
2580,Guus Til,4,3,2,1,1,2,3,66.7,1,2,0,2,2,2,0
2581,David Timor,13,9,5,6,2,9,21,42.9,12,5,1,4,19,32,1
2582,Jean-Clair Todibo,25,15,16,9,0,16,31,51.6,15,13,7,6,19,48,1
2583,Karl Toko Ekambi,16,10,5,3,8,8,32,25.0,24,20,1,19,26,8,0
2584,Corentin Tolisso,19,19,4,11,4,9,29,31.0,20,15,2,13,6,8,0
2585,Jeremy Toljan,21,12,16,3,2,12,27,44.4,15,15,7,8,13,28,0
2586,Rafael Tolói,51,23,21,26,4,26,48,54.2,22,37,7,30,33,66,0
2587,Takehiro Tomiyasu,47,31,27,14,6,21,34,61.8,13,37,19,18,54,106,0
2588,James Tomkins,4,2,4,0,0,3,4,75.0,1,4,3,1,4,45,0
2589,Fikayo Tomori,2,1,2,0,0,0,0,,0,1,1,0,2,8,0
2590,Fikayo Tomori,28,18,17,9,2,8,14,57.1,6,32,20,12,18,61,1
2591,Sandro Tonali,28,19,14,13,1,13,28,46.4,15,18,5,13,22,18,0
2592,Lorenzo Tonelli,33,18,20,11,2,10,21,47.6,11,21,14,7,25,94,1
2593,Toño,4,0,4,0,0,0,2,0.0,2,10,1,9,7,12,0
2594,Ömer Toprak,23,16,15,6,2,12,24,50.0,12,27,16,11,36,115,1
2595,Tyron Tormin,0,0,0,0,0,0,0,,0,0,0,0,0,0,0
2596,Ernesto Torregrossa,1,1,0,0,1,0,2,0.0,2,4,0,4,1,1,0
2597,Lucas Torreira,8,4,2,3,3,0,3,0.0,3,5,3,2,12,8,0
2598,Ferrán Torres,12,5,4,6,2,5,16,31.3,11,16,0,16,3,8,0
2599,Óliver Torres,34,22,13,15,6,19,53,35.8,34,15,0,15,15,9,0
2600,Pau Torres,17,11,10,5,2,11,18,61.1,7,33,25,8,23,111,1
2601,Roberto Torres,15,8,6,5,4,8,29,27.6,21,12,0,12,16,13,0
2602,Lucas Torró,32,15,11,19,2,21,34,61.8,13,16,7,9,27,43,0
2603,Jordan Torunarigha,7,4,7,0,0,5,8,62.5,3,8,2,6,15,54,1
2604,Cenk Tosun,0,0,0,0,0,0,1,0.0,1,0,0,0,0,0,0
2605,Abdoulaye Touré,28,12,10,16,2,14,31,45.2,17,17,2,15,22,19,0
2606,Almamy Touré,18,12,8,7,3,10,14,71.4,4,5,1,4,8,22,0
2607,Lucas Tousart,33,18,16,15,2,13,27,48.1,14,33,6,27,40,52,0
2608,Andros Townsend,78,41,45,20,13,30,79,38.0,49,48,2,46,41,19,0
2609,Conor Townsend,44,28,32,9,3,30,49,61.2,19,38,15,23,36,55,2
2610,Mattéo Tramoni,4,2,2,1,1,1,2,50.0,1,5,0,5,1,2,0
2611,Adama Traoré,28,16,11,13,4,13,21,61.9,8,23,1,22,7,12,1
2612,Amadou Traore,6,1,2,2,2,2,9,22.2,7,9,0,9,1,2,0
2613,Bertrand Traoré,26,10,8,10,8,10,34,29.4,24,23,1,22,15,14,1
2614,Boubacar Traoré,3,2,1,2,0,1,1,100.0,0,1,0,1,0,0,0
2615,Chaka Traorè,0,0,0,0,0,0,0,,0,0,0,0,0,1,1
2616,Charles Traore,53,34,30,17,6,27,54,50.0,27,26,5,21,36,65,0
2617,Cheick Traoré,2,2,1,1,0,2,4,50.0,2,1,0,1,2,1,0
2618,Hamari Traoré,56,38,23,27,6,22,59,37.3,37,31,5,26,76,50,0
2619,Ibrahima Traoré,4,1,1,2,1,0,0,,0,2,0,2,0,0,0
2620,Ismaël Traoré,32,14,23,9,0,20,37,54.1,17,27,13,14,40,107,0
2621,Kevin Trapp,0,0,0,0,0,0,1,0.0,1,1,0,1,3,11,3
2622,Miguel Trauco,47,29,25,14,8,23,43,53.5,20,19,4,15,30,34,1
2623,Trézéguet,33,18,14,15,4,13,45,28.9,32,13,1,12,19,17,0
2624,Manu Trigueros,51,30,25,21,5,21,77,27.3,56,32,2,30,17,19,0
2625,Christopher Trimmel,50,25,28,18,4,28,54,51.9,26,32,7,25,50,99,0
2626,Francisco Trincão,4,2,0,3,1,2,5,40.0,3,4,0,4,1,2,0
2627,Alessandro Tripaldelli,13,6,5,6,2,5,6,83.3,1,6,1,5,3,15,0
2628,Kieran Trippier,61,39,30,25,6,26,52,50.0,26,22,4,18,40,58,1
2629,Leandro Trossard,33,14,11,16,6,10,36,27.8,26,34,2,32,26,7,1
2630,Alexis Trouillet,5,4,1,4,0,4,5,80.0,1,0,0,0,3,0,0
2631,Adrien Truffert,38,18,18,12,8,13,24,54.2,11,26,5,21,18,38,1
2632,Marvin Tshibuabua,1,0,1,0,0,0,0,,0,0,0,0,1,1,0
2633,Kostas Tsimikas,0,0,0,0,0,0,0,,0,0,0,0,0,0,0
2634,Axel Tuanzebe,13,7,5,7,1,8,9,88.9,1,7,5,2,3,18,0
2635,Alessandro Tuia,39,17,34,4,1,15,25,60.0,10,22,10,12,36,91,1
2636,Ľubomír Tupta,0,0,0,0,0,0,0,,0,0,0,0,0,0,0
2637,Tuta,35,20,22,13,0,24,43,55.8,19,19,2,17,29,53,0
2638,Destiny Udogie,6,4,2,2,2,2,2,100.0,0,3,0,3,2,4,0
2639,Matthieu Udol,34,21,18,12,4,17,39,43.6,22,25,5,20,39,30,0
2640,Naomichi Ueda,4,2,3,1,0,4,6,66.7,2,5,4,1,6,30,1
2641,Lesley Ugochukwu,3,1,0,3,0,2,3,66.7,1,1,0,1,0,0,0
2642,Hwang Ui-jo,14,6,5,8,1,6,25,24.0,19,17,2,15,8,14,0
2643,Samir Ujkani,0,0,0,0,0,0,0,,0,0,0,0,0,1,0
2644,Samuel Umtiti,5,1,3,2,0,1,2,50.0,1,11,6,5,9,15,0
2645,Enes Ünal,11,3,0,8,3,4,15,26.7,11,11,0,11,2,14,0
2646,Cengiz Ünder,4,1,0,3,1,3,5,60.0,2,3,0,3,2,0,0
2647,Dayot Upamecano,37,30,18,19,0,14,20,70.0,6,25,14,11,33,74,2
2648,Kacper Urbanski,0,0,0,0,0,0,0,,0,0,0,0,0,0,0
2649,Mark Uth,25,13,13,10,2,5,23,21.7,18,21,0,21,5,10,0
2650,Tomáš Vaclík,0,0,0,0,0,0,1,0.0,1,0,0,0,0,0,1
2651,Eugeni Valderrama,2,2,1,0,1,0,1,0.0,1,0,0,0,5,3,0
2652,Lautaro Valenti,10,4,7,2,1,6,15,40.0,9,11,3,8,11,30,0
2653,Antoine Valerio,0,0,0,0,0,0,1,0.0,1,1,0,1,2,0,0
2654,Borja Valero,13,9,7,4,2,3,15,20.0,12,6,1,5,6,2,0
2655,Yan Valery,5,3,2,3,0,1,5,20.0,4,2,0,2,2,5,0
2656,Jesús Vallejo,11,6,7,3,1,7,18,38.9,11,21,11,10,13,55,0
2657,Manu Vallejo,18,8,5,8,5,5,26,19.2,21,8,0,8,3,3,0
2658,Federico Valverde,25,16,9,8,8,10,26,38.5,16,16,2,14,22,4,0
2659,Virgil van Dijk,3,2,1,2,0,0,0,,0,1,1,0,5,8,1
2660,Raphaël Varane,22,14,16,5,1,10,19,52.6,9,26,18,8,36,114,2
2661,Jamie Vardy,18,12,1,8,9,2,15,13.3,13,14,5,9,4,32,0
2662,Ruben Vargas,18,12,6,9,3,1,16,6.3,15,26,2,24,18,27,0
2663,Denis Vavro,0,0,0,0,0,0,1,0.0,1,0,0,0,1,3,0
2664,Denis Vavro,7,4,2,4,1,2,5,40.0,3,2,0,2,11,21,0
2665,Franco Vázquez,5,1,0,3,2,1,5,20.0,4,2,1,1,1,1,0
2666,Kevin Vázquez,11,5,9,2,0,3,9,33.3,6,8,0,8,9,18,0
2667,Lucas Vázquez,61,37,30,22,9,22,52,42.3,30,14,1,13,19,31,1
2668,Matías Vecino,1,1,0,0,1,0,5,0.0,5,7,1,6,4,3,0
2669,Koke Vegas,0,0,0,0,0,0,0,,0,0,0,0,0,1,1
2670,Gabriel Veiga,3,0,3,0,0,1,4,25.0,3,3,0,3,3,0,0
2671,Miloš Veljković,24,14,17,6,1,15,31,48.4,16,22,9,13,29,94,1
2672,Miguel Veloso,24,17,10,10,4,12,34,35.3,22,12,1,11,12,25,0
2673,Joël Veltman,67,33,34,25,8,29,57,50.9,28,24,5,19,33,64,0
2674,Unai Vencedor Paris,31,21,10,15,6,11,42,26.2,31,17,6,11,18,14,0
2675,Lorenzo Venuti,24,11,14,7,3,14,28,50.0,14,18,3,15,17,24,0
2676,Daniele Verde,5,4,2,2,1,4,10,40.0,6,5,0,5,9,7,0
2677,Simone Verdi,19,12,10,6,3,6,19,31.6,13,8,0,8,8,2,2
2678,Gonzalo Verdú,34,19,26,8,0,16,28,57.1,12,40,30,10,52,113,0
2679,Jordan Veretout,20,12,8,12,0,9,33,27.3,24,14,3,11,14,21,3
2680,Edoardo Vergani,0,0,0,0,0,0,0,,0,0,0,0,0,0,0
2681,Marco Verratti,53,30,17,25,11,24,72,33.3,48,22,5,17,26,4,1
2682,Valerio Verre,11,7,2,7,2,4,19,21.1,15,14,2,12,9,3,0
2683,Mikel Vesga,28,14,8,16,4,12,50,24.0,38,28,8,20,27,35,1
2684,Jannik Vestergaard,50,31,31,15,4,35,52,67.3,17,29,16,13,42,122,0
2685,Rúben Vezo,34,19,26,7,1,12,29,41.4,17,22,11,11,46,106,3
2686,Guglielmo Vicario,0,0,0,0,0,0,0,,0,0,0,0,0,1,0
2687,Iñigo Vicente,1,1,1,0,0,1,1,100.0,0,0,0,0,0,0,0
2688,Fede Vico,10,6,5,5,0,3,10,30.0,7,15,1,14,12,5,0
2689,Aleix Vidal,9,5,5,3,1,5,12,41.7,7,10,1,9,12,9,0
2690,Arturo Vidal,27,14,8,13,6,12,41,29.3,29,23,3,20,29,11,0
2691,Clément Vidal,2,1,1,1,0,2,4,50.0,2,4,4,0,1,6,1
2692,Nacho Vidal,56,28,27,22,7,22,31,71.0,9,39,10,29,43,68,0
2693,Ronaldo Vieira,5,3,1,3,1,0,2,0.0,2,4,3,1,0,2,0
2694,Luca Vignali,19,9,10,6,3,7,25,28.0,18,13,5,8,22,25,0
2695,Emanuel Vignato,18,9,9,6,3,3,15,20.0,12,6,1,5,10,7,0
2696,Toni Villa,31,16,11,14,6,15,42,35.7,27,15,1,14,5,3,0
2697,Asier Villalibre,3,2,0,2,1,2,8,25.0,6,4,0,4,2,16,0
2698,Gonzalo Villar,44,18,14,24,6,18,61,29.5,43,25,3,22,22,14,1
2699,Iván Villar,0,0,0,0,0,0,1,0.0,1,0,0,0,0,18,0
2700,Rúben Vinagre,7,5,5,2,0,3,4,75.0,1,3,0,3,2,4,0
2701,Carlos Vinícius,3,1,2,1,0,1,1,100.0,0,0,0,0,2,5,0
2702,Nicolas Viola,16,9,2,11,3,6,28,21.4,22,10,3,7,9,7,0
2703,João Virgínia,0,0,0,0,0,0,0,,0,0,0,0,0,0,0
2704,Vitinha,7,3,2,5,0,3,8,37.5,5,3,0,3,3,1,0
2705,Vitolo,4,1,2,0,2,1,6,16.7,5,3,0,3,3,2,0
2706,Dušan Vlahović,13,4,3,4,6,5,16,31.3,11,16,2,14,4,15,0
2707,Michel Vlap,1,1,0,1,0,0,8,0.0,8,4,0,4,5,3,0
2708,Andreas Voglsammer,12,8,6,6,0,8,17,47.1,9,11,0,11,3,11,0
2709,Kevin Vogt,18,12,11,6,1,12,21,57.1,9,21,12,9,16,71,0
2710,Mërgim Vojvoda,24,14,18,5,1,12,22,54.5,10,19,4,15,18,35,1
2711,Jake Vokins,0,0,0,0,0,0,1,0.0,1,0,0,0,0,0,0
2712,Kevin Volland,33,16,11,19,3,8,34,23.5,26,23,0,23,4,4,0
2713,Stefan de Vrij,28,16,15,12,1,15,24,62.5,9,24,18,6,41,95,0
2714,Giacomo Vrioni,0,0,0,0,0,0,0,,0,0,0,0,0,0,0
2715,Šime Vrsaljko,18,12,13,5,0,8,12,66.7,4,5,0,5,8,14,0
2716,Nikola Vukčević,14,7,5,8,1,9,18,50.0,9,8,5,3,8,12,1
2717,Miloš Vulić,15,8,9,1,5,8,21,38.1,13,10,1,9,8,8,0
2718,Matěj Vydra,9,5,2,4,3,1,8,12.5,7,8,1,7,6,5,0
2719,Franklin Wadja,4,2,0,2,2,2,2,100.0,0,0,0,0,2,1,0
2720,Elye Wahi,4,3,2,1,1,1,6,16.7,5,4,0,4,2,5,0
2721,Walace,50,23,28,19,3,21,60,35.0,39,36,3,33,34,23,0
2722,Theo Walcott,23,11,8,9,6,11,32,34.4,21,16,0,16,14,5,0
2723,Theo Walcott,0,0,0,0,0,0,0,,0,0,0,0,0,0,0
2724,Kyle Walker,29,19,15,12,2,16,24,66.7,8,19,7,12,14,28,0
2725,Kyle Walker-Peters,83,53,56,25,2,34,57,59.6,23,41,10,31,38,66,2
2726,Sebastian Walukiewicz,27,19,11,13,3,12,30,40.0,18,22,14,8,36,60,0
2727,Aaron Wan-Bissaka,88,54,53,29,6,32,45,71.1,13,65,17,48,62,84,2
2728,Joel Ward,43,25,29,14,0,24,42,57.1,18,27,8,19,41,87,2
2729,James Ward-Prowse,75,49,30,41,4,29,70,41.4,41,36,4,32,42,60,0
2730,Daniel Wass,52,31,21,29,2,22,55,40.0,33,33,13,20,47,69,0
2731,Ollie Watkins,29,17,5,16,8,10,33,30.3,23,21,2,19,7,24,0
2732,Caleb Watts,2,1,2,0,0,1,2,50.0,1,0,0,0,0,0,0
2733,Timothy Weah,15,7,3,9,3,7,14,50.0,7,7,0,7,4,5,0
2734,Adam Webster,29,16,15,10,4,12,25,48.0,13,29,16,13,47,92,3
2735,Wout Weghorst,13,8,2,8,3,4,20,20.0,16,17,3,14,4,26,0
2736,Mitchell Weiser,4,1,1,2,1,2,4,50.0,2,1,0,1,3,4,0
2737,Shon Weissman,12,9,4,5,3,2,23,8.7,21,17,3,14,8,7,0
2738,Danny Welbeck,12,6,2,6,4,7,19,36.8,12,17,0,17,7,13,0
2739,Wendell,53,35,27,18,8,23,49,46.9,26,26,3,23,25,39,1
2740,Oscar Wendt,12,6,2,9,1,4,12,33.3,8,18,4,14,14,23,0
2741,Timo Werner,20,9,6,11,3,7,43,16.3,36,23,1,22,8,8,0
2742,Ashley Westwood,23,15,6,12,5,10,42,23.8,32,26,9,17,44,33,0
2743,Ben White,49,26,21,24,4,24,57,42.1,33,46,22,24,62,56,0
2744,Georginio Wijnaldum,23,7,6,14,3,7,31,22.6,24,18,3,15,26,18,1
2745,William,0,0,0,0,0,0,0,,0,0,0,0,0,0,0
2746,William,14,10,10,4,0,5,15,33.3,10,16,5,11,11,15,1
2747,Brandon Williams,0,0,0,0,0,0,1,0.0,1,1,0,1,1,7,0
2748,Iñaki Williams,11,7,0,4,7,2,14,14.3,12,13,1,12,5,22,0
2749,Neco Williams,6,5,4,2,0,5,9,55.6,4,3,1,2,6,6,0
2750,Nico Williams,1,0,1,0,0,0,2,0.0,2,0,0,0,1,0,0
2751,Rhys Williams,6,4,3,3,0,3,3,100.0,0,4,3,1,6,27,1
2752,Willian,13,7,6,6,1,6,16,37.5,10,13,0,13,8,8,0
2753,Joe Willock,6,3,1,4,1,3,7,42.9,4,6,1,5,3,0,0
2754,Joe Willock,26,13,16,7,3,9,42,21.4,33,21,3,18,17,15,1
2755,Callum Wilson,12,5,1,6,5,2,12,16.7,10,10,3,7,7,14,0
2756,Marten Winkler,0,0,0,0,0,0,0,,0,0,0,0,0,0,0
2757,Harry Winks,16,9,11,5,0,5,20,25.0,15,16,4,12,11,12,1
2758,Florian Wirtz,35,18,8,22,5,11,37,29.7,26,27,1,26,9,8,0
2759,Yoane Wissa,35,20,12,14,9,11,34,32.4,23,25,3,22,20,14,0
2760,Axel Witsel,18,12,6,11,1,8,16,50.0,8,13,3,10,22,13,0
2761,Hannes Wolf,26,13,8,10,8,8,36,22.2,28,18,1,17,9,4,0
2762,Marius Wolf,35,19,19,13,3,13,38,34.2,25,29,3,26,28,47,1
2763,Nick Woltemade,3,2,1,1,1,2,4,50.0,2,1,0,1,0,0,0
2764,Jeong Woo-yeong,9,5,1,6,2,2,11,18.2,9,8,1,7,11,11,0
2765,Chris Wood,12,7,2,4,6,5,18,27.8,13,14,3,11,1,21,0
2766,Joscha Wosz,1,1,1,0,0,0,0,,0,1,0,1,1,0,0
2767,Xeka,33,17,14,15,4,16,43,37.2,27,14,2,12,20,18,0
2768,Granit Xhaka,50,26,18,17,15,30,58,51.7,28,23,7,16,24,38,3
2769,Reinhold Yabo,5,2,2,2,1,2,9,22.2,7,6,1,5,4,1,0
2770,Jawad El Yamiq,21,14,14,7,0,8,11,72.7,3,15,10,5,46,100,0
2771,Rubén Yáñez,0,0,0,0,0,0,1,0.0,1,0,0,0,2,2,0
2772,Andriy Yarmolenko,5,4,2,2,1,2,8,25.0,6,1,0,1,1,2,0
2773,Yusuf Yazıcı,12,5,6,2,4,1,24,4.2,23,5,1,4,2,2,0
2774,DeAndre Yedlin,9,4,8,1,0,4,10,40.0,6,5,1,4,7,17,0
2775,Burak Yılmaz,13,6,3,7,3,4,30,13.3,26,7,0,7,5,22,0
2776,Yoel,0,0,0,0,0,0,0,,0,0,0,0,0,2,0
2777,Okay Yokuşlu,38,25,21,13,4,17,35,48.6,18,15,3,12,35,33,1
2778,Okay Yokuşlu,14,8,8,4,2,5,9,55.6,4,5,2,3,10,9,0
2779,Maya Yoshida,17,4,10,7,0,7,13,53.8,6,45,34,11,57,93,1
2780,Amin Younes,25,14,8,10,7,6,32,18.8,26,19,1,18,13,4,0
2781,Ashley Young,15,7,8,4,3,3,13,23.1,10,13,0,13,6,31,0
2782,Wilitty Younoussa,6,3,3,3,0,3,7,42.9,4,3,0,3,2,0,0
2783,Zaydou Youssouf,30,15,19,10,1,16,40,40.0,24,15,0,15,25,12,1
2784,Mattia Zaccagni,27,13,8,11,8,8,25,32.0,17,28,4,24,27,13,1
2785,Dan-Axel Zagadou,2,2,2,0,0,0,0,,0,3,2,1,6,13,0
2786,Vasilios Zagaritis,0,0,0,0,0,0,0,,0,1,0,1,0,0,0
2787,Arthur Zagre,3,1,2,1,0,2,2,100.0,0,1,1,0,3,1,0
2788,Wilfried Zaha,26,18,8,15,3,11,30,36.7,19,21,0,21,9,4,0
2789,Miha Zajc,22,14,9,10,3,13,39,33.3,26,30,4,26,27,19,0
2790,Denis Zakaria,30,15,12,15,3,11,20,55.0,9,20,7,13,23,29,1
2791,Joseba Zaldúa,15,12,7,5,3,6,18,33.3,12,6,2,4,6,13,0
2792,Nicola Zalewski,1,1,0,1,0,1,1,100.0,0,0,0,0,0,0,0
2793,Andre-Frank Zambo Anguissa,78,37,27,38,13,27,68,39.7,41,35,6,29,56,17,2
2794,Niccolò Zanellato,24,14,16,6,2,13,36,36.1,23,19,5,14,16,12,2
2795,Cristián Zapata,18,12,11,7,0,10,14,71.4,4,15,11,4,15,56,0
2796,Duván Zapata,12,5,2,3,7,4,13,30.8,9,19,5,14,6,19,0
2797,Gabriele Zappa,34,17,16,15,3,22,49,44.9,27,36,4,32,24,50,0
2798,Davide Zappacosta,33,16,15,13,5,15,30,50.0,15,17,1,16,18,41,0
2799,Oier Zarraga,1,1,0,1,0,1,2,50.0,1,1,0,1,0,0,0
2800,Simone Zaza,15,9,4,6,5,6,20,30.0,14,14,0,14,3,5,1
2801,Deyovaisio Zeefuik,13,9,8,3,2,8,19,42.1,11,15,3,12,12,36,0
2802,Marvin Zeegelaar,40,18,23,16,1,20,39,51.3,19,21,9,12,24,43,0
2803,Arber Zeneli,20,10,11,1,8,8,22,36.4,14,12,1,11,3,8,0
2804,Robin Zentner,1,1,1,0,0,1,3,33.3,2,0,0,0,3,9,2
2805,Andi Zeqiri,3,2,0,2,1,1,2,50.0,1,1,0,1,0,2,0
2806,Mehdi Zerkane,23,15,7,10,6,5,18,27.8,13,15,2,13,9,5,0
2807,Ron-Robert Zieler,0,0,0,0,0,0,0,,0,0,0,0,0,0,0
2808,Piotr Zieliński,18,10,8,7,3,7,20,35.0,13,23,4,19,18,12,0
2809,Oleksandr Zinchenko,25,15,12,9,4,14,24,58.3,10,17,4,13,23,28,0
2810,Joshua Zirkzee,2,2,1,1,0,1,3,33.3,2,1,1,0,0,1,0
2811,Joshua Zirkzee,1,0,0,1,0,1,2,50.0,1,0,0,0,0,0,0
2812,Hakim Ziyech,14,10,5,7,2,5,19,26.3,14,9,1,8,10,2,0
2813,Jeroen Zoet,0,0,0,0,0,0,1,0.0,1,0,0,0,0,4,2
2814,Kévin Zohi,9,5,3,4,2,2,6,33.3,4,6,0,6,6,3,0
2815,Kurt Zouma,16,10,8,6,2,4,8,50.0,4,13,9,4,28,93,0
2816,Igor Zubeldia,23,16,15,8,0,8,14,57.1,6,20,13,7,12,46,0
2817,Steven Zuber,24,12,8,13,3,8,16,50.0,8,4,1,3,4,1,0
2818,Martín Zubimendi,41,22,18,20,3,20,34,58.8,14,22,10,12,40,39,0
2819,Martin Ødegaard,9,3,2,6,1,4,14,28.6,10,2,0,2,2,5,0
2820,Martin Ødegaard,1,0,0,1,0,1,2,50.0,1,1,0,1,1,0,0
2821,Filip Đuričić,32,23,6,16,10,12,30,40.0,18,20,2,18,9,12,0
