,Player,Tkl,TklW,Def 3rd,Mid 3rd,Att 3rd,TklDribblers,Att,Tkl%,Lost,Blocks,Sh,Pass,Int,Clr,Err
0,Ismael Aaneba,12,6,7,5,0,5,10,50.0,5,5,0,5,8,9,0
1,Patrick van Aanholt,48,24,35,11,2,24,40,60.0,16,33,9,24,40,91,2
2,Ignazio Abate,34,19,16,13,5,14,22,63.6,8,19,6,13,18,50,0
3,Yunis Abdelhamid,60,33,48,11,1,30,40,75.0,10,44,24,20,65,196,0
4,Mehdi Abeid,51,33,27,16,8,15,45,33.3,30,33,7,26,29,23,1
5,Charles Abi,4,4,2,1,1,2,2,100.0,0,1,0,1,0,1,0
6,David Abraham,22,14,13,8,1,11,25,44.0,14,23,12,11,24,64,0
7,Amir Abrashi,20,11,7,10,3,6,19,31.6,13,11,3,8,14,15,0
8,Francesco Acerbi,40,30,22,13,5,12,16,75.0,4,50,32,18,61,169,1
9,Afriyie Acquah,27,9,9,12,6,4,11,36.4,7,11,1,10,12,16,0
10,Tyler Adams,29,17,12,16,1,11,26,42.3,15,17,1,16,16,8,0
11,Antonio Adán,0,0,0,0,0,0,0,,0,0,0,0,0,0,0
12,Aday,9,8,2,5,2,6,7,85.7,1,1,0,1,7,17,1
13,Khaled Adénon,31,22,20,11,0,16,28,57.1,12,26,11,15,31,101,0
14,Claud Adjapong,4,2,1,3,0,1,2,50.0,1,3,1,2,1,4,0
15,Yacine Adli,7,2,2,3,2,3,9,33.3,6,3,0,3,2,0,0
16,Ali Adnan Kadhim,1,1,1,0,0,1,2,50.0,1,1,1,0,3,6,0
17,Aritz Aduriz,4,2,1,1,2,1,7,14.3,6,2,1,1,0,4,0
18,Luis Advíncula,52,38,38,12,2,21,31,67.7,10,22,2,20,19,60,1
19,Martin Agirregabiria,45,29,32,10,3,28,46,60.9,18,33,11,22,27,65,1
20,Nayef Aguerd,17,12,8,9,0,8,19,42.1,11,20,11,9,14,59,1
21,Sergio Agüero,17,9,1,10,6,5,9,55.6,4,15,1,14,9,3,0
22,Ruben Aguilar,88,51,40,33,15,39,69,56.5,30,23,3,20,37,50,1
23,Juan Aguilera,2,2,0,1,1,1,4,25.0,3,4,2,2,4,2,0
24,Emmanuel Agyemang-Badu,4,0,1,2,1,1,1,100.0,0,2,0,2,1,2,0
25,Jean-Eudes Aholou,20,11,6,11,3,8,16,50.0,8,7,0,7,17,12,0
26,Antonis Aidonis,3,1,1,1,1,1,4,25.0,3,1,0,1,2,2,0
27,Ola Aina,54,36,32,20,2,23,48,47.9,25,30,3,27,39,59,2
28,Youssef Aït Bennasser,25,13,9,12,4,13,28,46.4,15,15,2,13,19,6,2
29,Youssef Aït Bennasser,33,16,14,18,1,13,29,44.8,16,15,5,10,15,19,0
30,Rayan Aït-Nouri,2,2,1,1,0,0,1,0.0,1,0,0,0,0,1,0
31,Ludovic Ajorque,17,13,1,10,6,4,9,44.4,5,5,0,5,5,9,0
32,Manuel Akanji,29,19,14,13,2,14,25,56.0,11,22,13,9,27,92,2
33,Carlos Akapo,28,15,18,8,2,19,33,57.6,14,12,2,10,23,36,0
34,Nathan Aké,66,35,42,21,3,22,35,62.9,13,51,35,16,32,241,0
35,Sergio Akieme,3,3,3,0,0,2,2,100.0,0,0,0,0,1,5,0
36,Chadrac Akolo,9,6,2,7,0,1,3,33.3,2,7,0,7,4,1,0
37,Kevin Akpoguma,23,15,13,10,0,11,21,52.4,10,18,5,13,12,20,2
38,Kevin Akpoguma,10,6,5,5,0,6,7,85.7,1,7,2,5,10,7,2
39,David Alaba,34,21,13,13,8,17,26,65.4,9,24,3,21,31,40,0
40,Sofiane Alakouch,81,44,44,31,6,36,63,57.1,27,15,4,11,46,57,0
41,Lucas Alario,15,8,5,6,4,4,14,28.6,10,9,0,9,1,16,0
42,Jordi Alba,42,22,20,15,7,20,48,41.7,28,24,6,18,60,76,1
43,Luis Alberto,53,22,15,29,9,21,55,38.2,34,23,3,20,10,10,0
44,Raúl Albiol,16,8,12,4,0,8,15,53.3,7,19,16,3,20,90,1
45,Miiko Albornoz,46,26,31,10,5,21,45,46.7,24,23,3,20,16,37,1
46,Marc Albrighton,35,22,18,14,3,13,31,41.9,18,26,3,23,23,30,0
47,Paco Alcácer,3,1,2,0,1,0,6,0.0,6,5,0,5,6,7,0
48,Pedro Alcalá,32,23,23,9,0,15,23,65.2,8,21,18,3,36,120,0
49,Thiago Alcántara,87,65,31,44,12,25,48,52.1,23,23,4,19,44,17,1
50,Rubén Alcaraz,96,54,50,40,6,32,89,36.0,57,59,10,49,38,52,1
51,Toby Alderweireld,37,23,25,10,2,12,22,54.5,10,41,22,19,24,175,0
52,Álex Alegría,1,1,0,1,0,0,3,0.0,3,1,0,1,0,0,0
53,Alexis Alegue,1,0,0,1,0,0,0,,0,0,0,0,0,0,0
54,Iván Alejo,2,0,0,2,0,0,4,0.0,4,2,0,2,0,3,0
55,Carles Aleñá,7,4,0,6,1,2,8,25.0,6,4,0,4,2,0,0
56,Rúnar Alex Rúnarsson,2,0,2,0,0,2,6,33.3,4,0,0,0,1,7,2
57,Alexander,1,0,1,0,0,1,1,100.0,0,0,0,0,0,0,0
58,Trent Alexander-Arnold,61,39,31,22,8,36,68,52.9,32,19,3,16,35,68,0
59,Alfonso,1,1,0,1,0,1,2,50.0,1,0,0,0,1,0,0
60,Rachid Alioui,15,5,3,9,3,4,9,44.4,5,8,1,7,10,11,0
61,Alisson,2,1,2,0,0,2,2,100.0,0,0,0,0,1,14,6
62,Bobby Allain,0,0,0,0,0,0,1,0.0,1,1,0,1,0,16,1
63,Allan,106,70,39,55,12,36,107,33.6,71,55,13,42,36,28,0
64,Allan,4,4,2,2,0,0,4,0.0,4,4,2,2,0,1,0
65,Dele Alli,33,19,6,14,13,5,24,20.8,19,33,5,28,19,20,0
66,Miguel Almirón,20,12,7,10,3,4,10,40.0,6,14,1,13,8,5,0
67,Júnior Alonso,13,9,8,4,1,7,12,58.3,5,8,3,5,5,24,1
68,Marcos Alonso,73,46,44,22,7,33,58,56.9,25,25,2,23,39,101,0
69,Mickaël Alphonse,10,5,6,1,3,3,4,75.0,1,3,1,2,9,30,0
70,Sergio Álvarez,34,25,12,20,2,13,23,56.5,10,9,4,5,17,43,0
71,Sergio Álvarez,0,0,0,0,0,0,0,,0,0,0,0,0,4,0
72,Yeray Álvarez,55,30,39,14,2,19,33,57.6,14,35,16,19,63,149,1
73,Bruno Alves,15,8,11,4,0,4,7,57.1,3,36,28,8,29,210,0
74,Dani Alves,42,22,16,23,3,13,38,34.2,25,18,5,13,8,11,0
75,Ibrahim Amadou,27,20,9,15,3,2,9,22.2,7,7,4,3,11,24,0
76,Romain Amalfitano,52,33,20,28,4,25,67,37.3,42,45,13,32,47,35,0
77,Daniel Amartey,18,12,11,6,1,10,15,66.7,5,6,4,2,17,28,1
78,Jordi Amat,54,31,34,19,1,24,42,57.1,18,31,10,21,43,133,1
79,Amath,20,13,7,11,2,6,27,22.2,21,17,0,17,10,12,0
80,Jordan Amavi,74,50,34,26,14,35,56,62.5,21,24,8,16,46,93,4
81,Kelvin Amian,68,45,54,12,2,20,30,66.7,10,36,13,23,36,113,1
82,Nadiem Amiri,14,9,8,4,2,3,13,23.1,10,11,0,11,7,4,0
83,Yanis Ammour,0,0,0,0,0,0,0,,0,0,0,0,0,0,0
84,Luke Amos,1,0,0,1,0,0,0,,0,0,0,0,0,0,0
85,Joachim Andersen,40,27,31,8,1,19,31,61.3,12,30,15,15,35,147,1
86,Felipe Anderson,89,49,33,44,12,31,101,30.7,70,71,0,71,41,18,1
87,Florin Andone,10,2,3,4,3,1,6,16.7,5,9,1,8,3,12,0
88,Benjamin André,101,60,39,50,12,33,85,38.8,52,40,6,34,54,58,0
89,Marco Andreolli,1,1,1,0,0,1,1,100.0,0,2,1,1,1,5,0
90,Marco Andreolli,10,6,7,2,1,6,10,60.0,4,4,2,2,6,33,0
91,Yoann Andreu,1,0,1,0,0,0,1,0.0,1,0,0,0,1,0,0
92,José Ángel,66,46,36,23,7,31,56,55.4,25,24,5,19,41,113,1
93,Miguel Ángel Moyá,1,1,1,0,0,1,2,50.0,1,0,0,0,1,9,2
94,Cristian Ansaldi,50,26,19,21,10,15,30,50.0,15,21,4,17,15,31,0
95,Mirco Antenucci,11,9,5,1,5,1,10,10.0,9,14,0,14,5,5,0
96,Waldemar Anton,49,32,33,14,2,22,50,44.0,28,56,33,23,69,169,3
97,Luca Antonelli,13,11,4,5,4,7,17,41.2,10,19,4,15,16,25,1
98,Mauro Antonio Burruchaga,2,2,1,1,0,0,2,0.0,2,2,1,1,0,3,0
99,Michail Antonio,23,14,12,6,5,6,12,50.0,6,38,3,35,18,26,1
100,Antoñito,35,21,16,15,4,18,42,42.9,24,21,8,13,18,31,0
101,Vitorino Antunes,41,26,22,17,2,27,45,60.0,18,33,7,26,43,75,1
102,Anuar,33,19,15,16,2,6,14,42.9,8,14,1,13,11,25,1
103,Dennis Aogo,15,10,6,7,2,6,15,40.0,9,8,1,7,9,19,0
104,Houssem Aouar,63,38,28,25,10,17,61,27.9,44,33,6,27,32,25,3
105,Emmanuel Apeh,0,0,0,0,0,0,1,0.0,1,0,0,0,0,0,0
106,Mauro Arambarri,59,33,18,37,4,23,76,30.3,53,44,9,35,30,36,0
107,Guilherme Arana,11,6,5,5,1,6,7,85.7,1,6,3,3,9,8,0
108,Charles Aránguiz,48,30,21,22,5,21,66,31.8,45,31,2,29,25,27,1
109,Luiz Araújo,23,17,8,9,6,9,24,37.5,15,6,1,5,3,4,0
110,Néstor Araujo,42,22,32,9,1,18,22,81.8,4,32,21,11,35,153,1
111,Anaitz Arbilla,31,24,25,5,1,17,27,63.0,10,12,5,7,46,92,2
112,Joaquín Ardaiz,0,0,0,0,0,0,0,,0,0,0,0,0,0,0
113,Alphonse Areola,1,1,1,0,0,1,1,100.0,0,0,0,0,0,4,1
114,Santiago Arias,48,32,31,16,1,20,31,64.5,11,14,2,12,34,43,0
115,Lorenzo Ariaudo,20,14,15,4,1,6,10,60.0,4,31,20,11,14,103,0
116,Nicolò Armini,1,1,0,1,0,1,2,50.0,1,1,0,1,0,0,0
117,Yoël Armougom,31,21,20,9,2,15,29,51.7,14,9,3,6,21,66,0
118,Stuart Armstrong,28,20,14,6,8,8,42,19.0,34,14,0,14,12,12,0
119,José Arnaiz,1,1,1,0,0,0,3,0.0,3,0,0,0,2,1,0
120,Marko Arnautović,9,5,4,3,2,1,7,14.3,6,4,2,2,3,6,0
121,Maximilian Arnold,52,30,21,27,4,21,61,34.4,40,31,10,21,35,48,1
122,Kepa Arrizabalaga,1,1,1,0,0,1,2,50.0,1,1,0,1,0,4,2
123,Harry Arter,62,37,27,26,9,16,46,34.8,30,33,5,28,21,21,2
124,Kwadwo Asamoah,44,26,22,14,8,29,51,56.9,22,21,4,17,40,46,1
125,Takuma Asano,5,3,1,1,3,1,6,16.7,5,9,0,9,2,2,0
126,Santiago Ascacíbar,78,50,43,29,6,34,74,45.9,40,48,10,38,43,34,1
127,Sergio Asenjo,0,0,0,0,0,0,1,0.0,1,0,0,0,3,26,2
128,Marco Asensio,12,8,3,5,4,2,24,8.3,22,16,1,15,14,7,0
129,Iago Aspas,16,11,4,8,4,4,20,20.0,16,14,0,14,16,5,0
130,Simon Asta,6,3,4,2,0,2,2,100.0,0,2,1,1,3,1,0
131,Youcef Atal,68,44,34,25,9,34,67,50.7,33,38,8,30,56,42,0
132,Christian Atsu,24,15,9,11,4,5,16,31.3,11,13,3,10,7,16,0
133,Pierre-Emerick Aubameyang,21,17,6,9,6,8,28,28.6,20,26,0,26,8,22,0
134,Emil Audero,4,3,4,0,0,3,3,100.0,0,0,0,0,1,21,4
135,Jean-Kévin Augustin,2,0,0,0,2,0,1,0.0,1,6,0,6,3,0,0
136,Ludwig Augustinsson,53,31,25,22,6,23,39,59.0,16,37,11,26,38,86,1
137,Serge Aurier,20,12,12,4,4,8,15,53.3,7,8,2,6,7,20,0
138,Charlie Austin,13,7,3,6,4,6,11,54.5,5,12,2,10,2,13,0
139,Ezequiel Ávila,18,10,7,7,4,4,26,15.4,22,21,2,19,13,22,0
140,Jordan Ayew,38,23,12,19,7,6,20,30.0,14,16,0,16,7,6,0
141,Kaan Ayhan,53,29,38,15,0,23,47,48.9,24,34,16,18,59,118,3
142,Floyd Ayité,4,4,2,1,1,2,6,33.3,4,8,1,7,7,5,0
143,César Azpilicueta,105,60,52,40,13,38,67,56.7,29,63,16,47,43,91,3
144,Abdoulaye Ba,46,33,37,8,1,29,39,74.4,10,32,18,14,29,165,4
145,Florian Baak,0,0,0,0,0,0,0,,0,0,0,0,0,0,0
146,Ludovic Baal,4,3,3,1,0,0,0,,0,1,0,1,2,1,0
147,Khouma Babacar,7,3,2,5,0,2,10,20.0,8,8,2,6,3,25,1
148,Ryan Babel,8,4,1,5,2,3,9,33.3,6,12,0,12,6,13,1
149,Carlos Bacca,4,2,1,2,1,0,5,0.0,5,4,0,4,8,5,0
150,Juninho Bacuna,46,29,22,19,5,22,54,40.7,32,21,1,20,24,12,1
151,Leandro Bacuna,15,10,5,7,3,8,22,36.4,14,5,2,3,15,9,0
152,Milan Badelj,33,20,10,19,4,16,37,43.2,21,27,9,18,33,20,1
153,Benoît Badiashile,25,18,18,7,0,17,25,68.0,8,12,5,7,21,79,2
154,Holger Badstuber,12,4,8,4,0,7,8,87.5,1,6,2,4,9,21,1
155,Stéphane Bahoken,15,7,0,10,5,3,21,14.3,18,35,3,32,8,5,0
156,Daniel Baier,62,39,21,37,4,24,66,36.4,42,27,8,19,60,48,2
157,Leon Bailey,15,11,9,2,4,6,20,30.0,14,20,0,20,14,11,0
158,Eric Bailly,15,9,14,1,0,8,10,80.0,2,9,4,5,13,39,1
159,Leighton Baines,8,6,4,3,1,4,6,66.7,2,2,0,2,2,8,0
160,Marvin Bakalorz,18,11,7,9,2,6,36,16.7,30,29,4,25,28,47,0
161,Tiemoué Bakayoko,69,43,22,40,7,26,62,41.9,36,34,5,29,50,42,2
162,Ridle Baku,18,9,6,9,3,2,7,28.6,5,13,1,12,8,9,0
163,Fabián Balbuena,40,20,34,6,0,16,42,38.1,26,23,15,8,53,175,0
164,Keita Baldé,10,6,4,2,4,2,9,22.2,7,8,0,8,3,1,0
165,Gareth Bale,16,8,5,7,4,6,20,30.0,14,19,3,16,11,13,0
166,Mikel Balenziaga,10,6,7,1,2,5,8,62.5,3,6,2,4,2,21,0
167,Andrija Balić,1,0,0,0,1,0,1,0.0,1,0,0,0,0,1,0
168,Fodé Ballo-Touré,47,35,26,19,2,21,32,65.6,11,25,7,18,27,42,2
169,Fodé Ballo-Touré,46,31,26,16,4,20,40,50.0,20,20,2,18,28,38,2
170,Florent Balmont,29,16,16,10,3,9,36,25.0,27,13,2,11,6,8,0
171,Leon Balogun,12,6,11,1,0,8,9,88.9,1,5,3,2,17,32,1
172,Mario Balotelli,1,0,0,1,0,1,4,25.0,3,9,1,8,1,8,0
173,Mario Balotelli,5,3,1,3,1,2,7,28.6,5,8,2,6,3,6,0
174,Abdoulaye Bamba,51,29,31,14,6,24,44,54.5,20,20,4,16,37,86,0
175,Jonathan Bamba,29,19,7,17,5,13,39,33.3,26,24,1,23,41,18,0
176,Sol Bamba,74,42,44,30,0,31,55,56.4,24,72,32,40,82,181,3
177,Yacine Bammou,14,7,7,4,3,3,8,37.5,5,14,3,11,9,17,0
178,Éver Banega,71,50,32,35,4,20,70,28.6,50,26,5,21,28,28,0
179,Mattia Bani,67,40,46,21,0,27,40,67.5,13,51,35,16,57,162,2
180,Léo Baptistão,22,14,11,5,6,8,27,29.6,19,17,0,17,8,14,0
181,Antonín Barák,9,6,4,5,0,2,11,18.2,9,4,0,4,2,2,0
182,Federico Barba,30,14,21,9,0,8,21,38.1,13,29,15,14,65,129,0
183,Danilo Barbosa,29,20,13,13,3,6,17,35.3,11,17,2,15,15,25,1
184,Enis Bardhi,70,43,30,34,6,28,87,32.2,59,35,3,32,31,36,1
185,Francesco Bardi,0,0,0,0,0,0,0,,0,0,0,0,0,2,0
186,Phil Bardsley,32,19,15,14,3,12,21,57.1,9,25,12,13,31,68,1
187,Nicolò Barella,99,65,38,41,20,30,82,36.6,52,61,2,59,38,27,0
188,Philipp Bargfrede,23,15,9,12,2,10,28,35.7,18,35,11,24,34,45,1
189,Antonino Barillà,64,36,40,17,7,19,53,35.8,34,40,13,27,36,50,1
190,Ross Barkley,15,10,5,7,3,4,14,28.6,10,8,1,7,9,17,2
191,Aymen Barkok,13,6,4,9,0,4,19,21.1,15,8,1,7,4,3,0
192,Ashley Barnes,28,17,4,17,7,6,29,20.7,23,29,8,21,2,25,0
193,Harvey Barnes,10,6,5,4,1,4,6,66.7,2,7,1,6,3,7,0
194,Antonio Barragán,14,8,9,4,1,2,12,16.7,10,15,4,11,5,30,2
195,Antonio Barreca,0,0,0,0,0,0,0,,0,0,0,0,0,0,0
196,Antonio Barreca,11,8,8,3,0,7,11,63.6,4,3,2,1,7,18,0
197,Leandro Barreiro Martins,4,4,2,0,2,1,2,50.0,1,0,0,0,2,1,0
198,Ander Barrenetxea,7,2,2,0,5,2,8,25.0,6,8,0,8,4,1,0
199,Édgar Barreto,28,19,15,6,7,10,26,38.5,16,11,3,8,17,7,0
200,Musa Barrow,9,5,5,3,1,4,6,66.7,2,4,0,4,0,2,0
201,Fin Bartels,0,0,0,0,0,0,1,0.0,1,0,0,0,1,0,0
202,Marc Bartra,86,55,55,26,5,41,76,53.9,35,46,21,25,60,132,2
203,Andrea Barzagli,1,1,0,1,0,1,2,50.0,1,2,2,0,4,10,0
204,Daniele Baselli,65,45,22,34,9,16,44,36.4,28,30,6,24,34,32,0
205,Toma Bašić,32,16,5,21,6,11,31,35.5,20,13,1,12,9,22,1
206,Thomas Basila,2,1,1,1,0,0,0,,0,2,1,1,0,8,0
207,Borja Bastón,16,7,4,9,3,2,24,8.3,22,16,5,11,4,10,0
208,Alessandro Bastoni,25,12,20,5,0,6,15,40.0,9,26,18,8,22,96,0
209,Bastos,22,17,16,4,2,17,27,63.0,10,16,8,8,7,49,1
210,Michy Batshuayi,2,1,1,1,0,1,2,50.0,1,8,3,5,3,0,0
211,Michy Batshuayi,1,1,0,1,0,0,3,0.0,3,5,2,3,0,3,0
212,Robert Bauer,48,29,32,13,3,20,39,51.3,19,19,5,14,28,80,0
213,Oliver Baumann,0,0,0,0,0,0,0,,0,0,0,0,2,11,5
214,Timo Baumgartl,33,23,21,12,0,11,19,57.9,8,31,22,9,26,100,0
215,Julian Baumgartlinger,52,30,24,20,8,20,45,44.4,25,18,6,12,26,21,1
216,Christoph Baumgartner,1,0,0,0,1,1,3,33.3,2,2,0,2,0,0,0
217,Jon Bautista,5,3,0,3,2,0,3,0.0,3,8,1,7,5,4,0
218,Paul Baysse,1,0,1,0,0,0,1,0.0,1,1,1,0,1,6,0
219,Paul Baysse,25,14,20,5,0,13,18,72.2,5,25,20,5,31,113,1
220,Noah Joel Sarenren Bazee,0,0,0,0,0,0,0,,0,1,0,1,0,3,0
221,Claudio Beauvue,18,11,7,9,2,1,14,7.1,13,11,2,9,10,21,0
222,Bebé,19,9,10,4,5,9,19,47.4,10,16,1,15,9,16,1
223,Bebé,0,0,0,0,0,0,0,,0,1,0,1,1,0,0
224,Ihlas Bebou,15,9,4,10,1,4,9,44.4,5,18,2,16,9,9,0
225,Uffe Bech,0,0,0,0,0,0,1,0.0,1,0,0,0,0,0,0
226,Andreas Beck,35,19,17,17,1,11,27,40.7,16,32,6,26,22,54,0
227,Jan Bednarek,41,25,25,16,0,21,37,56.8,16,44,27,17,71,171,0
228,Andrea Beghetto,26,14,13,10,3,15,25,60.0,10,20,4,16,17,59,0
229,Asmir Begović,0,0,0,0,0,0,3,0.0,3,1,0,1,1,15,7
230,Valon Behrami,65,38,25,34,6,18,44,40.9,26,29,12,17,18,26,0
231,Hanno Behrens,46,26,29,17,0,21,47,44.7,26,43,13,30,33,49,0
232,Ishak Belfodil,13,10,5,6,2,4,16,25.0,12,6,0,6,3,14,0
233,Stefan Bell,31,20,18,13,0,15,34,44.1,19,31,11,20,54,122,1
234,Karim Bellarabi,13,6,7,4,2,3,19,15.8,16,13,0,13,10,8,0
235,Héctor Bellerín,15,12,8,4,3,6,13,46.2,7,17,5,12,20,37,3
236,Andrea Belotti,33,22,8,15,10,6,30,20.0,24,36,5,31,15,23,0
237,Fran Beltrán,23,17,8,12,3,13,31,41.9,18,19,2,17,19,15,1
238,Hatem Ben Arfa,15,7,4,8,3,7,16,43.8,9,9,0,9,4,0,0
239,Wissam Ben Yedder,18,16,3,11,4,2,12,16.7,10,18,0,18,11,2,0
240,Diego Benaglio,1,0,1,0,0,1,1,100.0,0,0,0,0,0,16,0
241,Marco Benassi,30,19,8,15,7,14,41,34.1,27,16,3,13,9,27,1
242,Medhi Benatia,7,6,6,1,0,3,5,60.0,2,10,5,5,16,18,0
243,Lars Bender,43,29,20,20,3,18,35,51.4,17,26,4,22,21,26,0
244,Sven Bender,40,25,25,15,0,18,30,60.0,12,31,14,17,52,98,0
245,László Bénes,3,1,3,0,0,3,3,100.0,0,1,0,1,0,0,0
246,Nicolas Benezet,32,19,14,15,3,5,19,26.3,14,12,0,12,19,4,0
247,Walter Benítez,1,0,1,0,0,1,2,50.0,1,0,0,0,2,6,2
248,Ismaël Bennacer,94,57,43,41,10,32,75,42.7,43,38,9,29,57,34,0
249,Joe Bennett,50,29,34,16,0,22,38,57.9,16,30,8,22,60,93,0
250,Ryan Bennett,58,32,41,16,1,25,41,61.0,16,42,21,21,43,131,1
251,Yassine Benrahou,9,6,1,7,1,2,5,40.0,3,4,0,4,2,1,0
252,Ramy Bensebaini,69,48,42,19,8,40,58,69.0,18,24,10,14,41,98,0
253,Nabil Bentaleb,32,17,8,21,3,4,18,22.2,14,28,8,20,35,19,0
254,Rodrigo Bentancur,53,34,22,29,2,18,39,46.2,21,20,8,12,43,42,1
255,Christian Benteke,5,1,0,4,1,1,4,25.0,3,7,2,5,0,14,0
256,Karim Benzema,24,11,2,11,11,2,17,11.8,15,16,1,15,8,25,0
257,Yassine Benzia,1,1,0,1,0,1,1,100.0,0,0,0,0,1,1,0
258,Domenico Berardi,38,21,16,9,13,15,73,20.5,58,31,2,29,27,24,0
259,Yuri Berchiche,46,31,26,11,9,23,46,50.0,23,34,9,25,42,82,0
260,Álex Berenguer,31,20,12,17,2,14,34,41.2,20,20,1,19,8,14,0
261,Bartosz Bereszyński,46,30,27,15,4,24,51,47.1,27,22,7,15,31,76,0
262,Jóhann Berg Guðmundsson,27,11,14,10,3,16,34,47.1,18,25,4,21,33,34,0
263,Markel Bergara,2,2,0,1,1,2,3,66.7,1,3,0,3,1,2,0
264,Robert Berić,12,5,1,9,2,1,11,9.1,10,8,2,6,4,3,0
265,Etrit Berisha,0,0,0,0,0,0,2,0.0,2,0,0,0,0,5,3
266,Valon Berisha,8,5,1,6,1,4,6,66.7,2,6,0,6,4,3,0
267,Bernard,49,30,19,22,8,15,55,27.3,40,37,2,35,27,14,1
268,Federico Bernardeschi,14,8,5,6,3,7,18,38.9,11,9,0,9,6,10,0
269,Bernardo,62,43,43,13,6,31,45,68.9,14,32,13,19,34,82,0
270,Paul Bernardoni,1,1,1,0,0,1,2,50.0,1,0,0,0,1,20,1
271,Juan Bernat,47,32,22,19,6,22,46,47.8,24,19,5,14,20,41,1
272,Antoine Bernede,13,7,3,8,2,5,9,55.6,4,3,1,2,3,1,1
273,Dimitry Bertaud,0,0,0,0,0,0,0,,0,0,0,0,0,0,0
274,Ryan Bertrand,46,27,22,20,4,16,31,51.6,15,27,5,22,28,51,0
275,Daniel Bessa,60,35,28,23,9,11,39,28.2,28,30,4,26,19,16,1
276,Marcus Bettinelli,0,0,0,0,0,0,0,,0,0,0,0,0,5,0
277,Jordan Beyer,32,18,21,10,1,17,24,70.8,7,12,6,6,11,32,0
278,Jonathan Biabiany,30,22,18,10,2,9,17,52.9,8,8,1,7,11,11,1
279,Giulian Biancone,4,3,4,0,0,1,3,33.3,2,0,0,0,3,2,0
280,Ermin Bičakčić,32,19,18,11,3,13,22,59.1,9,36,15,21,56,79,1
281,Pedro Bigas,4,3,2,0,2,1,5,20.0,4,6,2,4,8,22,0
282,Lucas Biglia,60,33,31,25,4,20,45,44.4,25,19,3,16,22,21,1
283,Philip Billing,73,44,26,39,8,19,42,45.2,23,57,16,41,53,43,0
284,Cristiano Biraghi,52,33,31,17,4,18,38,47.4,20,40,17,23,44,113,0
285,Davide Biraschi,58,38,37,19,2,25,42,59.5,17,32,13,19,64,107,1
286,Valter Birsa,5,3,1,3,1,4,8,50.0,4,5,0,5,4,3,0
287,Valter Birsa,14,9,4,7,3,4,17,23.5,13,9,1,8,6,13,0
288,Yves Bissouma,62,30,33,27,2,20,38,52.6,18,21,5,16,33,29,2
289,Leonardo Bittencourt,37,26,9,22,6,8,32,25.0,24,22,1,21,13,7,0
290,Alejandro Blanco,1,1,1,0,0,1,3,33.3,2,1,0,1,0,0,0
291,Rubén Blanco,1,0,1,0,0,1,2,50.0,1,1,0,1,2,13,2
292,Ludovic Blas,62,38,22,32,8,20,43,46.5,23,44,7,37,26,14,0
293,Pablo de Blasis,32,19,17,8,7,12,32,37.5,20,18,0,18,13,20,0
294,Pablo de Blasis,2,0,0,1,1,2,3,66.7,1,0,0,0,1,0,0
295,Alexis Blin,77,45,33,36,8,35,89,39.3,54,39,14,25,33,48,1
296,Danny Blum,0,0,0,0,0,0,0,,0,0,0,0,0,5,0
297,Emmanuel Boateng,4,3,0,0,4,0,3,0.0,3,5,0,5,1,7,0
298,Jérôme Boateng,21,15,12,9,0,10,22,45.5,12,8,3,5,25,49,0
299,Kevin-Prince Boateng,5,4,0,4,1,1,4,25.0,3,7,3,4,3,13,0
300,Kevin-Prince Boateng,3,2,0,1,2,0,1,0.0,1,1,0,1,1,4,0
301,Antonin Bobichon,34,16,17,12,5,16,58,27.6,42,15,3,12,15,13,0
302,Yann Bodiger,0,0,0,0,0,0,1,0.0,1,0,0,0,0,0,0
303,Mathieu Bodmer,15,11,3,11,1,3,10,30.0,7,3,0,3,2,10,0
304,Adam Bodzek,44,27,27,16,1,17,43,39.5,26,15,6,9,26,39,0
305,Jean-Paul Boëtius,51,32,21,25,5,16,44,36.4,28,59,2,57,37,13,0
306,Sacha Boey,0,0,0,0,0,0,0,,0,0,0,0,0,0,0
307,Jeremie Boga,7,4,5,1,1,4,14,28.6,10,19,0,19,2,4,0
308,Willy Boly,85,52,49,34,2,34,56,60.7,22,55,32,23,72,177,6
309,Léo Bonatini,1,1,0,0,1,1,5,20.0,4,1,0,1,0,0,0
310,Giacomo Bonaventura,6,2,2,4,0,2,7,28.6,5,3,0,3,7,8,0
311,Daniele Bonera,2,2,2,0,0,1,1,100.0,0,5,5,0,4,10,0
312,Gaëtan Bong,16,10,7,6,3,6,10,60.0,4,16,6,10,25,57,2
313,Kevin Bonifazi,40,24,31,8,1,15,33,45.5,18,38,21,17,36,79,0
314,Leonardo Bonucci,18,9,11,6,1,10,13,76.9,3,32,21,11,38,88,3
315,Fabio Borini,14,10,7,7,0,3,9,33.3,6,17,0,17,12,28,0
316,Robin Bormuth,7,4,7,0,0,5,10,50.0,5,6,4,2,10,49,1
317,Artur Boruc,1,0,1,0,0,1,3,33.3,2,0,0,0,0,1,0
318,Olivier Boscagli,20,12,14,4,2,9,20,45.0,11,12,1,11,17,37,0
319,Gabriel Boschilia,33,23,11,9,13,8,33,24.2,25,14,2,12,8,7,0
320,John Bostock,24,14,14,10,0,9,30,30.0,21,12,2,10,17,11,0
321,Denis Bouanga,52,32,21,22,9,13,61,21.3,48,24,3,21,20,16,0
322,Zacharie Boucher,0,0,0,0,0,0,0,,0,1,0,1,0,1,0
323,Ryad Boudebouz,14,4,4,6,4,3,8,37.5,5,9,1,8,3,9,0
324,Ryad Boudebouz,8,4,4,1,3,4,10,40.0,6,5,1,4,5,2,0
325,Sofiane Boufal,35,21,18,11,6,15,47,31.9,32,24,0,24,10,12,0
326,Nassim Boujellab,10,4,3,6,1,3,11,27.3,8,6,0,6,2,3,0
327,Arnold Bouka Moutou,3,1,2,1,0,0,4,0.0,4,1,0,1,3,1,0
328,Yassine Bounou,0,0,0,0,0,0,2,0.0,2,0,0,0,1,7,2
329,Mehdi Bourabia,51,28,23,21,7,15,46,32.6,31,28,5,23,33,32,0
330,Benjamin Bourigeaud,55,35,23,21,11,20,67,29.9,47,44,5,39,32,34,1
331,Bilal Boutobba,0,0,0,0,0,0,2,0.0,2,0,0,0,0,0,0
332,Umut Bozok,9,6,0,3,6,2,4,50.0,2,3,0,3,5,1,0
333,Filip Bradarić,26,21,11,12,3,10,20,50.0,10,13,3,10,39,50,0
334,Robbie Brady,15,7,5,5,5,6,17,35.3,11,7,1,6,7,18,1
335,Martin Braithwaite,5,3,0,0,5,0,4,0.0,4,9,0,9,3,4,0
336,Julian Brandt,27,16,13,10,4,7,43,16.3,36,27,1,26,17,12,1
337,Darko Brašanac,32,16,15,13,4,10,26,38.5,16,17,4,13,13,19,0
338,Pedro Brazão,0,0,0,0,0,0,1,0.0,1,0,0,0,0,0,0
339,Fabian Bredlow,1,1,1,0,0,1,1,100.0,0,0,0,0,1,3,4
340,Josip Brekalo,15,7,7,6,2,5,18,27.8,13,15,1,14,12,9,1
341,Gleison Bremer,3,1,1,2,0,1,2,50.0,1,4,1,3,8,9,0
342,Joshua Brenet,20,13,12,5,3,7,13,53.8,6,16,1,15,8,19,0
343,Rajko Brežančić,1,0,0,0,1,0,0,,0,0,0,0,0,0,0
344,Anthony Briançon,46,27,36,10,0,27,50,54.0,23,51,38,13,70,184,1
345,Jimmy Briand,14,8,2,10,2,4,24,16.7,20,14,6,8,4,29,0
346,Nicolò Brighenti,27,17,9,15,3,6,14,42.9,8,17,8,9,31,37,0
347,Matteo Brighi,11,4,2,9,0,2,9,22.2,7,2,0,2,3,4,0
348,Enrico Brignola,2,2,2,0,0,0,2,0.0,2,0,0,0,1,1,0
349,Miguel Britos,4,2,4,0,0,2,4,50.0,2,1,1,0,3,11,1
350,David Brooks,37,26,12,19,6,19,44,43.2,25,36,7,29,24,28,0
351,John Brooks,29,15,18,9,2,13,27,48.1,14,28,13,15,37,135,3
352,Daniel Brosinski,27,16,16,10,1,18,33,54.5,15,30,9,21,26,58,0
353,Marcelo Brozović,101,70,47,40,14,31,86,36.0,55,45,8,37,44,32,3
354,Bruma,5,2,3,1,1,1,5,20.0,4,4,0,4,4,2,0
355,Jeffrey Bruma,12,11,8,4,0,6,12,50.0,6,8,2,6,4,35,0
356,Bruno,25,16,20,3,2,14,18,77.8,4,7,2,5,11,30,1
357,Jacob Bruun Larsen,15,9,8,2,5,7,17,41.2,10,15,1,14,13,12,0
358,Joe Bryan,61,41,35,21,5,24,42,57.1,18,34,12,22,31,82,1
359,Gianluigi Buffon,0,0,0,0,0,0,1,0.0,1,0,0,0,0,5,0
360,Niko Bungert,7,5,5,2,0,5,5,100.0,0,7,6,1,4,16,0
361,Guido Burgstaller,11,9,2,5,4,3,8,37.5,5,5,0,5,2,10,0
362,Burgui,6,6,4,2,0,1,3,33.3,2,4,0,4,0,2,1
363,Jonathan Burkardt,4,4,2,1,1,1,2,50.0,1,2,0,2,3,5,0
364,Roman Bürki,1,0,1,0,0,1,2,50.0,1,1,0,1,2,8,4
365,Patrick Burner,36,23,22,10,4,16,34,47.1,18,15,5,10,31,40,0
366,Sergio Busquets,90,60,35,45,10,41,89,46.1,48,43,8,35,54,22,1
367,Gaëtan Bussmann,2,1,2,0,0,2,5,40.0,3,0,0,0,1,2,0
368,Unai Bustinza,41,31,25,14,2,17,33,51.5,16,31,13,18,53,110,2
369,Ludovic Butelle,1,0,1,0,0,1,1,100.0,0,0,0,0,1,31,1
370,David Button,0,0,0,0,0,0,0,,0,0,0,0,0,2,0
371,Jakub Błaszczykowski,0,0,0,0,0,0,0,,0,0,0,0,0,0,0
372,Erick Cabaco,22,13,19,3,0,12,29,41.4,17,29,14,15,29,69,0
373,Willy Caballero,0,0,0,0,0,0,0,,0,0,0,0,0,1,0
374,Rémy Cabella,88,51,31,38,19,30,87,34.5,57,39,1,38,19,5,3
375,Gustavo Cabral,37,26,28,7,2,17,27,63.0,10,31,11,20,33,102,1
376,Rafael Cabral,0,0,0,0,0,0,0,,0,0,0,0,0,0,0
377,Leandro Cabrera,47,26,28,17,2,24,41,58.5,17,29,16,13,52,216,2
378,Fabrizio Cacciatore,9,7,7,0,2,1,5,20.0,4,6,4,2,7,17,0
379,Fabrizio Cacciatore,8,4,6,2,0,4,9,44.4,5,8,2,6,5,20,0
380,Martín Cáceres,4,2,3,1,0,4,6,66.7,2,4,0,4,0,12,1
381,Martín Cáceres,7,3,6,0,1,4,4,100.0,0,6,3,3,4,14,0
382,Anthony Caci,56,30,38,14,4,24,46,52.2,22,20,10,10,47,63,0
383,Mathieu Cafaro,59,28,29,24,6,18,63,28.6,45,28,0,28,20,14,0
384,Gary Cahill,0,0,0,0,0,0,0,,0,0,0,0,0,1,0
385,Yannick Cahuzac,33,19,15,15,3,17,32,53.1,15,16,4,12,24,55,0
386,Felipe Caicedo,16,12,4,6,6,1,8,12.5,7,9,2,7,5,5,0
387,Marc-Aurèle Caillard,0,0,0,0,0,0,2,0.0,2,0,0,0,2,8,3
388,Tom Cairney,37,21,9,22,6,12,16,75.0,4,21,5,16,10,13,1
389,Caiuby,12,10,5,6,1,3,11,27.3,8,16,1,15,5,10,0
390,Arturo Calabresi,46,27,22,17,7,22,40,55.0,18,18,3,15,34,60,0
391,Davide Calabria,79,51,58,16,5,37,67,55.2,30,33,1,32,32,78,1
392,Jordi Calavera,0,0,0,0,0,0,0,,0,0,0,0,0,0,0
393,Fernando Calero,51,31,33,18,0,23,38,60.5,15,55,31,24,55,170,0
394,Duje Ćaleta-Car,22,16,14,8,0,14,18,77.8,4,15,9,6,20,86,2
395,Hakan Çalhanoğlu,52,31,27,16,9,23,46,50.0,23,27,5,22,28,19,0
396,Daniel Caligiuri,93,52,55,29,9,44,103,42.7,59,66,10,56,50,72,1
397,José Callejón,34,18,12,14,8,18,57,31.6,39,34,5,29,22,11,0
398,Jonathan Calleri,20,13,3,11,6,1,24,4.2,23,34,7,27,7,53,0
399,Jan-Ingwer Callsen-Bracker,0,0,0,0,0,0,0,,0,0,0,0,0,0,0
400,Dominic Calvert-Lewin,13,7,3,3,7,7,15,46.7,8,16,3,13,7,19,0
401,Ignacio Camacho,15,9,9,6,0,3,7,42.9,4,7,2,5,18,12,0
402,Juanjo Camacho,1,1,1,0,0,1,1,100.0,0,0,0,0,0,1,0
403,Rafael Camacho,1,0,1,0,0,1,1,100.0,0,0,0,0,0,0,0
404,Mahdi Camara,0,0,0,0,0,0,0,,0,0,0,0,0,2,0
405,Souleymane Camara,0,0,0,0,0,0,2,0.0,2,0,0,0,0,3,0
406,Víctor Camarasa,28,15,8,15,5,6,31,19.4,25,17,2,15,33,28,1
407,Eduardo Camavinga,23,15,8,12,3,8,18,44.4,10,13,2,11,4,4,0
408,Sergio Camello,1,0,1,0,0,1,1,100.0,0,0,0,0,0,0,0
409,José Campaña,65,45,31,29,5,27,86,31.4,59,51,7,44,48,46,1
410,Joel Campbell,15,10,5,8,2,3,17,17.6,14,2,0,2,3,2,1
411,Emre Can,64,38,28,27,9,24,40,60.0,16,43,13,30,28,36,2
412,Sergio Canales,44,30,19,18,7,11,53,20.8,42,34,3,31,9,8,1
413,João Cancelo,43,28,18,18,7,27,49,55.1,22,14,4,10,15,48,0
414,Antonio Candreva,1,1,0,1,0,1,8,12.5,7,0,0,0,4,9,0
415,Ander Capa,43,27,32,8,3,13,27,48.1,14,20,2,18,30,47,0
416,Luan Capanni,1,1,0,0,1,0,0,,0,0,0,0,0,0,0
417,Pierrick Capelle,51,31,23,22,6,19,54,35.2,35,23,2,21,38,49,0
418,Leonardo Capezzi,14,9,6,8,0,7,13,53.8,6,14,4,10,10,13,0
419,Étienne Capoue,91,56,36,48,7,33,87,37.9,54,50,13,37,85,96,1
420,Gianluca Caprari,15,9,4,9,2,5,12,41.7,7,7,0,7,4,3,0
421,Marco Capuano,53,33,37,15,1,26,46,56.5,20,44,31,13,34,101,2
422,Francesco Caputo,13,9,2,4,7,3,10,30.0,7,11,1,10,2,11,0
423,Yoan Cardinale,1,0,1,0,0,1,1,100.0,0,0,0,0,0,1,0
424,Marc Cardona,7,5,2,1,4,2,6,33.3,4,7,0,7,1,3,0
425,Diego Carlos,58,34,43,14,1,26,33,78.8,7,44,31,13,50,186,1
426,Jonas Carls,5,2,4,0,1,5,5,100.0,0,0,0,0,1,0,0
427,Louis Carnot,0,0,0,0,0,0,0,,0,0,0,0,0,0,0
428,Lionel Carole,25,12,16,7,2,11,16,68.8,5,19,5,14,32,51,0
429,Daniel Carriço,35,18,23,11,1,12,20,60.0,8,19,12,7,31,104,1
430,Guido Carrillo,25,14,4,12,9,6,19,31.6,13,12,1,11,8,25,0
431,Andy Carroll,4,2,1,3,0,1,4,25.0,3,3,2,1,1,8,0
432,Dani Carvajal,40,24,17,15,8,18,41,43.9,23,31,7,24,26,35,0
433,William Carvalho,45,27,20,21,4,16,29,55.2,13,8,0,8,12,30,0
434,Casemiro,86,52,44,35,7,38,94,40.4,56,52,12,40,41,56,3
435,Santiago Cáseres,67,35,20,38,9,25,57,43.9,32,22,9,13,14,24,1
436,Moreto Cassamã,3,3,1,2,0,1,7,14.3,6,1,0,1,1,2,0
437,Francesco Cassata,20,11,12,4,4,9,23,39.1,14,8,1,7,6,15,1
438,Timothy Castagne,61,39,30,22,9,32,57,56.1,25,32,6,26,28,50,0
439,Koen Casteels,1,0,1,0,0,1,2,50.0,1,1,0,1,0,11,1
440,Samu Castillejo,15,10,10,2,3,4,25,16.0,21,16,0,16,8,11,0
441,Gonzalo Castro,50,28,21,25,4,19,43,44.2,24,23,5,18,29,22,1
442,Jonny Castro,79,43,42,33,4,31,60,51.7,29,45,8,37,60,64,2
443,Lucas Castro,18,11,8,8,2,8,23,34.8,15,20,4,16,17,6,0
444,Danilo Cataldi,12,7,4,5,3,2,9,22.2,7,3,0,3,7,6,0
445,Catena,4,4,3,1,0,2,2,100.0,0,4,2,2,8,8,0
446,Craig Cathcart,50,31,36,11,3,21,37,56.8,16,42,30,12,38,184,4
447,Ivan Cavaleiro,5,4,3,1,1,1,14,7.1,13,12,0,12,4,5,0
448,Edinson Cavani,11,8,1,4,6,3,13,23.1,10,11,2,9,6,16,0
449,Santi Cazorla,69,34,32,26,11,24,69,34.8,45,35,6,29,28,17,1
450,Dani Ceballos,32,21,9,16,7,11,31,35.5,20,26,1,25,15,6,0
451,Federico Ceccherini,13,10,8,3,2,5,9,55.6,4,12,8,4,21,40,0
452,Petr Čech,1,1,1,0,0,1,1,100.0,0,0,0,0,0,5,2
453,Žan Celar,0,0,0,0,0,0,0,,0,0,0,0,0,0,0
454,Zeki Çelik,90,59,40,39,11,36,89,40.4,53,34,5,29,34,89,1
455,Luca Ceppitelli,40,24,28,11,1,13,22,59.1,9,34,24,10,20,111,2
456,Fabio Ceravolo,5,1,2,1,2,1,11,9.1,10,9,1,8,2,19,0
457,Alberto Cerri,3,2,2,1,0,0,7,0.0,7,7,1,6,2,4,0
458,Boštjan Cesar,16,10,9,7,0,7,17,41.2,10,14,8,6,14,60,2
459,Nacer Chadli,11,5,4,4,3,3,8,37.5,5,7,1,6,3,7,0
460,Fouad Chafik,44,31,29,12,3,23,36,63.9,13,17,3,14,25,71,0
461,Nathaniel Chalobah,3,2,1,2,0,2,7,28.6,5,2,1,1,5,7,0
462,Calum Chambers,64,36,32,27,5,16,48,33.3,32,37,12,25,69,113,4
463,Timothy Chandler,0,0,0,0,0,0,0,,0,0,0,0,0,0,0
464,Kwon Chang-hoon,7,4,3,2,2,0,12,0.0,12,16,0,16,8,8,0
465,Charles,7,5,1,3,3,2,13,15.4,11,14,1,13,4,14,0
466,Xavier Chavalerin,106,61,56,39,11,28,72,38.9,44,44,12,32,72,39,1
467,Pablo Chavarría,20,12,8,6,6,3,15,20.0,12,11,0,11,4,19,0
468,Chechu,0,0,0,0,0,0,2,0.0,2,0,0,0,2,5,0
469,Pape Cheikh Diop,1,0,0,1,0,0,5,0.0,5,6,2,4,2,2,1
470,Chema,27,19,16,9,2,13,19,68.4,6,19,11,8,19,83,0
471,Denis Cheryshev,46,32,15,22,9,17,37,45.9,20,35,3,32,15,16,0
472,Raman Chibsah,46,27,25,19,2,16,54,29.6,38,45,10,35,32,28,1
473,Leandro Chichizola,0,0,0,0,0,0,0,,0,0,0,0,0,1,0
474,Giorgio Chiellini,24,13,20,2,2,5,8,62.5,3,22,15,7,30,96,1
475,Federico Chiesa,46,27,8,17,21,10,40,25.0,30,24,1,23,10,12,0
476,Ben Chilwell,55,29,34,18,3,24,55,43.6,31,37,7,30,38,156,0
477,Vlad Chiricheș,2,1,1,1,0,0,2,0.0,2,2,2,0,1,2,0
478,Tahith Chong,0,0,0,0,0,0,0,,0,1,0,1,0,1,0
479,Hamza Choudhury,24,10,13,10,1,9,15,60.0,6,12,3,9,15,13,0
480,Andreas Christensen,10,4,2,6,2,2,5,40.0,3,4,2,2,4,29,0
481,Cyrus Christie,43,23,26,13,4,18,41,43.9,23,25,11,14,29,96,1
482,Samuel Chukwueze,19,11,7,10,2,9,31,29.0,22,11,2,9,10,2,0
483,Camillo Ciano,33,15,12,10,11,8,50,16.0,42,28,4,24,8,16,0
484,Amato Ciciretti,1,0,1,0,0,0,0,,0,3,0,3,3,0,0
485,Luca Cigarini,54,33,27,22,5,28,63,44.4,35,28,5,23,26,41,0
486,Per Ciljan Skjelbred,26,18,13,12,1,5,22,22.7,17,10,1,9,20,14,0
487,Jasper Cillessen,0,0,0,0,0,0,0,,0,0,0,0,0,3,2
488,Laurent Ciman,11,6,9,2,0,7,16,43.8,9,13,9,4,7,37,0
489,Daniel Ciofani,8,6,2,5,1,3,7,42.9,4,4,0,4,3,9,0
490,Thiago Cionek,75,44,46,25,4,29,56,51.8,27,34,22,12,55,144,0
491,Ibrahima Cissé,0,0,0,0,0,0,1,0.0,1,0,0,0,3,4,0
492,Till Cissokho,1,0,1,0,0,0,0,,0,0,0,0,2,3,0
493,Ciaran Clark,20,17,15,5,0,9,12,75.0,3,11,7,4,12,58,0
494,Tom Cleverley,17,9,11,4,2,6,22,27.3,16,4,0,4,5,11,0
495,Nathaniel Clyne,33,18,16,14,3,11,23,47.8,12,13,3,10,16,33,1
496,Nathaniel Clyne,4,3,2,2,0,2,4,50.0,2,1,0,1,2,1,0
497,Conor Coady,31,19,26,5,0,17,32,53.1,15,35,27,8,30,133,3
498,Marcus Coco,39,23,20,10,9,16,33,48.5,17,24,0,24,23,14,0
499,Coke,44,27,24,17,3,26,56,46.4,30,18,8,10,40,54,1
500,Joel Coleman,0,0,0,0,0,0,0,,0,0,0,0,0,0,0
501,Séamus Coleman,44,25,23,18,3,19,30,63.3,11,14,5,9,26,86,0
502,Álex Collado,1,0,0,1,0,0,1,0.0,1,3,0,3,0,2,0
503,Omar Colley,18,11,12,6,0,12,13,92.3,1,24,16,8,22,102,0
504,Racine Coly,7,2,1,5,1,4,11,36.4,7,6,1,5,9,11,1
505,Kingsley Coman,11,6,4,4,3,6,19,31.6,13,20,0,20,5,3,0
506,Santi Comesaña,56,35,29,25,2,22,61,36.1,39,30,5,25,30,45,2
507,Daniel Congré,75,45,46,26,3,38,65,58.5,27,35,15,20,67,106,1
508,Andrea Consigli,0,0,0,0,0,0,2,0.0,2,0,0,0,1,15,6
509,Andrea Conti,9,5,3,4,2,2,9,22.2,7,4,0,4,15,12,1
510,Lewis Cook,13,6,6,7,0,8,19,42.1,11,8,2,6,8,7,1
511,Steve Cook,36,19,31,5,0,20,27,74.1,7,36,21,15,50,202,1
512,Duje Čop,5,4,1,2,2,0,8,0.0,8,8,3,5,3,3,0
513,Francis Coquelin,46,31,25,14,7,17,35,48.6,18,21,5,16,49,29,1
514,Gabriele Corbo,0,0,0,0,0,0,0,,0,0,0,0,0,0,0
515,Iñigo Córdoba,37,23,15,17,5,14,47,29.8,33,27,0,27,17,13,0
516,Sergio Córdova,9,5,3,4,2,2,6,33.3,4,0,0,0,3,5,0
517,Benjamin Corgnet,21,12,7,9,5,4,11,36.4,7,1,0,1,6,9,0
518,Ante Ćorić,0,0,0,0,0,0,0,,0,0,0,0,0,0,0
519,Jack Cork,51,27,12,34,5,18,46,39.1,28,39,16,23,29,82,2
520,Andreas Cornelius,4,1,1,3,0,1,4,25.0,3,4,1,3,1,21,0
521,Maxwel Cornet,14,11,4,7,3,1,11,9.1,10,10,0,10,5,8,0
522,Quentin Cornette,5,1,2,2,1,3,6,50.0,3,3,0,3,1,5,0
523,Ángel Correa,38,19,19,12,7,10,53,18.9,43,28,5,23,17,20,0
524,Joaquín Correa,21,13,6,12,3,5,18,27.8,13,14,3,11,2,7,0
525,Danny da Costa,61,35,29,25,7,18,42,42.9,24,51,9,42,32,67,0
526,Diego Costa,4,1,0,4,0,1,8,12.5,7,5,0,5,2,6,0
527,Douglas Costa,10,8,2,8,0,4,9,44.4,5,8,0,8,4,2,0
528,Filippo Costa,15,13,6,6,3,4,9,44.4,5,10,3,7,8,31,1
529,Hélder Costa,18,14,7,7,4,7,23,30.4,16,15,0,15,9,6,0
530,Jaume Costa,33,21,26,5,2,20,33,60.6,13,12,3,9,21,61,0
531,Nuno da Costa,39,27,10,19,10,10,38,26.3,28,24,1,23,14,9,0
532,David Costas,25,13,21,4,0,10,15,66.7,5,12,6,6,18,58,1
533,Benoît Costil,2,0,2,0,0,2,2,100.0,0,0,0,0,0,14,3
534,Kalifa Coulibaly,15,7,1,10,4,4,11,36.4,7,8,1,7,4,22,0
535,Senou Coulibaly,13,7,10,3,0,3,8,37.5,5,8,2,6,11,20,0
536,Thibaut Courtois,0,0,0,0,0,0,2,0.0,2,0,0,0,2,5,0
537,Philippe Coutinho,16,11,1,6,9,7,22,31.8,15,21,2,19,12,8,0
538,Nicolas Cozza,19,15,14,5,0,4,10,40.0,6,13,10,3,23,37,1
539,Alessio Cragno,0,0,0,0,0,0,1,0.0,1,0,0,0,2,19,1
540,Aaron Cresswell,29,16,14,11,4,13,25,52.0,12,28,7,21,23,58,0
541,Domenico Criscito,111,75,64,36,11,57,83,68.7,26,40,11,29,70,142,0
542,Lorenzo Crisetig,14,11,4,8,2,6,15,40.0,9,8,3,5,12,12,0
543,Bryan Cristante,63,34,21,35,7,19,49,38.8,30,37,5,32,29,48,0
544,Sebastián Cristóforo,15,8,4,8,3,5,14,35.7,9,13,0,13,8,5,0
545,Enzo Crivelli,20,14,10,8,2,8,13,61.5,5,5,0,5,4,28,1
546,Peter Crouch,1,1,0,1,0,1,1,100.0,0,0,0,0,0,2,0
547,Alessio da Cruz,2,1,0,2,0,0,1,0.0,1,0,0,0,0,0,0
548,Juan Cuadrado,20,15,6,9,5,5,23,21.7,18,14,3,11,18,11,0
549,Cucho,22,13,6,10,6,6,18,33.3,12,23,2,21,9,21,0
550,Marc Cucurella,49,37,13,21,15,10,23,43.5,13,36,3,33,20,24,0
551,Iván Cuéllar,0,0,0,0,0,0,1,0.0,1,0,0,0,2,10,0
552,Mickaël Cuisance,11,6,6,3,2,3,8,37.5,5,3,0,3,5,4,0
553,Matheus Cunha,10,6,3,5,2,3,13,23.1,10,13,1,12,4,8,0
554,Greg Cunningham,18,7,11,4,3,9,16,56.3,7,9,3,6,17,16,1
555,Patrick Cutrone,9,5,0,3,6,2,16,12.5,14,13,2,11,7,13,0
556,Wylan Cyprien,40,20,16,21,3,15,43,34.9,28,20,5,15,11,15,0
557,Marco D'Alessandro,55,34,34,15,6,29,49,59.2,20,24,2,22,9,50,1
558,Danilo D'Ambrosio,69,40,34,27,8,24,57,42.1,33,25,8,17,27,39,0
559,Damien Da Silva,41,25,31,9,1,18,24,75.0,6,42,36,6,39,152,0
560,Kouadio-Yves Dabila,11,6,10,1,0,5,6,83.3,1,13,9,4,6,44,0
561,Abdoulaye Dabo,3,1,1,0,2,0,0,,0,0,0,0,0,0,0
562,Bryan Dabo,10,6,1,8,1,1,6,16.7,5,11,6,5,10,21,0
563,Christoph Daferner,1,0,1,0,0,0,0,,0,0,0,0,1,0,0
564,Colin Dagba,24,12,10,12,2,13,19,68.4,6,10,0,10,9,10,1
565,Mahmoud Dahoud,16,10,4,10,2,3,15,20.0,12,10,0,10,17,8,0
566,Leon Dajaku,2,1,0,1,1,0,0,,0,1,0,1,0,0,0
567,Felipe dal Belo,36,25,21,13,2,16,32,50.0,16,29,18,11,17,88,1
568,Nicola Dalmonte,2,2,0,2,0,0,0,,0,0,0,0,0,0,0
569,Diogo Dalot,24,12,8,14,2,14,19,73.7,5,15,2,13,10,35,1
570,Matty Daly,0,0,0,0,0,0,0,,0,0,0,0,0,0,0
571,Vitalie Damașcan,1,1,0,1,0,1,1,100.0,0,0,0,0,0,0,0
572,Loïc Damour,0,0,0,0,0,0,1,0.0,1,0,0,0,0,0,0
573,Charlie Daniels,25,15,18,6,1,13,22,59.1,9,14,4,10,20,56,2
574,Danilo,20,16,6,12,2,12,17,70.6,5,5,0,5,15,22,1
575,Scott Dann,6,2,5,1,0,3,7,42.9,4,16,12,4,5,46,0
576,Kevin Danso,25,14,21,3,1,11,14,78.6,3,25,17,8,19,72,0
577,Dante,54,40,36,16,2,24,41,58.5,17,56,30,26,38,156,2
578,Palkó Dárdai,1,1,1,0,0,0,0,,0,1,0,1,0,0,0
579,Sergi Darder,60,35,23,32,5,25,69,36.2,44,18,3,15,22,30,0
580,Vladimír Darida,8,5,3,4,1,2,3,66.7,1,5,0,5,8,5,0
581,Matteo Darmian,14,8,10,4,0,4,11,36.4,7,9,0,9,7,20,0
582,Alphonso Davies,1,1,1,0,0,0,0,,0,2,0,2,2,1,0
583,Ben Davies,56,30,39,13,4,38,54,70.4,16,23,10,13,23,68,1
584,Tom Davies,27,17,9,17,1,7,23,30.4,16,15,1,14,16,9,1
585,Steven Davis,2,2,0,2,0,0,0,,0,2,0,2,1,5,0
586,Kevin De Bruyne,22,15,6,12,4,7,21,33.3,14,13,1,12,3,2,1
587,Sebastien De Maio,11,7,7,4,0,3,12,25.0,9,22,17,5,12,93,0
588,Sebastien De Maio,5,4,3,2,0,1,2,50.0,1,8,5,3,1,32,0
589,Rodrigo De Paul,53,33,21,27,5,13,42,31.0,29,35,2,33,32,28,0
590,Daniele De Rossi,16,10,6,7,3,3,14,21.4,11,18,12,6,26,33,0
591,Mattia De Sciglio,40,28,24,14,2,17,28,60.7,11,18,6,12,26,58,1
592,Lorenzo De Silvestri,15,11,8,5,2,7,24,29.2,17,53,3,50,22,69,2
593,Lucas Deaux,41,28,21,18,2,20,41,48.8,21,10,0,10,11,7,0
594,Mathieu Debuchy,43,26,25,13,5,22,37,59.5,15,17,7,10,47,64,0
595,Troy Deeney,24,14,8,10,6,7,32,21.9,25,22,4,18,7,29,0
596,Jermain Defoe,0,0,0,0,0,0,0,,0,0,0,0,0,0,0
597,Steven Defour,8,4,2,4,2,3,14,21.4,11,11,3,8,8,7,0
598,Grégoire Defrel,40,29,10,16,14,9,21,42.9,12,15,0,15,3,9,0
599,Alessandro Deiola,7,3,1,6,0,3,13,23.1,10,14,0,14,6,8,0
600,Alessandro Deiola,12,8,4,7,1,4,10,40.0,6,15,4,11,11,10,0
601,Romain Del Castillo,36,20,15,13,8,13,37,35.1,24,19,0,19,20,7,1
602,Thomas Delaney,69,54,28,39,2,19,30,63.3,11,30,9,21,58,43,0
603,Moisés Delgado,7,6,3,3,1,2,3,66.7,1,2,1,1,3,9,0
604,Cristian Dell'Orco,18,11,11,5,2,4,11,36.4,7,13,7,6,17,44,0
605,Cristian Dell'Orco,1,1,1,0,0,1,3,33.3,2,1,0,1,1,3,0
606,Andy Delort,34,20,7,20,7,8,34,23.5,26,28,7,21,4,7,0
607,Fabian Delph,23,14,11,7,5,12,23,52.2,11,3,0,3,13,19,1
608,Mousa Dembélé,13,9,6,6,1,4,7,57.1,3,4,1,3,7,5,2
609,Moussa Dembélé,12,4,0,8,4,4,14,28.6,10,15,2,13,2,13,0
610,Ousmane Dembélé,23,15,4,13,6,6,18,33.3,12,13,0,13,5,4,0
611,Jessy Deminguet,37,25,18,17,2,15,40,37.5,25,19,3,16,18,28,1
612,Merih Demiral,24,16,23,1,0,10,13,76.9,3,16,11,5,19,80,0
613,Kerem Demirbay,57,35,20,27,10,11,51,21.6,40,34,10,24,22,25,0
614,Diego Demme,75,47,24,43,8,33,67,49.3,34,36,3,33,26,15,0
615,Jason Denayer,33,21,22,11,0,16,24,66.7,8,36,32,4,26,122,1
616,Leander Dendoncker,53,26,25,25,3,16,47,34.0,31,35,6,29,23,34,1
617,Fabio Depaoli,74,43,37,32,5,34,67,50.7,33,42,16,26,35,99,3
618,Laurent Depoitre,6,4,2,3,1,0,3,0.0,3,9,0,9,2,8,0
619,Clément Depres,2,2,1,1,0,1,4,25.0,3,3,0,3,0,6,0
620,Kiril Despodov,0,0,0,0,0,0,1,0.0,1,1,0,1,0,0,0
621,Daniele Dessena,2,2,0,2,0,1,3,33.3,2,3,1,2,3,5,0
622,Mattia Destro,3,2,2,0,1,0,0,,0,4,0,4,0,6,0
623,Gerard Deulofeu,11,6,5,3,3,4,26,15.4,22,16,0,16,14,3,0
624,Jacopo Dezi,1,1,1,0,0,0,1,0.0,1,1,0,1,3,2,0
625,Federico Di Francesco,10,6,3,4,3,4,7,57.1,3,12,1,11,5,5,0
626,Antonio Di Gaudio,2,0,0,1,1,1,5,20.0,4,6,1,5,3,5,0
627,Giovanni Di Lorenzo,66,43,38,23,5,24,44,54.5,20,34,13,21,36,93,3
628,Ángel Di María,29,17,12,10,7,10,42,23.8,32,24,1,23,16,4,0
629,Franco Di Santo,2,2,1,0,1,1,2,50.0,1,0,0,0,0,2,0
630,Franco Di Santo,2,1,0,2,0,1,4,25.0,3,3,1,2,1,3,0
631,Boulaye Dia,12,6,3,8,1,5,11,45.5,6,4,2,2,4,9,0
632,Fousseni Diabaté,2,0,2,0,0,0,1,0.0,1,2,0,2,0,0,0
633,Moussa Diaby,14,8,7,2,5,2,11,18.2,9,7,1,6,12,6,0
634,Adama Diakhaby,6,3,4,1,1,3,11,27.3,8,7,0,7,1,2,0
635,Mouctar Diakhaby,14,8,10,4,0,5,10,50.0,5,24,16,8,20,94,1
636,Bafodé Diakité,15,7,5,9,1,10,14,71.4,4,15,3,12,11,29,0
637,Abdou Diallo,36,20,20,13,3,11,15,73.3,4,28,15,13,26,91,1
638,Abdoulaye Diallo,1,1,1,0,0,1,1,100.0,0,0,0,0,0,1,0
639,Mustapha Diallo,16,11,6,9,1,5,13,38.5,8,7,1,6,10,14,1
640,Mohamed Diamé,76,46,35,36,5,16,54,29.6,38,42,9,33,30,39,1
641,Grady Diangana,20,9,8,8,4,5,14,35.7,9,11,0,11,1,4,0
642,Lassana Diarra,2,1,0,2,0,0,1,0.0,1,0,0,0,2,3,0
643,Amadou Diawara,12,4,1,9,2,4,5,80.0,1,6,0,6,11,12,0
644,Brahim Díaz,9,7,5,4,0,3,8,37.5,5,2,0,2,0,0,0
645,Javier Díaz,0,0,0,0,0,0,0,,0,0,0,0,0,0,0
646,Bakaye Dibassy,38,26,18,16,4,18,27,66.7,9,40,21,19,44,102,0
647,Lorenzo Dickmann,5,4,4,1,0,5,7,71.4,2,0,0,0,1,5,0
648,Daniel Didavi,21,15,8,10,3,7,20,35.0,13,11,1,10,4,5,0
649,Étienne Didot,41,29,12,27,2,17,44,38.6,27,37,10,27,37,35,0
650,Adrián Diéguez,16,10,11,4,1,9,16,56.3,7,9,4,5,12,46,1
651,Eric Dier,26,16,7,15,4,19,47,40.4,28,27,12,15,21,46,1
652,Tim Dierßen,0,0,0,0,0,0,0,,0,1,0,1,0,0,0
653,Lucas Digne,71,46,45,18,8,28,45,62.2,17,43,9,34,60,116,0
654,Mitchell Dijks,30,18,19,7,4,13,36,36.1,23,18,1,17,23,49,0
655,Javairô Dilrosun,14,10,7,5,2,3,7,42.9,4,18,2,16,7,9,0
656,Federico Dimarco,22,7,10,8,4,10,20,50.0,10,13,6,7,15,27,0
657,Stole Dimitrievski,0,0,0,0,0,0,1,0.0,1,0,0,0,0,8,1
658,Tristan Dingomé,27,15,11,10,6,7,24,29.2,17,16,3,13,11,5,0
659,Ismaël Diomandé,28,15,15,12,1,11,20,55.0,9,17,7,10,10,37,0
660,Federico Dionisi,3,1,0,2,1,0,2,0.0,2,0,0,0,0,0,0
661,Lois Diony,17,12,3,9,5,4,10,40.0,6,14,0,14,1,9,0
662,Issa Diop,68,38,47,21,0,37,57,64.9,20,58,36,22,64,161,4
663,Papakouli Diop,66,40,14,44,8,14,34,41.2,20,21,1,20,37,27,0
664,Sofiane Diop,12,7,3,6,3,1,15,6.7,14,6,0,6,8,6,0
665,Assane Dioussé,24,16,11,8,5,10,23,43.5,13,14,4,10,19,13,2
666,Assane Dioussé,6,4,3,3,0,2,4,50.0,2,2,0,2,1,7,1
667,Axel Disasi,2,1,1,1,0,1,2,50.0,1,2,1,1,2,16,0
668,Djené,54,34,43,11,0,26,43,60.5,17,27,11,16,74,154,3
669,Koffi Djidji,37,23,27,9,1,12,20,60.0,8,26,19,7,24,72,1
670,Koffi Djidji,1,1,1,0,0,0,0,,0,1,1,0,1,3,0
671,Alexander Djiku,48,37,33,13,2,23,43,53.5,20,56,31,25,83,183,3
672,Papy Djilobodji,1,1,1,0,0,0,0,,0,4,2,2,0,11,0
673,Berat Djimsiti,32,22,18,12,2,13,29,44.8,16,21,11,10,34,96,0
674,Johan Djourou,3,1,3,0,0,2,2,100.0,0,5,3,2,4,20,0
675,Marko Dmitrović,0,0,0,0,0,0,0,,0,0,0,0,2,11,3
676,Matt Doherty,67,42,48,15,4,35,58,60.3,23,49,7,42,60,107,2
677,Keagan Dolly,1,1,0,1,0,0,3,0.0,3,0,0,0,0,0,0
678,Jaume Doménech,0,0,0,0,0,0,1,0.0,1,0,0,0,0,1,0
679,Giulio Donati,9,7,6,3,0,8,10,80.0,2,5,3,2,16,24,0
680,Ji Dong-won,10,6,5,3,2,6,16,37.5,10,13,2,11,8,10,0
681,Anastasios Donis,15,13,8,4,3,3,11,27.3,8,7,0,7,4,0,0
682,Gianluigi Donnarumma,1,1,1,0,0,1,2,50.0,1,0,0,0,1,13,3
683,Godfred Donsah,3,1,3,0,0,3,5,60.0,2,4,2,2,0,7,0
684,Riccardo Doratiotto,1,1,0,0,1,0,0,,0,0,0,0,0,0,0
685,Mathieu Dossevi,42,28,20,11,11,13,40,32.5,27,29,1,28,33,13,0
686,Abdoulaye Doucouré,71,38,27,32,12,19,57,33.3,38,31,8,23,34,55,5
687,Cheick Doukouré,13,7,3,7,3,4,15,26.7,11,10,2,8,3,3,1
688,Moussa Doumbia,28,13,13,13,2,11,39,28.2,28,7,2,5,7,13,0
689,Seydou Doumbia,5,1,1,2,2,0,2,0.0,2,2,0,2,3,1,0
690,Souleyman Doumbia,11,7,9,2,0,6,10,60.0,4,6,1,5,4,20,0
691,Aleksandar Dragović,18,12,14,4,0,9,14,64.3,5,15,8,7,25,66,0
692,Bartłomiej Drągowski,0,0,0,0,0,0,0,,0,0,0,0,0,2,0
693,Bartłomiej Drągowski,0,0,0,0,0,0,1,0.0,1,0,0,0,0,7,1
694,Julian Draxler,41,22,11,19,11,16,43,37.2,27,20,1,19,15,2,1
695,Luke Dreher,0,0,0,0,0,0,0,,0,0,0,0,0,0,0
696,Josip Drmić,2,0,0,2,0,1,2,50.0,1,1,0,1,1,0,0
697,Jaroslav Drobný,0,0,0,0,0,0,0,,0,0,0,0,0,1,0
698,Óscar Duarte,12,5,7,5,0,4,7,57.1,3,7,7,0,13,34,0
699,Rubén Duarte,72,35,45,20,7,34,64,53.1,30,46,12,34,57,130,1
700,Leo Dubois,51,22,25,21,5,20,35,57.1,15,30,10,20,22,61,1
701,Martin Dúbravka,2,0,2,0,0,1,3,33.3,2,0,0,0,0,20,5
702,Marvin Ducksch,3,1,0,2,1,1,5,20.0,4,4,0,4,4,11,0
703,Ondrej Duda,54,33,13,35,6,15,55,27.3,40,36,4,32,15,17,1
704,Shane Duffy,35,20,23,7,5,14,25,56.0,11,57,47,10,36,244,3
705,Demeaco Duhaney,1,0,1,0,0,1,3,33.3,2,2,0,2,1,1,0
706,Paul Dummett,34,22,24,9,1,19,32,59.4,13,25,11,14,37,133,0
707,Alfred Duncan,33,21,15,15,3,19,48,39.6,29,20,6,14,15,18,0
708,Lewis Dunk,42,26,31,10,1,17,39,43.6,22,49,38,11,46,196,5
709,Maxime Dupé,0,0,0,0,0,0,0,,0,0,0,0,0,3,1
710,Erik Durm,35,22,24,8,3,14,33,42.4,19,26,6,20,41,42,0
711,Jimmy Durmaz,34,22,8,13,13,15,38,39.5,23,14,2,12,11,16,1
712,Riza Durmisi,4,4,2,0,2,2,3,66.7,1,0,0,0,1,9,0
713,Hugo Duro,6,4,1,2,3,3,6,50.0,3,6,1,5,3,4,0
714,Raphael Dwamena,0,0,0,0,0,0,0,,0,2,1,1,0,2,0
715,Paulo Dybala,17,8,3,9,5,7,23,30.4,16,20,2,18,14,1,0
716,Edin Džeko,13,7,3,5,5,4,16,25.0,12,10,1,9,0,36,1
717,Blerim Džemaili,44,27,22,19,3,19,58,32.8,39,22,1,21,17,12,1
718,Félix Eboa Eboa,47,33,26,20,1,16,22,72.7,6,37,24,13,39,136,2
719,Dennis Eckert,3,2,0,1,2,0,2,0.0,2,1,0,1,2,3,0
720,Bruno Ecuele Manga,69,36,48,16,5,29,58,50.0,29,62,28,34,81,179,4
721,Simone Edera,0,0,0,0,0,0,1,0.0,1,1,0,1,1,0,0
722,Simone Edera,4,4,3,0,1,1,3,33.3,2,5,1,4,0,1,0
723,Ederson,3,3,2,1,0,3,3,100.0,0,0,0,0,1,12,2
724,Johannes Eggestein,13,9,7,4,2,5,19,26.3,14,13,0,13,4,7,0
725,Maximilian Eggestein,68,42,29,34,5,24,54,44.4,30,49,10,39,30,69,0
726,Albin Ekdal,61,39,16,38,7,37,68,54.4,31,42,12,30,53,62,1
727,Josip Elez,8,3,5,3,0,2,11,18.2,9,13,4,9,6,27,0
728,Harvey Elliott,0,0,0,0,0,0,0,,0,1,0,1,0,0,0
729,Mohamed Elneny,13,4,9,1,3,1,2,50.0,1,7,4,3,2,8,0
730,Aritz Elustondo,47,29,31,14,2,26,41,63.4,15,23,7,16,39,150,0
731,Gorka Elustondo,7,5,4,3,0,5,8,62.5,3,6,1,5,6,10,0
732,Nico Elvedi,41,19,34,7,0,23,33,69.7,10,30,13,17,47,135,6
733,Rodrigo Ely,8,5,5,3,0,5,7,71.4,2,9,7,2,7,30,0
734,Mohamed Elyounoussi,16,12,7,6,3,6,19,31.6,13,11,1,10,6,5,0
735,Adri Embarba,54,26,20,24,10,22,61,36.1,39,38,2,36,29,22,0
736,Breel Embolo,22,17,4,13,5,1,9,11.1,8,11,0,11,4,6,0
737,Emerson,9,7,6,1,2,3,10,30.0,7,6,0,6,7,12,0
738,Youssef En-Nesyri,16,8,6,5,5,4,24,16.7,20,18,3,15,6,23,0
739,Björn Engels,11,8,6,5,0,6,16,37.5,10,30,24,6,44,181,3
740,Sergi Enrich,27,17,3,11,13,7,30,23.3,23,11,1,10,6,14,0
741,Javier Eraso,6,3,3,2,1,0,6,0.0,6,3,1,2,7,4,0
742,Christian Eriksen,41,25,8,20,13,17,59,28.8,42,26,3,23,15,13,0
743,Patrick Erras,15,10,7,7,1,7,19,36.8,12,24,13,11,23,45,0
744,Gonzalo Escalante,49,28,11,35,3,19,46,41.3,27,37,2,35,21,21,0
745,Sergio Escudero,43,29,20,18,5,18,35,51.4,17,22,4,18,24,52,0
746,Bernardo Espinosa,20,14,16,4,0,8,17,47.1,9,46,31,15,40,197,5
747,Michael Esser,3,2,3,0,0,2,5,40.0,3,1,0,1,1,15,0
748,Alexander Esswein,17,11,6,4,7,6,21,28.6,15,17,0,17,12,16,0
749,Neil Etheridge,1,1,1,0,0,1,2,50.0,1,0,0,0,7,19,1
750,Beñat Etxebarria,47,24,14,25,8,19,59,32.2,40,18,1,17,24,11,0
751,Xabier Etxeita,47,23,32,12,3,26,47,55.3,21,38,25,13,39,163,3
752,Lucas Evangelista,30,17,11,12,7,14,25,56.0,11,10,0,10,9,6,0
753,Jonny Evans,24,13,20,4,0,13,18,72.2,5,28,10,18,33,152,3
754,Ewerton,24,20,21,3,0,8,14,57.1,6,23,16,7,25,108,1
755,Valentin Eysseric,6,5,3,2,1,2,4,50.0,2,6,1,5,4,1,0
756,Valentin Eysseric,1,1,0,1,0,0,2,0.0,2,2,0,2,0,0,0
757,Marco Fabián,3,2,2,1,0,1,1,100.0,0,0,0,0,3,0,0
758,Łukasz Fabiański,1,0,1,0,0,1,3,33.3,2,0,0,0,1,10,1
759,Fabinho,59,31,17,38,4,24,59,40.7,35,34,6,28,28,27,2
760,Fábio,53,34,25,27,1,26,53,49.1,27,18,4,14,18,27,0
761,Cesc Fàbregas,6,4,4,2,0,1,5,20.0,4,2,1,1,1,0,0
762,Cesc Fàbregas,14,10,5,5,4,8,28,28.6,20,12,3,9,9,5,1
763,Fabricio,1,1,1,0,0,0,0,,0,0,0,0,0,3,2
764,Ralf Fährmann,0,0,0,0,0,0,0,,0,0,0,0,2,10,4
765,Romain Faivre,1,0,0,1,0,0,1,0.0,1,0,0,0,1,1,1
766,Fayçal Fajr,65,32,22,33,10,25,66,37.9,41,27,6,21,29,19,2
767,Radamel Falcao,34,15,6,16,12,8,27,29.6,19,11,6,5,3,23,2
768,Diego Falcinelli,8,5,1,3,4,2,3,66.7,1,4,1,3,1,5,0
769,Simon Falette,9,6,7,1,1,2,6,33.3,4,11,5,6,14,32,0
770,Iago Falque,13,8,3,8,2,3,16,18.8,13,14,0,14,3,2,0
771,Paolo Faragò,46,29,20,16,10,13,43,30.2,30,28,2,26,15,38,0
772,Mohamed Fares,63,43,37,18,8,25,54,46.3,29,48,4,44,54,83,2
773,Diego Farias,11,4,2,8,1,3,10,30.0,7,7,1,6,0,4,0
774,Diego Farias,13,9,3,7,3,2,11,18.2,9,7,1,6,1,5,0
775,Andrea Favilli,1,1,0,0,1,0,1,0.0,1,1,0,1,0,1,0
776,Federico Fazio,28,20,14,11,3,12,25,48.0,13,45,33,12,53,171,2
777,Zouhair Feddal,38,23,31,6,1,16,28,57.1,12,19,8,11,31,94,2
778,Nabil Fekir,51,31,16,19,16,13,38,34.2,25,42,0,42,7,3,0
779,Yassin Fekir,0,0,0,0,0,0,1,0.0,1,0,0,0,0,0,0
780,Felipe,23,15,21,2,0,9,17,52.9,8,17,9,8,35,71,0
781,Luiz Felipe,27,18,20,7,0,13,20,65.0,7,27,15,12,26,57,1
782,Ohis Felix Uduokhai,13,7,7,5,1,9,10,90.0,1,6,2,4,6,11,1
783,Marouane Fellaini,21,13,11,9,1,9,17,52.9,8,9,5,4,4,34,1
784,Kiko Femenía,48,30,34,12,2,24,51,47.1,27,24,6,18,36,68,0
785,Edimilson Fernandes,36,24,17,16,3,14,36,38.9,22,31,6,25,26,31,0
786,Gelson Fernandes,74,48,33,38,3,23,65,35.4,42,45,9,36,53,16,0
787,Aitor Fernández,1,0,1,0,0,1,1,100.0,0,0,0,0,1,10,1
788,Andrés Fernández,1,0,1,0,0,1,1,100.0,0,0,0,0,0,4,1
789,Borja Fernández,17,12,7,9,1,6,16,37.5,10,14,2,12,14,25,0
790,Federico Fernández,16,12,12,4,0,10,18,55.6,8,19,12,7,25,106,1
791,Joaquín Fernández,16,9,14,1,1,8,16,50.0,8,9,7,2,17,45,0
792,Valery Fernández,20,15,13,6,1,10,17,58.8,7,15,1,14,8,10,0
793,Fernandinho,57,43,19,30,8,26,47,55.3,21,28,4,24,41,70,0
794,Juan Ferney Otero,29,13,11,12,6,13,46,28.3,33,23,3,20,22,18,0
795,Alex Ferrari,10,8,4,6,0,5,7,71.4,2,7,4,3,9,26,0
796,David Ferreiro,36,22,13,19,4,11,64,17.2,53,27,1,26,24,14,2
797,Facundo Ferreyra,5,2,0,4,1,1,3,33.3,2,3,0,3,0,5,0
798,Jordan Ferri,52,31,22,23,7,26,62,41.9,36,27,2,25,15,9,1
799,Jordan Ferri,5,3,3,1,1,1,4,25.0,3,4,2,2,1,3,0
800,Oliver Fink,38,22,17,17,4,12,38,31.6,26,20,3,17,13,19,0
801,Alfreð Finnbogason,7,3,2,5,0,1,9,11.1,8,6,1,5,3,11,0
802,Roberto Firmino,30,20,5,16,9,7,34,20.6,27,35,1,34,6,16,0
803,Junior Firpo,38,25,16,14,8,10,24,41.7,14,27,2,25,23,48,0
804,Mathieu Flamini,9,4,4,4,1,4,7,57.1,3,3,1,2,5,4,0
805,Mark Flekken,0,0,0,0,0,0,0,,0,0,0,0,0,0,0
806,Sergio Floccari,13,5,1,5,7,1,7,14.3,6,6,2,4,2,6,0
807,Alessandro Florenzi,38,21,22,11,5,17,37,45.9,20,27,5,22,46,58,0
808,Phil Foden,7,6,1,3,3,2,9,22.2,7,1,0,1,4,1,0
809,Guessouma Fofana,6,4,3,3,0,1,3,33.3,2,2,1,1,3,0,0
810,Guessouma Fofana,14,9,2,10,2,4,10,40.0,6,3,0,3,6,8,0
811,Seko Fofana,25,13,14,10,1,6,36,16.7,30,20,7,13,29,18,3
812,Wesley Fofana,7,6,5,2,0,6,13,46.2,7,1,0,1,4,9,0
813,Youssouf Fofana,28,20,5,20,3,9,27,33.3,18,7,0,7,11,8,0
814,Thomas Foket,91,52,55,23,13,42,69,60.9,27,30,4,26,49,80,1
815,Thomas Fontaine,6,3,5,0,1,2,5,40.0,3,6,2,4,7,28,1
816,José Fonte,27,15,15,9,3,17,24,70.8,7,33,26,7,37,153,1
817,Rui Fonte,25,12,4,16,5,6,11,54.5,5,4,0,4,2,8,0
818,Pablo Fornals,49,26,14,26,9,15,54,27.8,39,32,4,28,24,19,0
819,Emil Forsberg,12,7,0,12,0,5,16,31.3,11,16,1,15,3,6,0
820,Fraser Forster,0,0,0,0,0,0,0,,0,0,0,0,0,1,0
821,Steven Fortes,3,1,1,2,0,0,0,,0,1,1,0,2,9,2
822,Iver Fossum,9,5,1,7,1,4,8,50.0,4,8,2,6,7,10,0
823,Ben Foster,2,2,2,0,0,2,6,33.3,4,0,0,0,2,34,3
824,Timothy Fosu-Mensah,18,7,12,6,0,8,13,61.5,5,11,5,6,12,30,1
825,Dimitri Foulquier,29,12,10,14,5,11,22,50.0,11,23,2,21,20,38,0
826,Juan Foyth,31,17,20,11,0,14,19,73.7,5,12,5,7,10,50,1
827,Raphael Framberger,8,6,4,4,0,0,3,0.0,3,10,3,7,11,15,1
828,Simon Francis,25,14,19,5,1,12,24,50.0,12,15,7,8,19,73,1
829,Mike Frantz,34,26,15,15,4,6,20,30.0,14,24,4,20,21,32,0
830,Ryan Fraser,19,11,9,8,2,10,32,31.3,22,23,6,17,22,33,0
831,Pierluigi Frattali,0,0,0,0,0,0,0,,0,0,0,0,0,1,0
832,Fred,29,17,12,16,1,15,33,45.5,18,26,2,24,16,14,2
833,Ryan Fredericks,38,23,33,5,0,21,32,65.6,11,15,5,10,13,49,1
834,Remo Freuler,84,45,34,34,16,30,70,42.9,40,62,12,50,38,45,0
835,Nicolas Frey,3,1,2,1,0,0,3,0.0,3,3,3,0,7,18,0
836,Marco Friedl,8,6,4,3,1,3,11,27.3,8,9,6,3,13,21,0
837,Alexander Fuchs,14,12,5,7,2,5,15,33.3,10,9,1,8,5,10,0
838,Christian Fuchs,4,3,0,4,0,1,2,50.0,1,0,0,0,4,8,0
839,Javi Fuego,6,3,5,1,0,4,8,50.0,4,2,0,2,3,9,0
840,Angelo Fulgini,38,22,18,13,7,12,31,38.7,19,21,3,18,28,15,0
841,Niclas Füllkrug,3,0,0,1,2,1,5,20.0,4,10,4,6,1,17,0
842,Ramiro Funes Mori,41,29,30,9,2,19,44,43.2,25,36,24,12,42,149,2
843,Manolo Gabbiadini,6,2,1,4,1,1,2,50.0,1,5,0,5,3,6,0
844,Manolo Gabbiadini,5,2,1,3,1,3,11,27.3,8,6,1,5,4,4,0
845,Mijat Gaćinović,31,20,7,13,11,11,42,26.2,31,26,1,25,24,10,0
846,Gianluca Gaetano,0,0,0,0,0,0,0,,0,0,0,0,0,0,0
847,Roberto Gagliardini,23,14,13,8,2,10,27,37.0,17,21,3,18,16,19,0
848,Riccardo Gagliolo,69,45,52,15,2,33,68,48.5,35,60,33,27,66,213,2
849,Milan Gajić,2,1,1,0,1,1,1,100.0,0,0,0,0,1,7,0
850,Javi Galán,61,39,36,23,2,34,59,57.6,25,22,1,21,19,52,1
851,Sam Gallagher,0,0,0,0,0,0,0,,0,1,0,1,0,1,0
852,Álex Gallar,15,9,6,5,4,8,19,42.1,11,9,1,8,9,5,0
853,Enric Gallego,21,15,3,13,5,3,19,15.8,16,17,2,15,8,32,0
854,Álex Gálvez,38,28,25,13,0,14,28,50.0,14,7,2,5,45,69,1
855,Kévin Gameiro,14,9,4,6,4,1,6,16.7,5,12,2,10,5,3,0
856,Idrissa Gana Gueye,142,89,70,63,9,38,76,50.0,38,52,8,44,74,48,1
857,Ignatius Ganago,3,1,0,2,1,0,7,0.0,7,2,0,2,1,7,0
858,Cristian Ganea,0,0,0,0,0,0,3,0.0,3,1,0,1,1,2,0
859,Ganso,12,8,2,8,2,2,15,13.3,13,5,1,4,6,0,0
860,Ezequiel Garay,20,17,15,3,2,9,18,50.0,9,30,23,7,16,140,0
861,Borja Garcés,0,0,0,0,0,0,0,,0,0,0,0,0,0,0
862,Alberto García,1,1,1,0,0,1,3,33.3,2,1,0,1,2,1,2
863,Aleix García,37,19,17,20,0,13,36,36.1,23,21,6,15,21,18,0
864,Álvaro García,22,19,11,7,4,4,25,16.0,21,24,0,24,19,30,0
865,Borja García,39,27,17,15,7,22,44,50.0,22,23,2,21,38,17,0
866,Dani García,56,34,21,32,3,24,63,38.1,39,28,8,20,49,46,1
867,Javi García,3,1,3,0,0,2,3,66.7,1,5,1,4,5,27,0
868,Manu García,83,48,29,40,14,24,77,31.2,53,42,7,35,23,67,0
869,Manu García,37,26,14,17,6,15,49,30.6,34,16,1,15,15,5,0
870,Raúl García,61,41,13,37,11,22,68,32.4,46,56,1,55,21,39,0
871,Raúl García,8,6,4,4,0,6,8,75.0,2,5,2,3,6,28,1
872,Raúl García,21,12,11,7,3,11,16,68.8,5,14,4,10,11,35,1
873,Sergio García,18,10,4,11,3,3,16,18.8,13,6,1,5,10,4,0
874,James Garner,0,0,0,0,0,0,0,,0,0,0,0,0,0,0
875,Mario Gaspar,62,43,39,17,6,29,49,59.2,20,48,11,37,42,91,0
876,Paulo Gazzaniga,0,0,0,0,0,0,0,,0,0,0,0,0,1,0
877,Marcello Gazzola,9,4,2,5,2,5,9,55.6,4,6,3,3,4,33,0
878,Jean-Philippe Gbamin,51,31,29,15,7,23,51,45.1,28,39,5,34,30,32,1
879,David de Gea,0,0,0,0,0,0,2,0.0,2,1,0,1,0,11,4
880,Theodor Gebre Selassie,53,38,27,16,10,22,51,43.1,29,33,8,25,69,100,0
881,Dennis Geiger,2,1,1,1,0,1,6,16.7,5,1,0,1,3,1,0
882,Jérémy Gélin,30,16,18,10,2,18,34,52.9,16,14,6,8,19,29,0
883,Romain Genevois,10,6,9,1,0,6,11,54.5,5,3,0,3,8,13,0
884,Christian Gentner,61,38,29,26,6,16,50,32.0,34,30,3,27,31,41,1
885,Yannick Gerhardt,52,34,22,20,10,16,43,37.2,27,35,7,28,30,34,0
886,Valère Germain,38,25,8,22,8,8,33,24.2,25,20,5,15,6,30,0
887,Gerson,42,26,22,15,5,12,38,31.6,26,46,9,37,16,32,0
888,Gervinho,19,12,11,5,3,5,13,38.5,8,7,0,7,10,2,0
889,Willem Geubbels,0,0,0,0,0,0,0,,0,0,0,0,0,0,0
890,Lamine Ghezali,1,1,0,1,0,1,2,50.0,1,0,0,0,0,2,0
891,Rachid Ghezzal,14,5,3,7,4,3,18,16.7,15,10,1,9,7,4,1
892,Paolo Ghiglione,8,4,6,1,1,6,14,42.9,8,2,0,2,4,22,0
893,Saman Ghoddos,33,17,14,15,4,13,32,40.6,19,15,2,13,7,13,0
894,Faouzi Ghoulam,9,7,3,5,1,8,9,88.9,1,6,2,4,8,17,0
895,Emanuele Giaccherini,14,8,5,7,2,6,31,19.4,25,21,2,19,16,10,2
896,Morgan Gibbs-White,6,3,2,4,0,1,4,25.0,3,6,0,6,1,0,0
897,Ben Gibson,1,1,1,0,0,0,0,,0,1,1,0,0,2,0
898,Fabian Giefer,0,0,0,0,0,0,2,0.0,2,0,0,0,0,1,2
899,Niko Gießelmann,57,37,38,14,5,26,59,44.1,33,25,6,19,36,85,1
900,Bryan Gil,6,4,4,1,1,1,5,20.0,4,0,0,0,1,0,0
901,Daniel Ginczek,9,7,4,3,2,5,19,26.3,14,12,2,10,3,23,1
902,Matthias Ginter,24,14,16,7,1,9,17,52.9,8,31,19,12,17,98,1
903,Andrei Girotto,57,40,18,36,3,20,44,45.5,24,22,6,16,29,43,1
904,Olivier Giroud,3,2,0,1,2,1,4,25.0,3,6,1,5,3,7,0
905,Kamil Glik,32,23,26,5,1,16,32,50.0,16,25,17,8,61,200,1
906,Serge Gnabry,36,20,12,13,11,5,30,16.7,25,18,0,18,11,3,0
907,Joris Gnagnon,11,8,6,4,1,4,7,57.1,3,2,2,0,10,16,0
908,Eddy Gnahoré,39,27,17,17,5,9,39,23.1,30,29,4,25,23,23,1
909,Massimo Gobbi,14,7,5,5,4,8,25,32.0,17,16,8,8,9,48,0
910,Kevin Goden,4,3,3,1,0,2,7,28.6,5,4,1,3,4,11,0
911,Diego Godín,52,30,33,19,0,20,42,47.6,22,22,9,13,45,141,2
912,Mauro Goicoechea,0,0,0,0,0,0,0,,0,0,0,0,0,7,0
913,Edoardo Goldaniga,43,28,34,7,2,19,32,59.4,13,29,16,13,57,119,0
914,Pierluigi Gollini,2,2,2,0,0,1,2,50.0,1,0,0,0,0,3,2
915,Aleksandr Golovin,36,17,3,20,13,10,44,22.7,34,34,3,31,22,12,0
916,André Gomes,39,23,12,24,3,13,59,22.0,46,27,4,23,20,18,0
917,Angel Gomes,1,0,0,0,1,0,0,,0,0,0,0,0,0,0
918,Ibai Gómez,6,3,3,2,1,4,9,44.4,5,8,1,7,2,8,0
919,Ibai Gómez,14,8,9,3,2,6,19,31.6,13,10,0,10,8,17,0
920,Joe Gomez,18,11,10,7,1,9,15,60.0,6,10,5,5,14,42,0
921,Mario Gómez,19,11,6,10,3,2,12,16.7,10,17,6,11,5,33,0
922,Maxi Gómez,6,4,1,4,1,1,12,8.3,11,3,0,3,2,43,0
923,Moi Gómez,42,28,15,25,2,11,46,23.9,35,27,3,24,28,27,0
924,Papu Gómez,19,14,5,10,4,6,30,20.0,24,21,0,21,16,4,0
925,Sergi Gómez,49,38,33,12,4,18,28,64.3,10,30,20,10,40,135,1
926,Alfred Gomis,0,0,0,0,0,0,1,0.0,1,0,0,0,1,14,1
927,Maxime Gonalons,8,4,2,5,1,1,15,6.7,14,10,4,6,5,12,0
928,Anthony Gonçalves,22,15,12,8,2,7,22,31.8,15,21,2,19,10,17,0
929,Jérôme Gondorf,33,18,12,19,2,14,28,50.0,14,29,5,24,19,23,1
930,Álvaro González,49,35,33,14,2,25,35,71.4,10,34,24,10,37,177,2
931,Bruno González,23,10,14,8,1,9,18,50.0,9,13,6,7,22,110,0
932,Cristo González,1,0,0,1,0,0,0,,0,0,0,0,1,0,0
933,Giancarlo González,13,7,12,1,0,5,9,55.6,4,15,11,4,12,42,0
934,Nicolás González,19,14,3,7,9,9,19,47.4,10,32,2,30,11,27,0
935,Jon Gorenc Stanković,26,18,18,7,1,14,26,53.8,12,16,9,7,9,20,1
936,Leon Goretzka,41,22,7,27,7,14,38,36.8,24,25,4,21,26,14,1
937,Mathieu Gorgelin,0,0,0,0,0,0,0,,0,0,0,0,0,3,0
938,Mirko Gori,16,13,7,9,0,5,16,31.3,11,2,0,2,4,9,0
939,Andoni Gorosabel,16,9,10,5,1,8,13,61.5,5,5,1,4,4,20,1
940,Robin Gosens,63,46,32,26,5,37,54,68.5,17,41,3,38,38,60,0
941,Dan Gosling,57,23,27,21,9,28,53,52.8,25,33,11,22,20,46,1
942,Felix Götze,4,2,2,2,0,3,3,100.0,0,1,0,1,3,7,0
943,Mario Götze,26,19,6,11,9,4,25,16.0,21,10,0,10,8,4,1
944,Prince-Désir Gouano,31,18,25,5,1,12,22,54.5,10,36,27,9,46,127,6
945,Yoann Gourcuff,0,0,0,0,0,0,2,0.0,2,1,1,0,0,1,0
946,Jeffrey Gouweleeuw,42,31,23,19,0,24,39,61.5,15,44,21,23,56,71,1
947,Paolo Gozzi Iweru,3,2,2,1,0,0,0,,0,0,0,0,3,3,0
948,Max Gradel,58,35,34,19,5,24,70,34.3,46,53,9,44,18,41,0
949,Jonathan Gradit,52,28,30,21,1,28,52,53.8,24,40,15,25,45,82,3
950,Samuel Grandsir,9,6,5,3,1,3,7,42.9,4,2,0,2,1,0,0
951,Samuel Grandsir,12,7,4,5,3,2,10,20.0,8,11,0,11,1,5,1
952,Álex Granell,64,28,30,31,3,34,83,41.0,49,34,5,29,35,36,1
953,Esteban Granero,50,32,26,18,6,17,50,34.0,33,42,8,34,26,34,2
954,Karlan Grant,5,2,1,2,2,1,3,33.3,2,8,0,8,2,1,1
955,Alberto Grassi,20,12,7,10,3,2,10,20.0,8,8,2,6,8,10,0
956,Andre Gray,3,1,0,2,1,1,6,16.7,5,3,1,2,2,6,0
957,Demarai Gray,25,12,7,14,4,6,16,37.5,10,19,0,19,9,15,0
958,Mason Greenwood,3,3,2,0,1,2,3,66.7,1,2,0,2,0,1,0
959,Michael Gregoritsch,22,13,7,9,6,4,28,14.3,24,29,10,19,15,58,0
960,Clément Grenier,44,27,7,33,4,21,61,34.4,40,28,4,24,29,34,1
961,Antoine Griezmann,31,19,8,13,10,8,28,28.6,20,18,1,17,12,21,0
962,Vincenzo Grifo,6,3,2,3,1,0,5,0.0,5,2,1,1,2,5,0
963,Vincenzo Grifo,26,14,11,8,7,14,27,51.9,13,10,1,9,2,10,0
964,Florian Grillitsch,77,49,30,38,9,36,80,45.0,44,34,8,26,72,56,1
965,Jérémy Grimm,4,2,2,2,0,3,5,60.0,2,1,0,1,4,5,0
966,Pascal Groß,27,12,12,12,3,11,36,30.6,25,20,8,12,13,23,0
967,Sergej Grubac,2,1,1,0,1,1,1,100.0,0,1,0,1,0,1,0
968,Marko Grujić,45,33,17,20,8,13,38,34.2,25,29,6,23,29,51,1
969,Vicente Guaita,0,0,0,0,0,0,0,,0,0,0,0,0,5,2
970,Andrés Guardado,24,15,9,12,3,11,47,23.4,36,27,1,26,28,28,1
971,Sergi Guardiola,19,11,1,10,8,2,13,15.4,11,12,0,12,5,17,0
972,Sergi Guardiola,1,1,0,1,0,0,0,,0,0,0,0,0,0,0
973,Metehan Güçlü,0,0,0,0,0,0,0,,0,0,0,0,0,0,0
974,Gonçalo Guedes,31,13,16,12,3,14,43,32.6,29,15,0,15,7,1,0
975,Mattéo Guendouzi,44,26,18,23,3,17,47,36.2,30,28,5,23,30,24,3
976,Javi Guerra,3,3,1,1,1,0,3,0.0,3,2,0,2,1,0,0
977,Raphaël Guerreiro,25,12,11,7,7,12,23,52.2,11,7,1,6,18,12,1
978,Francis Guerrero,51,28,25,16,10,23,41,56.1,18,15,1,14,21,47,4
979,Guido Guerrieri,0,0,0,0,0,0,0,,0,0,0,0,0,2,0
980,Ander Guevara,3,1,0,3,0,2,6,33.3,4,1,0,1,1,0,0
981,Makhtar Gueye,2,1,2,0,0,2,2,100.0,0,2,0,2,0,0,0
982,John Guidetti,4,1,0,3,1,0,4,0.0,4,4,0,4,1,6,0
983,Josuha Guilavogui,31,16,18,13,0,14,25,56.0,11,17,8,9,43,56,2
984,Frederic Guilbert,98,67,59,29,10,41,83,49.4,42,49,21,28,78,121,2
985,Baptiste Guillaume,12,6,1,8,3,2,9,22.2,7,6,0,6,2,6,0
986,Serhou Guirassy,7,5,1,5,1,0,4,0.0,4,7,0,7,4,14,0
987,Péter Gulácsi,0,0,0,0,0,0,0,,0,0,0,0,0,11,0
988,Manuel Gulde,24,16,18,5,1,12,16,75.0,4,25,13,12,26,90,0
989,Gerard Gumbau,22,16,9,13,0,6,25,24.0,19,15,2,13,13,13,0
990,İlkay Gündoğan,19,12,4,12,3,6,31,19.4,25,12,3,9,28,19,1
991,Angus Gunn,0,0,0,0,0,0,0,,0,0,0,0,0,8,3
992,Aron Gunnarsson,51,29,23,25,3,23,84,27.4,61,40,12,28,38,55,1
993,Christian Günter,38,26,16,16,6,20,43,46.5,23,31,7,24,14,55,0
994,Koray Günter,18,13,13,3,2,9,16,56.3,7,9,7,2,18,34,0
995,Serdar Gürler,5,5,3,2,0,3,11,27.3,8,8,0,8,1,2,0
996,Ahmet Gürleyen,0,0,0,0,0,0,0,,0,0,0,0,0,1,0
997,Régis Gurtner,1,1,1,0,0,0,1,0.0,1,0,0,0,1,7,3
998,Gorka Guruzeta,1,1,1,0,0,0,2,0.0,2,1,0,1,2,0,0
999,Luiz Gustavo,72,43,49,18,5,30,66,45.5,36,26,12,14,34,61,0
1000,Jonathan de Guzmán,34,24,11,20,3,13,28,46.4,15,18,2,16,11,16,0
1001,Janik Haberer,71,47,37,24,10,30,75,40.0,45,31,4,27,36,49,0
1002,Hacen,0,0,0,0,0,0,0,,0,1,0,1,1,1,0
1003,Alexander Hack,29,13,20,9,0,19,28,67.9,9,26,15,11,41,59,2
1004,Munir El Haddadi,17,10,5,7,5,2,7,28.6,5,15,0,15,6,9,0
1005,Munir El Haddadi,3,3,1,1,1,1,3,33.3,2,1,0,1,0,1,0
1006,Oussama Haddadi,51,25,38,11,2,24,43,55.8,19,33,8,25,45,93,2
1007,Florent Hadergjonaj,30,17,10,18,2,13,37,35.1,24,21,7,14,21,37,1
1008,Benjamin Hadžić,0,0,0,0,0,0,1,0.0,1,0,0,0,0,0,0
1009,André Hahn,64,38,22,39,3,22,53,41.5,31,28,2,26,27,32,0
1010,Amadou Haidara,13,11,4,8,1,8,14,57.1,6,9,1,8,4,7,0
1011,Oualid El Hajjam,14,9,10,3,1,5,15,33.3,10,8,2,6,12,26,0
1012,Achraf Hakimi,34,19,25,8,1,17,36,47.2,19,27,4,23,29,45,2
1013,Sébastien Haller,24,11,7,10,7,8,21,38.1,13,21,1,20,15,23,0
1014,Emil Hallfreðsson,0,0,0,0,0,0,1,0.0,1,1,1,0,3,4,0
1015,Emil Hallfreðsson,10,6,5,4,1,0,9,0.0,9,4,1,3,2,3,0
1016,Marcel Halstenberg,68,44,31,24,13,42,65,64.6,23,27,4,23,38,69,0
1017,Ben Hamer,0,0,0,0,0,0,3,0.0,3,0,0,0,1,3,2
1018,Romain Hamouma,30,19,6,18,6,12,32,37.5,20,12,1,11,9,7,0
1019,Marek Hamšík,7,5,2,4,1,0,11,0.0,11,8,1,7,12,14,1
1020,Dávid Hancko,7,6,4,3,0,6,9,66.7,3,3,1,2,3,12,0
1021,Samir Handanović,1,0,1,0,0,1,1,100.0,0,0,0,0,0,12,1
1022,Genki Haraguchi,44,26,21,20,3,17,66,25.8,49,34,5,29,21,33,0
1023,Féthi Harek,4,4,2,2,0,3,4,75.0,1,1,0,1,1,6,0
1024,Amine Harit,15,8,4,9,2,8,24,33.3,16,11,1,10,9,2,0
1025,Martin Harnik,12,7,4,3,5,4,15,26.7,11,8,0,8,3,10,0
1026,Kadeem Harris,12,5,6,4,2,7,8,87.5,1,3,0,3,3,5,0
1027,Joe Hart,0,0,0,0,0,0,1,0.0,1,0,0,0,0,11,3
1028,Makoto Hasebe,52,34,35,17,0,25,42,59.5,17,43,22,21,40,101,3
1029,Hans Hateboer,43,31,19,19,5,17,34,50.0,17,29,5,24,23,47,1
1030,Kai Havertz,26,17,10,11,5,8,32,25.0,24,31,4,27,16,29,0
1031,Isaac Hayden,73,43,19,45,9,23,41,56.1,18,32,4,28,40,30,0
1032,Eden Hazard,14,9,2,1,11,5,17,29.4,12,10,0,10,13,6,1
1033,Thorgan Hazard,50,33,22,20,8,17,48,35.4,31,35,2,33,27,12,0
1034,Rhys Healey,1,0,0,1,0,0,1,0.0,1,0,0,0,0,0,0
1035,Tom Heaton,0,0,0,0,0,0,2,0.0,2,0,0,0,0,8,2
1036,Dominique Heintz,41,21,34,6,1,18,32,56.3,14,45,22,23,45,214,0
1037,Filip Helander,42,26,25,13,4,19,23,82.6,4,27,16,11,14,84,0
1038,Jordan Henderson,46,36,20,22,4,16,39,41.0,23,27,3,24,30,17,0
1039,Jeff Hendrick,24,12,13,7,4,9,32,28.1,23,20,5,15,12,31,0
1040,Wayne Hennessey,0,0,0,0,0,0,2,0.0,2,0,0,0,0,5,1
1041,Rouwen Hennings,14,10,1,8,5,2,13,15.4,11,16,1,15,4,20,0
1042,Benjamin Henrichs,58,39,32,22,4,16,38,42.1,22,18,0,18,35,45,0
1043,Benjamin Henrichs,0,0,0,0,0,0,0,,0,2,0,2,3,0,0
1044,Dalbert Henrique,33,24,18,14,1,12,21,57.1,9,9,3,6,8,20,0
1045,Uche Henry Agbo,7,4,3,4,0,5,10,50.0,5,3,1,2,6,1,0
1046,Christophe Hérelle,72,52,51,19,2,40,50,80.0,10,39,16,23,61,158,2
1047,Mario Hermoso,38,24,29,7,2,21,39,53.8,18,34,25,9,37,175,2
1048,Javier Hernández,3,0,0,3,0,0,6,0.0,6,8,1,7,1,8,0
1049,Lucas Hernández,35,25,20,14,1,17,20,85.0,3,17,9,8,14,49,0
1050,Theo Hernández,54,33,30,15,9,28,44,63.6,16,21,5,16,33,42,3
1051,Ander Herrera,54,28,24,22,8,21,61,34.4,40,38,6,32,37,25,1
1052,Yangel Herrera,48,24,18,25,5,23,43,53.5,20,13,1,12,14,32,0
1053,Iago Herrerín,0,0,0,0,0,0,2,0.0,2,0,0,0,0,11,2
1054,Patrick Herrmann,20,14,8,7,5,6,17,35.3,11,6,3,3,6,12,0
1055,Pablo Hervías,1,0,0,1,0,0,1,0.0,1,0,0,0,2,0,0
1056,Pablo Hervías,1,1,0,1,0,0,4,0.0,4,2,0,2,0,0,0
1057,Përparim Hetemaj,53,27,27,23,3,20,68,29.4,48,25,1,24,30,24,2
1058,Son Heung-min,23,12,7,12,4,10,34,29.4,24,26,2,24,8,4,1
1059,Gonzalo Higuaín,10,7,2,4,4,2,11,18.2,9,4,0,4,1,5,0
1060,Gonzalo Higuaín,8,6,1,5,2,5,13,38.5,8,3,0,3,0,11,1
1061,Oscar Hiljemark,16,9,8,7,1,5,16,31.3,11,13,3,10,13,14,0
1062,Vitorino Hilton,33,13,28,5,0,12,30,40.0,18,31,15,16,66,198,2
1063,Martin Hinteregger,48,35,31,16,1,24,35,68.6,11,24,13,11,22,68,0
1064,Martin Hinteregger,34,26,19,12,3,13,28,46.4,15,20,7,13,13,51,0
1065,Marwin Hitz,0,0,0,0,0,0,0,,0,0,0,0,0,0,1
1066,Andrew Hjulsager,16,10,11,2,3,2,18,11.1,16,4,0,4,2,1,0
1067,Wesley Hoedt,28,12,23,5,0,17,26,65.4,9,20,13,7,23,79,2
1068,Wesley Hoedt,17,11,15,2,0,12,17,70.6,5,17,11,6,11,58,3
1069,André Hoffmann,22,14,12,10,0,9,25,36.0,16,17,12,5,21,44,0
1070,Nicolas Höfler,45,22,19,22,4,14,36,38.9,22,21,4,17,32,41,0
1071,Jonas Hofmann,37,18,11,19,7,9,37,24.3,28,33,2,31,16,14,1
1072,Jonathan Hogg,78,41,18,51,9,27,69,39.1,42,46,7,39,73,19,1
1073,Junior Hoilett,40,27,26,11,3,15,53,28.3,38,34,0,34,32,30,0
1074,Rob Holding,11,7,9,2,0,2,8,25.0,6,9,7,2,12,40,0
1075,José Holebas,68,40,44,20,4,28,53,52.8,25,27,8,19,21,97,0
1076,Lucas Höler,18,13,6,9,3,4,18,22.2,14,10,1,9,3,15,2
1077,Mason Holgate,5,4,4,1,0,1,1,100.0,0,3,2,1,3,32,0
1078,Gerrit Holtmann,2,0,1,0,1,1,2,50.0,1,3,2,1,4,1,0
1079,Justin Hoogma,4,2,2,1,1,2,2,100.0,0,3,1,2,2,1,0
1080,Lukáš Hrádecký,0,0,0,0,0,0,1,0.0,1,0,0,0,1,9,1
1081,Branimir Hrgota,0,0,0,0,0,0,0,,0,0,0,0,0,0,0
1082,Benjamin Hübner,29,18,18,9,2,14,18,77.8,4,16,7,9,21,35,0
1083,Tomáš Hubočan,3,2,3,0,0,3,4,75.0,1,0,0,0,2,5,0
1084,Callum Hudson-Odoi,8,6,8,0,0,2,4,50.0,2,1,0,1,3,0,0
1085,Will Hughes,74,43,27,35,12,25,59,42.4,34,55,6,49,25,30,0
1086,Vitor Hugo,64,42,38,25,1,17,27,63.0,10,28,13,15,74,141,2
1087,Mats Hummels,26,17,19,6,1,9,24,37.5,15,20,8,12,34,50,1
1088,Adrien Hunou,11,7,3,5,3,2,9,22.2,7,14,0,14,5,8,0
1089,Emerson Hyndman,6,2,6,0,0,2,3,66.7,1,0,0,0,1,0,0
1090,Elseid Hysaj,40,28,22,15,3,25,49,51.0,24,11,3,8,24,51,0
1091,Suk Hyun-jun,11,8,1,6,4,0,8,0.0,8,2,1,1,2,4,1
1092,Pierre Højbjerg,71,49,20,44,7,24,73,32.9,49,51,8,43,60,30,1
1093,Simone Iacoponi,62,43,50,11,1,27,47,57.4,20,40,26,14,37,178,3
1094,Robert Ibáñez,2,2,1,1,0,0,1,0.0,1,3,0,3,0,0,0
1095,Roger Ibanez,0,0,0,0,0,0,0,,0,0,0,0,0,1,0
1096,Jordon Ibe,6,5,0,5,1,2,7,28.6,5,2,0,2,4,4,0
1097,Vedad Ibišević,12,8,2,5,5,0,10,0.0,10,10,4,6,3,20,0
1098,Vicente Iborra,4,1,1,3,0,0,7,0.0,7,1,0,1,8,4,1
1099,Vicente Iborra,31,18,22,5,4,14,37,37.8,23,25,7,18,22,41,1
1100,Didier Ibrahim Ndong,16,11,3,13,0,5,13,38.5,8,15,3,12,15,6,1
1101,Mauro Icardi,9,8,2,2,5,1,6,16.7,5,4,1,3,3,20,1
1102,Salvador Ichazo,0,0,0,0,0,0,0,,0,0,0,0,0,0,0
1103,Edgar Ié,5,4,3,2,0,3,5,60.0,2,2,1,1,7,17,0
1104,Edgar Ié,20,13,12,6,2,9,16,56.3,7,10,3,7,8,23,0
1105,Borja Iglesias,23,14,7,8,8,5,24,20.8,19,14,6,8,7,41,0
1106,Kelechi Iheanacho,6,5,4,1,1,1,5,20.0,4,5,0,5,2,3,0
1107,Jordan Ikoko,37,24,22,14,1,16,28,57.1,12,18,5,13,24,30,0
1108,Jonathan Ikone,25,14,7,12,6,8,30,26.7,22,24,2,22,6,4,0
1109,Ivo Iličević,1,0,0,1,0,1,2,50.0,1,1,0,1,0,0,0
1110,Josip Iličić,15,7,2,7,6,5,20,25.0,15,20,1,19,5,2,0
1111,Asier Illarramendi,39,24,22,14,3,21,51,41.2,30,36,9,27,31,46,1
1112,Stefan Ilsanker,26,17,15,10,1,14,23,60.9,9,9,2,7,18,43,1
1113,Giannelli Imbula,14,7,6,7,1,5,12,41.7,7,12,3,9,8,6,0
1114,Ciro Immobile,12,6,4,3,5,4,9,44.4,5,18,1,17,1,8,0
1115,Emmanuel Imorou,18,13,10,7,1,11,17,64.7,6,14,4,10,28,49,1
1116,Svante Ingelsson,1,1,1,0,0,0,0,,0,2,0,2,0,4,0
1117,Roberto Inglese,20,14,7,7,6,1,13,7.7,12,26,2,24,6,27,0
1118,Danny Ings,30,14,5,19,6,11,28,39.3,17,30,2,28,5,9,0
1119,Lorenzo Insigne,14,4,5,6,3,6,18,33.3,12,7,0,7,8,3,0
1120,Emiliano Insúa,51,33,26,18,7,25,42,59.5,17,29,2,27,31,55,1
1121,Pablo Insua,23,10,14,9,0,8,15,53.3,7,2,0,2,12,40,0
1122,Takashi Inui,9,5,6,2,1,5,18,27.8,13,5,0,5,4,3,0
1123,Takashi Inui,4,3,0,4,0,3,7,42.9,4,3,0,3,1,1,0
1124,Artur Ioniță,67,38,23,31,13,16,57,28.1,41,40,5,35,27,30,0
1125,Gorka Iraizoz,1,0,1,0,0,1,1,100.0,0,0,0,0,1,7,0
1126,Carlos Isaac,0,0,0,0,0,0,2,0.0,2,2,0,2,1,2,0
1127,Isco,29,14,14,8,7,14,34,41.2,20,9,1,8,6,3,0
1128,Mikael Ishak,9,6,3,6,0,3,16,18.8,13,8,3,5,3,10,0
1129,Wilson Isidor,0,0,0,0,0,0,0,,0,1,1,0,0,1,0
1130,Abass Issah,0,0,0,0,0,0,0,,0,0,0,0,0,0,0
1131,Gian-Luca Itter,4,3,3,1,0,1,2,50.0,1,2,0,2,1,2,0
1132,Manuel Iturra,2,0,0,2,0,0,0,,0,1,0,1,2,2,0
1133,Ander Iturraspe,2,2,1,1,0,1,1,100.0,0,0,0,0,6,2,0
1134,Ivi,0,0,0,0,0,0,0,,0,0,0,0,0,0,0
1135,Alex Iwobi,28,14,10,16,2,6,25,24.0,19,21,1,20,12,13,1
1136,José Izquierdo,15,9,9,4,2,10,20,50.0,10,7,1,6,5,7,0
1137,Armando Izzo,76,50,35,35,6,33,53,62.3,20,52,24,28,88,149,2
1138,Koo Ja-cheol,36,23,10,20,6,12,30,40.0,18,28,5,23,27,21,0
1139,Lukas Jäger,0,0,0,0,0,0,2,0.0,2,0,0,0,0,0,0
1140,Phil Jagielka,7,5,3,4,0,1,4,25.0,3,1,0,1,2,14,0
1141,Alireza Jahanbakhsh,32,18,17,11,4,11,30,36.7,19,16,0,16,11,4,0
1142,Christophe Jallet,29,21,12,13,4,16,27,59.3,11,21,5,16,14,32,0
1143,Jandrei,0,0,0,0,0,0,1,0.0,1,0,0,0,0,0,0
1144,Christoph Janker,2,1,2,0,0,0,0,,0,1,0,1,0,1,0
1145,Marko Janković,3,1,2,1,0,0,2,0.0,2,0,0,0,0,0,0
1146,Jakub Jankto,7,4,5,2,0,4,15,26.7,11,18,2,16,9,16,0
1147,Daryl Janmaat,36,24,23,11,2,20,29,69.0,9,16,6,10,33,71,0
1148,Vincent Janssen,2,1,0,2,0,0,0,,0,0,0,0,0,1,0
1149,Tony Jantschke,15,10,9,5,1,6,8,75.0,2,10,7,3,27,51,1
1150,Adnan Januzaj,11,8,5,2,4,3,13,23.1,10,7,0,7,6,6,0
1151,Nicolas Janvier,0,0,0,0,0,0,0,,0,0,0,0,0,0,0
1152,Paweł Jaroszyński,29,18,17,8,4,16,32,50.0,16,15,4,11,24,41,1
1153,Rune Jarstein,0,0,0,0,0,0,0,,0,0,0,0,1,8,1
1154,Jason,44,25,22,11,11,20,71,28.2,51,25,4,21,46,27,0
1155,Dennis Jastrzembski,0,0,0,0,0,0,3,0.0,3,0,0,0,1,0,0
1156,Assil Jaziri,2,2,0,2,0,1,2,50.0,1,1,0,1,1,0,0
1157,Corentin Jean,9,6,3,6,0,2,8,25.0,6,8,0,8,2,5,0
1158,Benjamin Jeannot,17,12,5,7,5,6,19,31.6,13,15,3,12,12,14,0
1159,Tin Jedvaj,23,15,9,8,6,10,19,52.6,9,28,2,26,22,52,0
1160,Jemerson,54,38,34,19,1,29,46,63.0,17,29,17,12,25,121,1
1161,Carl Jenkinson,3,2,2,0,1,2,3,66.7,1,4,3,1,0,2,0
1162,Fredrik Jensen,5,4,3,1,1,2,4,50.0,2,6,0,6,2,3,0
1163,Mathias Jensen,4,2,2,2,0,2,9,22.2,7,2,0,2,4,1,0
1164,Jesé,7,4,3,3,1,2,8,25.0,6,8,0,8,1,1,0
1165,Gabriel Jesus,10,3,5,2,3,0,5,0.0,5,16,2,14,3,4,0
1166,Juan Jesus,37,29,30,5,2,17,30,56.7,13,20,12,8,16,41,0
1167,Raúl Jiménez,30,18,5,17,8,6,23,26.1,17,25,3,22,26,40,0
1168,Joaquín,10,4,4,2,4,3,7,42.9,4,13,2,11,14,31,1
1169,Joelinton,35,22,9,20,6,10,30,33.3,20,36,3,33,14,8,0
1170,Aron Jóhannsson,0,0,0,0,0,0,0,,0,0,0,0,0,0,0
1171,Stefan Johansen,11,3,4,7,0,5,8,62.5,3,5,0,5,3,6,0
1172,Jakob Johansson,17,9,5,12,0,10,20,50.0,10,7,3,4,3,17,1
1173,Ben Johnson,1,0,1,0,0,0,1,0.0,1,0,0,0,1,5,0
1174,Fabian Johnson,13,5,2,8,3,6,8,75.0,2,8,3,5,10,16,0
1175,Tyreke Johnson,0,0,0,0,0,0,0,,0,0,0,0,0,0,0
1176,Karl-Johan Johnsson,0,0,0,0,0,0,1,0.0,1,0,0,0,0,4,1
1177,Jonathas,7,4,3,4,0,3,10,30.0,7,9,1,8,3,4,0
1178,Phil Jones,19,13,12,7,0,8,13,61.5,5,16,11,5,23,67,3
1179,Jony,20,14,6,7,7,7,37,18.9,30,18,0,18,22,12,2
1180,Joan Jordán,63,40,16,38,9,28,80,35.0,52,38,4,34,32,18,1
1181,Bruno Jordão,4,3,2,1,1,1,3,33.3,2,1,0,1,0,2,0
1182,Jorginho,76,38,27,41,8,45,96,46.9,51,46,7,39,64,38,1
1183,Willian José,5,3,1,3,1,2,7,28.6,5,11,5,6,1,27,0
1184,Joselu,14,8,4,5,5,4,9,44.4,5,5,0,5,3,15,0
1185,Evens Joseph,5,2,1,2,2,1,3,33.3,2,3,0,3,2,1,0
1186,Diogo Jota,28,16,11,11,6,10,38,26.3,28,20,1,19,13,11,0
1187,Aleksandar Jovanović,0,0,0,0,0,0,0,,0,0,0,0,1,3,0
1188,Vukašin Jovanović,26,21,21,5,0,13,19,68.4,6,23,12,11,36,105,0
1189,Stevan Jovetić,2,1,1,1,0,1,3,33.3,2,1,0,1,1,3,0
1190,Luka Jović,10,5,1,8,1,1,12,8.3,11,8,0,8,3,30,0
1191,Jozabed,19,10,8,8,3,8,24,33.3,16,8,2,6,9,13,2
1192,Miguel Juan Llambrich,21,14,11,9,1,6,14,42.9,8,9,2,7,12,17,0
1193,Juanfran,20,12,13,5,2,9,16,56.3,7,9,4,5,19,37,0
1194,Juanfran,35,22,27,5,3,24,38,63.2,14,13,5,8,19,36,1
1195,Juanmi,21,12,7,11,3,8,22,36.4,14,12,0,12,16,13,0
1196,Juanpe,48,25,32,15,1,24,45,53.3,21,31,15,16,57,138,0
1197,Juanpi,16,6,9,5,2,4,12,33.3,8,15,0,15,6,3,0
1198,Nathaël Julan,1,0,0,0,1,0,3,0.0,3,6,1,5,0,2,0
1199,Christopher Jullien,35,24,23,10,2,12,32,37.5,20,39,27,12,41,203,4
1200,David Juncà,55,30,40,13,2,28,46,60.9,18,27,6,21,35,63,1
1201,Sebastian Jung,1,0,0,1,0,1,1,100.0,0,0,0,0,0,1,0
1202,Hamed Junior Traorè,67,38,26,32,9,27,72,37.5,45,29,4,25,30,17,0
1203,Vinicius Júnior,10,6,3,6,1,3,16,18.8,13,6,1,5,7,1,0
1204,Musa Juwara,0,0,0,0,0,0,0,,0,0,0,0,1,0,0
1205,Mathias Jørgensen,49,31,27,21,1,27,46,58.7,19,29,14,15,69,83,0
1206,Sory Kaba,1,1,1,0,0,1,3,33.3,2,2,0,2,0,1,0
1207,Ozan Kabak,33,19,22,9,2,9,19,47.4,10,15,8,7,23,58,1
1208,Christian Kabasele,25,14,20,5,0,10,23,43.5,13,21,16,5,38,111,0
1209,Elias Kachunga,22,9,8,12,2,9,25,36.0,16,16,1,15,4,10,0
1210,Pavel Kadeřábek,30,19,12,13,5,11,24,45.8,13,37,10,27,34,71,1
1211,Shinji Kagawa,0,0,0,0,0,0,0,,0,0,0,0,0,0,0
1212,Florian Kainz,6,5,5,1,0,3,6,50.0,3,4,1,3,3,5,0
1213,Gaël Kakuta,12,7,5,5,2,2,10,20.0,8,4,1,3,9,9,0
1214,Nikola Kalinić,6,4,2,4,0,1,3,33.3,2,1,0,1,2,2,0
1215,Salomon Kalou,21,12,5,11,5,6,24,25.0,18,23,1,22,6,25,0
1216,Samuel Kalu,27,18,15,7,5,4,11,36.4,7,11,3,8,8,4,1
1217,François Kamano,29,18,6,17,6,11,30,36.7,19,27,0,27,17,6,1
1218,Aboubakar Kamara,8,4,1,5,2,3,7,42.9,4,6,0,6,1,6,0
1219,Boubacar Kamara,67,39,38,24,5,32,49,65.3,17,24,13,11,45,95,2
1220,Hassane Kamara,29,21,22,5,2,16,19,84.2,3,6,1,5,14,41,0
1221,Marcin Kamiński,18,13,14,3,1,7,11,63.6,4,21,11,10,39,103,2
1222,Patrick Kammerbauer,0,0,0,0,0,0,0,,0,0,0,0,1,1,0
1223,Kevin Kampl,41,24,16,21,4,8,28,28.6,20,32,2,30,33,22,0
1224,Harry Kane,10,6,2,8,0,1,14,7.1,13,16,6,10,1,14,0
1225,Lee Kang-in,2,0,1,1,0,1,3,33.3,2,0,0,0,1,0,0
1226,Wilfried Kanga,0,0,0,0,0,0,1,0.0,1,3,0,3,0,4,0
1227,N'Golo Kanté,75,41,21,41,13,23,67,34.3,44,63,6,57,44,32,1
1228,Stefanos Kapino,0,0,0,0,0,0,0,,0,0,0,0,0,0,0
1229,Wilfrid Kaptoum,15,6,4,10,1,5,11,45.5,6,9,1,8,10,6,2
1230,Kenan Karaman,13,9,3,10,0,7,12,58.3,5,5,1,4,2,8,0
1231,Yann Karamoh,0,0,0,0,0,0,0,,0,0,0,0,0,0,0
1232,Yann Karamoh,7,3,1,4,2,1,13,7.7,12,9,0,9,6,3,0
1233,Ibrahim Karamoko,0,0,0,0,0,0,0,,0,1,0,1,0,1,0
1234,Orestis Karnezis,0,0,0,0,0,0,0,,0,0,0,0,0,3,0
1235,Rick Karsdorp,9,6,3,5,1,5,11,45.5,6,4,2,2,12,12,1
1236,Grigoris Kastanos,3,1,3,0,0,0,0,,0,3,1,2,0,0,0
1237,Eiji Kawashima,0,0,0,0,0,0,0,,0,0,0,0,0,0,0
1238,Beram Kayal,28,17,16,11,1,5,21,23.8,16,17,10,7,15,25,0
1239,Moise Kean,0,0,0,0,0,0,1,0.0,1,1,0,1,2,1,0
1240,Michael Keane,41,25,22,16,3,19,32,59.4,13,30,22,8,43,185,4
1241,Neeskens Kebano,3,1,2,1,0,1,1,100.0,0,3,0,3,0,3,0
1242,Thilo Kehrer,64,43,27,31,6,31,55,56.4,24,32,17,15,31,69,1
1243,Jules Keita,10,4,0,3,7,5,12,41.7,7,2,0,2,2,1,0
1244,Naby Keïta,37,15,13,19,5,14,42,33.3,28,29,4,25,12,16,1
1245,Keko,42,18,21,15,6,18,50,36.0,32,20,1,19,14,17,0
1246,Martin Kelly,21,13,18,2,1,14,19,73.7,5,18,12,6,11,88,1
1247,Marc-Oliver Kempf,33,18,26,7,0,12,24,50.0,12,35,21,14,46,141,1
1248,Kenedy,30,22,11,16,3,12,29,41.4,17,10,0,10,32,24,1
1249,Jonjoe Kenny,21,16,16,4,1,10,18,55.6,8,13,2,11,17,36,1
1250,Christophe Kerbrat,40,24,28,12,0,24,38,63.2,14,19,10,9,50,140,5
1251,Sebastian Kerk,16,9,8,5,3,7,23,30.4,16,14,5,9,3,22,1
1252,Franck Kessié,42,27,16,20,6,18,38,47.4,20,35,10,25,27,53,2
1253,Saîf-Eddine Khaoui,20,14,5,11,4,8,27,29.6,19,9,1,8,20,4,0
1254,Wahbi Khazri,41,26,8,14,19,17,49,34.7,32,27,2,25,11,5,0
1255,Rani Khedira,56,39,22,28,6,18,36,50.0,18,44,22,22,80,95,1
1256,Sami Khedira,10,9,6,2,2,5,9,55.6,4,8,3,5,5,6,0
1257,Isaac Kiese Thelin,2,1,0,2,0,1,2,50.0,1,1,0,1,0,4,0
1258,Kiké,7,4,1,2,4,1,5,20.0,4,18,0,18,4,6,0
1259,Max Kilman,0,0,0,0,0,0,0,,0,0,0,0,0,0,0
1260,Joshua Kimmich,46,26,17,22,7,25,54,46.3,29,35,9,26,34,41,3
1261,Presnel Kimpembe,55,34,26,25,4,24,40,60.0,16,17,10,7,30,48,5
1262,Joshua King,30,19,7,19,4,8,29,27.6,21,28,4,24,7,14,0
1263,Sofian Kiyine,28,13,11,14,3,9,18,50.0,9,10,0,10,10,4,0
1264,Simon Kjær,29,19,25,3,1,9,16,56.3,7,41,34,7,27,136,0
1265,Davy Klaassen,64,47,24,33,7,14,49,28.6,35,44,9,35,47,47,0
1266,Felix Klaus,10,7,4,5,1,2,7,28.6,5,5,0,5,4,0,0
1267,Ragnar Klavan,9,8,5,3,1,5,11,45.5,6,19,13,6,10,68,1
1268,Tim Kleindienst,4,3,1,2,1,1,3,33.3,2,3,0,3,0,7,0
1269,Lukas Klostermann,50,29,33,12,5,29,45,64.4,16,37,5,32,29,74,0
1270,Justin Kluivert,28,27,12,9,7,10,23,43.5,13,17,0,17,7,12,0
1271,Lukas Klünter,11,8,6,5,0,4,5,80.0,1,6,2,4,12,20,0
1272,Robin Knoche,26,20,19,6,1,16,29,55.2,13,46,29,17,44,138,2
1273,Anthony Knockaert,33,21,12,15,6,13,30,43.3,17,13,0,13,29,11,0
1274,Törles Knöll,3,2,1,1,1,0,4,0.0,4,5,1,4,0,2,0
1275,Gregor Kobel,0,0,0,0,0,0,0,,0,0,0,0,0,0,0
1276,Gregor Kobel,1,1,1,0,0,1,1,100.0,0,0,0,0,2,5,3
1277,Robin Koch,25,14,17,7,1,7,24,29.2,17,31,18,13,32,77,4
1278,Kenan Kodro,3,1,1,1,1,1,3,33.3,2,1,0,1,0,0,0
1279,Dominik Kohr,42,29,21,21,0,14,35,40.0,21,25,12,13,15,17,1
1280,Djégui Koita,8,6,8,0,0,3,4,75.0,1,5,3,2,0,9,0
1281,Koke,84,46,41,32,11,34,86,39.5,52,25,5,20,31,37,1
1282,Aleksandar Kolarov,38,26,22,10,6,21,34,61.8,13,23,15,8,41,82,2
1283,Sead Kolašinac,34,21,21,7,6,20,34,58.8,14,12,3,9,20,28,3
1284,Randal Kolo Muani,2,0,1,1,0,0,1,0.0,1,2,0,2,0,2,0
1285,Timothée Kolodziejczak,34,22,21,10,3,20,45,44.4,25,25,11,14,53,118,2
1286,Vincent Kompany,16,10,11,3,2,8,9,88.9,1,11,8,3,16,55,0
1287,Ghislain Konan,45,28,31,10,4,24,40,60.0,16,18,4,14,40,55,1
1288,Ibrahima Konaté,44,32,30,14,0,17,27,63.0,10,29,18,11,58,126,0
1289,Moussa Konaté,10,8,3,3,4,2,12,16.7,10,14,3,11,5,15,0
1290,Geoffrey Kondogbia,47,33,18,23,6,12,27,44.4,15,20,7,13,27,22,2
1291,Lamine Koné,21,16,9,9,3,6,9,66.7,3,18,13,5,33,66,3
1292,Manu Koné,4,2,0,4,0,2,4,50.0,2,0,0,0,0,0,0
1293,Youssouf Koné,67,38,45,19,3,41,65,63.1,24,31,3,28,39,52,1
1294,Terence Kongolo,74,46,44,26,4,27,47,57.4,20,42,16,26,65,106,1
1295,Yevhen Konoplyanka,2,0,0,0,2,2,4,50.0,2,6,0,6,3,3,0
1296,Pascal Köpke,1,0,1,0,0,1,2,50.0,1,0,0,0,0,0,0
1297,Julian Korb,26,17,16,9,1,10,29,34.5,19,27,4,23,23,34,1
1298,Laurent Koscielny,19,11,9,9,1,10,16,62.5,6,20,15,5,30,72,0
1299,Filip Kostić,64,42,35,22,7,23,65,35.4,42,80,6,74,23,50,0
1300,Christian Kouamé,31,22,8,16,7,2,13,15.4,11,23,3,20,25,28,0
1301,Tomáš Koubek,0,0,0,0,0,0,1,0.0,1,0,0,0,0,26,4
1302,Kalidou Koulibaly,61,40,37,22,2,19,36,52.8,17,55,33,22,40,144,0
1303,Jules Koundé,48,31,37,11,0,27,41,65.9,14,44,23,21,50,193,7
1304,Cheikhou Kouyaté,59,33,23,31,5,9,33,27.3,24,29,11,18,16,33,0
1305,Mateo Kovačić,45,29,23,19,3,20,46,43.5,26,19,2,17,8,18,1
1306,Dawid Kownacki,2,1,0,1,1,1,4,25.0,3,0,0,0,0,0,0
1307,Dawid Kownacki,13,6,9,3,1,7,16,43.8,9,8,0,8,2,8,0
1308,Thomas Kraft,0,0,0,0,0,0,0,,0,0,0,0,0,1,1
1309,Emil Krafth,55,35,34,14,7,32,65,49.2,33,27,12,15,23,94,4
1310,Luka Krajnc,10,8,6,3,1,5,6,83.3,1,11,3,8,11,42,0
1311,Andrej Kramarić,9,4,1,5,3,4,26,15.4,22,15,3,12,8,13,0
1312,Christoph Kramer,41,22,17,23,1,15,40,37.5,25,19,4,15,21,23,0
1313,Vasyl Kravets,16,11,8,6,2,6,13,46.2,7,5,1,4,4,10,1
1314,Ladislav Krejčí,16,12,6,9,1,7,12,58.3,5,8,2,6,6,18,0
1315,Rene Krhin,22,14,7,12,3,11,19,57.9,8,7,4,3,21,32,0
1316,Toni Kroos,51,35,18,24,9,14,57,24.6,43,25,4,21,14,13,1
1317,Rade Krunić,38,23,21,14,3,14,41,34.1,27,35,12,23,24,32,0
1318,Max Kruse,17,5,2,13,2,6,38,15.8,32,16,1,15,8,6,2
1319,Lukas Kübler,35,22,23,12,0,16,26,61.5,10,15,5,10,30,50,1
1320,Yuya Kubo,21,11,6,10,5,12,33,36.4,21,11,0,11,10,6,0
1321,Juraj Kucka,51,32,17,29,5,19,53,35.8,34,27,7,20,17,37,1
1322,Dejan Kulusevski,3,3,0,2,1,1,3,33.3,2,1,0,1,0,0,0
1323,Pierre Kunde,48,29,20,26,2,16,27,59.3,11,34,14,20,24,49,1
1324,Jasmin Kurtić,35,20,19,13,3,13,41,31.7,28,30,3,27,20,52,0
1325,Layvin Kurzawa,19,11,6,5,8,6,16,37.5,10,10,2,8,10,16,0
1326,Rafał Kurzawa,8,3,6,2,0,2,6,33.3,4,1,0,1,3,3,0
1327,Ahmed Kutucu,8,3,3,4,1,1,3,33.3,2,2,1,1,0,0,0
1328,Enock Kwateng,65,41,34,27,4,33,70,47.1,37,28,4,24,78,56,0
1329,Grejohn Kyei,0,0,0,0,0,0,1,0.0,1,0,0,0,0,0,0
1330,Antonino La Gumina,5,4,1,2,2,2,6,33.3,4,8,2,6,6,5,0
1331,Rajiv van La Parra,8,5,1,7,0,1,6,16.7,5,0,0,0,4,3,1
1332,Gaëtan Laborde,4,3,0,1,3,2,4,50.0,2,0,0,0,0,0,0
1333,Gaëtan Laborde,36,15,6,15,15,11,27,40.7,16,18,2,16,6,27,0
1334,Alexandre Lacazette,35,16,6,19,10,5,28,17.9,23,27,1,26,15,31,0
1335,Alban Lafont,0,0,0,0,0,0,0,,0,0,0,0,1,16,4
1336,Víctor Laguardia,47,34,37,10,0,24,33,72.7,9,42,19,23,53,232,0
1337,Abdou Lahat Diakhate,0,0,0,0,0,0,0,,0,0,0,0,0,0,0
1338,Konrad Laimer,72,38,21,34,17,20,71,28.2,51,67,2,65,32,23,0
1339,Diego Lainez,4,4,0,3,1,1,1,100.0,0,2,0,2,1,2,0
1340,Kenny Lala,78,45,48,23,7,30,53,56.6,23,26,9,17,28,62,2
1341,Adam Lallana,16,9,6,7,3,5,12,41.7,7,10,1,9,5,4,0
1342,Érik Lamela,17,13,6,7,4,5,14,35.7,9,14,0,14,7,1,0
1343,Mohamed Lamine Diaby,1,1,0,1,0,1,1,100.0,0,2,0,2,2,0,0
1344,Loïck Landre,31,21,23,8,0,14,22,63.6,8,16,11,5,38,83,1
1345,Michael Lang,14,9,7,6,1,6,16,37.5,10,14,3,11,16,42,1
1346,Sebastian Langkamp,24,15,18,6,0,7,14,50.0,7,17,11,6,20,79,1
1347,Manuel Lanzini,12,7,5,6,1,5,18,27.8,13,3,1,2,9,7,1
1348,Gianluca Lapadula,2,1,2,0,0,1,5,20.0,4,2,0,2,1,2,0
1349,Aymeric Laporte,42,20,27,14,1,22,34,64.7,12,16,9,7,39,98,2
1350,Danilo Larangeira,40,26,29,11,0,20,30,66.7,10,52,39,13,37,182,3
1351,Johan Larsson,1,1,0,1,0,1,2,50.0,1,0,0,0,1,1,1
1352,Kevin Lasagna,6,1,0,3,3,2,12,16.7,10,20,2,18,8,35,0
1353,Jamaal Lascelles,32,21,25,5,2,11,14,78.6,3,43,28,15,39,218,3
1354,Paul Lasne,53,33,32,16,5,24,43,55.8,19,22,2,20,22,23,1
1355,Toni Lato,6,4,4,1,1,1,5,20.0,4,9,3,6,6,13,0
1356,Danny Latza,41,22,16,23,2,20,61,32.8,41,49,10,39,20,31,0
1357,Alexandre Lauray,11,6,9,2,0,6,8,75.0,2,2,0,2,4,10,0
1358,Armand Lauriente,0,0,0,0,0,0,0,,0,0,0,0,0,0,0
1359,Vincent Laurini,13,5,6,5,2,6,10,60.0,4,11,5,6,13,30,0
1360,Wesley Lautoa,81,55,46,31,4,34,75,45.3,41,37,14,23,87,110,1
1361,Diego Laxalt,26,13,14,7,5,13,22,59.1,9,23,3,20,8,12,0
1362,Miguel Layún,8,2,0,7,1,2,6,33.3,4,8,2,6,1,10,0
1363,Valentino Lazaro,46,31,23,17,6,21,53,39.6,32,52,12,40,44,65,0
1364,Darko Lazović,28,17,13,8,7,14,31,45.2,17,21,6,15,20,33,0
1365,Manuel Lazzari,29,17,16,10,3,13,24,54.2,11,26,5,21,20,51,1
1366,Mickaël Le Bihan,1,1,0,1,0,1,2,50.0,1,1,0,1,1,1,0
1367,Maxime Le Marchand,56,36,45,11,0,23,47,48.9,24,30,16,14,54,129,2
1368,Robin Le Normand,5,2,2,3,0,1,3,33.3,2,3,0,3,4,13,1
1369,Damien Le Tallec,95,58,42,43,10,33,89,37.1,56,35,8,27,59,50,0
1370,James Lea Siliki,26,17,13,10,3,12,35,34.3,23,14,1,13,10,7,1
1371,Rafael Leão,5,2,0,4,1,2,15,13.3,13,13,4,9,4,12,0
1372,Mathew Leckie,20,13,5,10,5,7,16,43.8,9,10,1,9,13,16,0
1373,Benjamin Lecomte,1,0,1,0,0,1,3,33.3,2,0,0,0,5,24,3
1374,Pierre Lees-Melou,74,46,31,36,7,25,62,40.3,37,44,8,36,36,37,0
1375,Jordan Lefort,33,18,23,6,4,16,25,64.0,9,11,8,3,46,107,0
1376,Wu Lei,13,6,5,6,2,5,16,31.3,11,9,0,9,7,7,0
1377,Tim Leibold,62,42,45,16,1,33,71,46.5,38,23,3,20,38,57,0
1378,Lucas Leiva,91,54,40,46,5,38,79,48.1,41,27,11,16,52,43,3
1379,Florian Lejeune,25,15,17,7,1,11,24,45.8,13,16,5,11,21,49,0
1380,Iñigo Lekue,5,2,3,2,0,2,7,28.6,5,4,0,4,4,11,0
1381,Thomas Lemar,38,21,23,11,4,19,42,45.2,23,26,1,25,22,7,1
1382,Mario Lemina,49,32,23,23,3,15,34,44.1,19,27,3,24,43,31,1
1383,Mauricio Lemos,2,1,2,0,0,1,2,50.0,1,2,1,1,3,10,1
1384,Clément Lenglet,47,29,26,19,2,22,36,61.1,14,30,20,10,21,70,0
1385,Aaron Lennon,26,16,11,12,3,6,14,42.9,8,24,0,24,10,18,0
1386,Bernd Leno,0,0,0,0,0,0,3,0.0,3,0,0,0,4,16,6
1387,Pedro León,7,4,2,2,3,4,7,57.1,3,10,0,10,4,2,0
1388,Sergio León,4,2,2,1,1,2,8,25.0,6,4,0,4,2,6,0
1389,Lukas Lerager,34,18,12,20,2,13,42,31.0,29,11,1,10,18,12,0
1390,Lukas Lerager,38,21,14,23,1,18,43,41.9,25,22,10,12,32,26,1
1391,Mehdi Léris,53,33,19,24,10,24,54,44.4,30,34,1,33,28,24,1
1392,Jefferson Lerma,45,31,20,20,5,14,54,25.9,40,35,19,16,54,88,1
1393,Robert Lewandowski,12,9,0,8,4,3,11,27.3,8,11,1,10,7,15,0
1394,Igor Lewczuk,12,7,8,2,2,1,4,25.0,3,2,2,0,4,27,0
1395,Aaron Leya Iseka,6,4,1,4,1,1,4,25.0,3,5,3,2,1,10,0
1396,Stephan Lichtsteiner,15,9,5,4,6,9,16,56.3,7,11,4,7,9,25,1
1397,Dimitri Liénard,33,18,20,9,4,21,45,46.7,24,11,2,9,18,22,0
1398,Philipp Lienhart,6,6,4,2,0,3,6,50.0,3,9,7,2,11,42,0
1399,Lucas Lima,49,28,26,15,8,20,53,37.7,33,39,3,36,29,62,1
1400,Anthony Limbombe,12,10,4,6,2,7,16,43.8,9,5,0,5,8,10,0
1401,Victor Lindelöf,40,27,28,12,0,13,23,56.5,10,21,12,9,24,121,3
1402,Karol Linetty,72,48,26,32,14,15,69,21.7,54,39,4,35,25,17,0
1403,Jesse Lingard,29,18,8,11,10,7,28,25.0,21,18,2,16,10,9,1
1404,Pol Lirola,35,22,19,11,5,21,34,61.8,13,25,5,20,32,89,0
1405,Adem Ljajić,0,0,0,0,0,0,1,0.0,1,0,0,0,0,0,0
1406,Diego Llorente,26,15,16,8,2,17,29,58.6,12,27,15,12,26,83,2
1407,Fernando Llorente,4,2,3,0,1,2,3,66.7,1,7,2,5,1,10,0
1408,Marcos Llorente,16,12,7,7,2,8,18,44.4,10,8,0,8,7,12,0
1409,Hugo Lloris,1,0,1,0,0,0,2,0.0,2,0,0,0,0,13,5
1410,Giovani Lo Celso,52,31,16,28,8,9,35,25.7,26,24,1,23,17,8,0
1411,Giovani Lo Celso,1,1,0,0,1,0,1,0.0,1,0,0,0,0,0,0
1412,Stanislav Lobotka,30,19,10,17,3,9,32,28.1,23,15,1,14,26,18,1
1413,Jürgen Locadia,15,10,5,8,2,3,7,42.9,4,8,0,8,9,13,0
1414,Manuel Locatelli,44,28,19,15,10,13,29,44.8,16,21,3,18,27,33,1
1415,Ruben Loftus-Cheek,18,12,7,7,4,3,12,25.0,9,10,4,6,11,5,0
1416,Enzo Loiodice,25,14,8,15,2,10,21,47.6,11,7,0,7,11,7,0
1417,Kevin Long,18,10,13,5,0,7,17,41.2,10,7,5,2,7,35,1
1418,Shane Long,15,8,4,5,6,3,16,18.8,13,10,1,9,7,18,0
1419,Samuele Longo,4,3,2,2,0,0,6,0.0,6,4,0,4,1,7,0
1420,Sean Longstaff,17,13,6,11,0,9,24,37.5,15,19,4,15,10,7,0
1421,Ademola Lookman,15,7,7,5,3,4,6,66.7,2,10,0,10,7,2,0
1422,Anthony Lopes,1,0,1,0,0,1,3,33.3,2,3,0,3,2,16,3
1423,Rony Lopes,33,22,10,17,6,9,22,40.9,13,17,1,16,8,10,0
1424,Álex López,3,1,1,2,0,2,3,66.7,1,0,0,0,3,1,0
1425,Cristian López,6,3,1,2,3,1,8,12.5,7,4,0,4,1,2,0
1426,David López,27,18,15,10,2,10,22,45.5,12,18,12,6,28,65,2
1427,Diego López,0,0,0,0,0,0,0,,0,0,0,0,2,9,3
1428,Javi López,63,40,37,22,4,28,60,46.7,32,27,5,22,40,90,0
1429,Lluis López,5,3,4,1,0,3,6,50.0,3,6,2,4,7,21,0
1430,Maxime Lopez,46,24,17,23,6,19,53,35.8,34,10,2,8,20,8,0
1431,Pedro López Muñoz,5,3,5,0,0,3,7,42.9,4,8,3,5,8,7,0
1432,Pau López,0,0,0,0,0,0,2,0.0,2,1,0,1,2,17,2
1433,Roberto López,0,0,0,0,0,0,1,0.0,1,1,0,1,1,2,0
1434,Unai López,7,5,3,2,2,2,12,16.7,10,10,3,7,1,2,0
1435,Jonas Lössl,0,0,0,0,0,0,1,0.0,1,1,0,1,2,12,2
1436,Albert Lottin,1,1,0,1,0,0,1,0.0,1,1,0,1,0,0,0
1437,Imran Louza,2,0,1,1,0,1,1,100.0,0,1,0,1,0,1,0
1438,Davor Lovren,1,1,0,0,1,0,0,,0,1,0,1,0,0,0
1439,Dejan Lovren,15,9,10,5,0,7,15,46.7,8,11,7,4,11,51,2
1440,Chris Löwe,34,18,17,15,2,12,33,36.4,21,21,3,18,23,56,0
1441,Eduard Löwen,30,22,14,13,3,11,34,32.4,23,15,2,13,8,23,0
1442,Matthew Lowton,56,35,21,31,4,32,60,53.3,28,29,7,22,30,80,1
1443,Anthony Lozano,6,5,3,3,0,0,6,0.0,6,7,1,6,0,6,0
1444,Derrick Luckassen,4,2,4,0,0,1,3,33.3,2,1,0,1,0,13,0
1445,Filipe Luís,66,36,33,25,8,32,58,55.2,26,18,3,15,44,47,0
1446,José Luis Gayà,83,59,56,20,7,46,80,57.5,34,48,6,42,43,105,1
1447,José Luis Morales,21,15,6,10,5,8,49,16.3,41,22,1,21,12,17,0
1448,José Luis Palomino,49,31,31,15,3,23,38,60.5,15,34,17,17,68,79,0
1449,Luisinho,14,10,9,5,0,10,17,58.8,7,6,1,5,16,17,0
1450,David Luiz,41,31,27,13,1,21,28,75.0,7,33,18,15,35,149,1
1451,Douglas Luiz,34,19,13,20,1,9,38,23.7,29,19,7,12,21,26,0
1452,Everton Luiz,11,6,5,5,1,4,7,57.1,3,9,1,8,3,7,2
1453,Jordan Lukaku,4,3,2,1,1,3,5,60.0,2,3,0,3,5,2,0
1454,Romelu Lukaku,8,4,0,6,2,2,10,20.0,8,12,1,11,2,19,0
1455,Dodi Lukebakio,25,17,11,6,8,8,15,53.3,7,13,0,13,9,19,0
1456,Saša Lukić,21,11,5,11,5,5,16,31.3,11,13,4,9,12,11,0
1457,Senad Lulić,71,43,37,27,7,32,76,42.1,44,27,3,24,49,58,1
1458,Antonio Luna,14,10,6,7,1,6,23,26.1,17,22,7,15,15,48,1
1459,Andriy Lunin,0,0,0,0,0,0,0,,0,0,0,0,0,0,0
1460,Sebastiano Luperto,8,6,5,2,1,2,5,40.0,3,7,3,4,13,30,0
1461,Fabian Lustenberger,45,30,23,21,1,15,33,45.5,18,39,18,21,39,108,2
1462,Andreas Luthe,0,0,0,0,0,0,0,,0,0,0,0,0,4,0
1463,Lyanco,1,1,1,0,0,0,0,,0,1,1,0,4,5,0
1464,Lyanco,29,18,19,10,0,13,18,72.2,5,24,16,8,22,64,0
1465,Hervé Lybohy,22,13,13,9,0,11,16,68.8,5,17,11,6,14,70,0
1466,Charalambos Lykogiannis,14,8,8,3,3,6,11,54.5,5,18,3,15,19,33,0
1467,Yann M'Vila,72,40,22,48,2,29,72,40.3,43,42,12,30,74,86,5
1468,Darwin Machís,7,6,4,3,0,0,4,0.0,4,6,0,6,2,8,0
1469,James Maddison,48,32,20,25,3,14,58,24.1,44,20,4,16,12,10,1
1470,Gary Madine,1,1,0,1,0,0,0,,0,0,0,0,0,0,0
1471,Pablo Maffeo,15,13,10,5,0,6,13,46.2,7,8,4,4,13,17,0
1472,Gabriel Magalhães,18,11,13,4,1,4,7,57.1,3,14,6,8,19,60,2
1473,Francesco Magnanelli,52,33,29,22,1,22,49,44.9,27,18,5,13,24,38,2
1474,Giangiacomo Magnani,11,9,9,2,0,6,15,40.0,9,17,13,4,16,99,1
1475,Harry Maguire,31,17,21,9,1,11,17,64.7,6,32,18,14,36,155,4
1476,Riyad Mahrez,14,7,3,7,4,6,18,33.3,12,18,1,17,9,3,1
1477,Thiago Maia,32,19,17,13,2,13,33,39.4,20,14,5,9,23,23,0
1478,Raffaele Maiello,42,27,30,8,4,16,27,59.3,11,23,10,13,30,41,0
1479,Arne Maier,31,16,12,19,0,6,25,24.0,19,32,9,23,28,35,0
1480,Domenico Maietta,33,15,22,10,1,16,36,44.4,20,19,14,5,24,78,2
1481,Mike Maignan,0,0,0,0,0,0,0,,0,1,0,1,0,12,1
1482,Linton Maina,28,14,13,10,5,12,23,52.2,11,20,0,20,14,4,0
1483,Ainsley Maitland-Niles,33,22,19,12,2,14,28,50.0,14,22,4,18,19,15,2
1484,Josh Maja,2,1,1,1,0,0,1,0.0,1,1,0,1,0,0,0
1485,Abdul Majeed Waris,22,13,6,13,3,7,28,25.0,21,9,0,9,7,7,0
1486,Jean-Victor Makengo,10,8,3,6,1,1,5,20.0,4,5,1,4,9,5,0
1487,Nemanja Maksimović,77,45,21,51,5,21,61,34.4,40,60,15,45,71,33,0
1488,Nikola Maksimović,20,13,14,6,0,6,12,50.0,6,16,10,6,28,56,1
1489,Malcom,3,2,0,1,2,2,3,66.7,1,7,0,7,1,1,0
1490,Kévin Malcuit,43,31,23,14,6,23,36,63.9,13,18,4,14,44,67,0
1491,Yunus Mallı,15,7,8,6,1,2,11,18.2,9,2,0,2,4,1,0
1492,Hugo Mallo,73,41,41,27,5,27,52,51.9,25,44,13,31,50,135,1
1493,Antonio Mance,1,1,0,0,1,1,2,50.0,1,0,0,0,0,0,0
1494,Vincent Manceau,98,65,64,23,11,33,62,53.2,29,41,10,31,44,87,0
1495,Gianluca Mancini,40,30,22,17,1,16,29,55.2,13,19,4,15,48,77,1
1496,Steve Mandanda,0,0,0,0,0,0,3,0.0,3,0,0,0,1,7,4
1497,Reinildo Mandava,3,2,1,2,0,2,3,66.7,1,1,0,1,1,0,0
1498,Aïssa Mandi,52,34,27,20,5,12,29,41.4,17,39,23,16,41,71,2
1499,Rolando Mandragora,66,35,25,34,7,24,69,34.8,45,49,9,40,43,59,0
1500,Mario Mandžukić,34,25,13,15,6,9,18,50.0,9,17,5,12,13,22,0
1501,Sadio Mané,35,29,12,17,6,14,43,32.6,29,28,4,24,15,10,1
1502,Thomas Mangani,42,27,13,26,3,19,62,30.6,43,13,2,11,23,24,0
1503,Kostas Manolas,32,24,23,8,1,17,26,65.4,9,34,25,9,50,117,2
1504,Javier Manquillo,27,19,14,11,2,9,14,64.3,5,9,1,8,17,58,0
1505,Martín Mantovani,15,9,12,3,0,6,11,54.5,5,4,3,1,22,48,0
1506,Juan Manuel Valencia,0,0,0,0,0,0,0,,0,0,0,0,1,0,0
1507,Harrison Manzala,2,2,1,0,1,0,0,,0,0,0,0,0,1,0
1508,Fran Manzanara,7,5,3,3,1,4,4,100.0,0,3,2,1,1,7,0
1509,Myziane Maolida,12,8,5,5,2,2,4,50.0,2,5,0,5,1,5,0
1510,Faitout Maouassa,55,30,35,15,5,23,39,59.0,16,24,5,19,23,81,1
1511,Fernando Marçal,25,16,17,7,1,12,15,80.0,3,9,3,6,30,42,0
1512,Iván Marcano,8,4,4,4,0,5,8,62.5,3,13,6,7,24,45,0
1513,Marcelo,34,19,17,12,5,15,39,38.5,24,19,2,17,17,21,0
1514,Marcelo,48,33,29,17,2,19,24,79.2,5,30,22,8,62,152,2
1515,Solly March,56,24,27,16,13,19,45,42.2,26,34,4,30,27,44,0
1516,Federico Marchetti,0,0,0,0,0,0,0,,0,0,0,0,0,1,0
1517,Gian Marco Ferrari,41,23,27,12,2,12,16,75.0,4,36,20,16,36,97,1
1518,Óscar de Marcos,60,32,34,17,9,29,62,46.8,33,29,4,25,27,62,0
1519,Georg Margreitter,39,24,28,8,3,31,38,81.6,7,29,26,3,26,141,0
1520,Miguel Marí,0,0,0,0,0,0,2,0.0,2,0,0,0,1,2,0
1521,José María Giménez,26,15,20,6,0,13,26,50.0,13,27,14,13,44,128,2
1522,Mariano,2,1,1,1,0,0,3,0.0,3,2,0,2,0,2,0
1523,Mariano,0,0,0,0,0,0,0,,0,0,0,0,1,0,0
1524,Adrian Mariappa,35,22,29,6,0,16,32,50.0,16,23,15,8,26,120,2
1525,Jordan Marié,52,28,15,31,6,21,58,36.2,37,28,5,23,40,32,0
1526,Adrián Marín,13,8,8,5,0,4,7,57.1,3,1,0,1,7,13,0
1527,João Mário,28,16,9,15,4,9,31,29.0,22,14,0,14,6,4,1
1528,Guillermo Maripán,46,26,34,12,0,26,38,68.4,12,35,19,16,40,133,2
1529,Lazar Marković,0,0,0,0,0,0,0,,0,0,0,0,0,2,0
1530,Marlon,29,18,25,3,1,15,21,71.4,6,22,12,10,24,39,0
1531,Marquinhos,65,41,34,28,3,31,52,59.6,21,30,13,17,44,84,1
1532,Roger Martí,8,6,1,4,3,1,19,5.3,18,14,1,13,4,9,0
1533,Anthony Martial,9,7,2,5,2,1,11,9.1,10,12,0,12,3,8,0
1534,Aarón Martín,55,30,29,21,5,20,38,52.6,18,38,11,27,38,75,1
1535,Jonas Martin,46,28,23,18,5,17,33,51.5,16,30,12,18,30,42,0
1536,Marvin Martin,2,1,0,2,0,0,6,0.0,6,2,1,1,2,1,0
1537,Iñigo Martínez,53,26,36,16,1,23,37,62.2,14,24,14,10,69,144,0
1538,Javi Martínez,26,15,7,17,2,5,16,31.3,11,17,5,12,31,13,0
1539,Lautaro Martínez,6,5,0,2,4,2,6,33.3,4,16,0,16,3,7,0
1540,Pablo Martinez,51,34,34,17,0,30,49,61.2,19,37,23,14,52,132,1
1541,Gelson Martins,5,3,3,1,1,3,4,75.0,1,1,0,1,1,1,0
1542,Gelson Martins,20,12,8,7,5,13,32,40.6,19,9,1,8,8,7,0
1543,Adam Marušić,32,15,14,14,4,16,25,64.0,9,25,4,21,24,36,0
1544,Omar Mascarell,20,10,9,9,2,10,24,41.7,14,21,7,14,23,8,0
1545,Andrea Masiello,28,14,13,15,0,17,29,58.6,12,21,6,15,44,49,0
1546,Adam Masina,30,17,16,13,1,13,25,52.0,12,19,4,15,17,40,0
1547,Jordi Masip,1,1,1,0,0,0,0,,0,1,0,1,1,3,3
1548,Han-Noah Massengo,2,2,2,0,0,2,5,40.0,3,0,0,0,2,1,0
1549,Arthur Masuaku,57,25,38,13,6,31,56,55.4,25,27,6,21,36,72,0
1550,Jaime Mata,30,21,8,14,8,7,26,26.9,19,14,0,14,17,27,0
1551,Juan Mata,9,4,7,1,1,6,21,28.6,15,8,1,7,6,6,0
1552,Luca Matarese,0,0,0,0,0,0,0,,0,0,0,0,0,0,0
1553,Jean-Philippe Mateta,13,9,4,4,5,1,10,10.0,9,15,2,13,3,22,0
1554,Christian Mathenia,0,0,0,0,0,0,0,,0,1,0,1,1,18,2
1555,Nemanja Matić,50,30,27,19,4,30,59,50.8,29,39,18,21,31,53,4
1556,Joël Matip,39,26,23,12,4,13,24,54.2,11,12,7,5,32,78,0
1557,Rabbi Matondo,4,1,4,0,0,1,5,20.0,4,2,0,2,0,1,0
1558,Alessandro Matri,2,1,0,0,2,0,3,0.0,3,4,2,2,4,7,0
1559,Federico Mattiello,33,20,19,9,5,15,23,65.2,8,9,3,6,20,43,0
1560,Blaise Matuidi,59,33,25,21,13,20,36,55.6,16,33,8,25,26,21,1
1561,José Mauri,8,4,2,6,0,2,6,33.3,4,0,0,0,5,0,0
1562,Stephy Mavididi,0,0,0,0,0,0,0,,0,1,0,1,0,0,0
1563,Konstantinos Mavropanos,1,0,0,1,0,1,1,100.0,0,1,1,0,7,5,0
1564,Alfie Mawson,11,7,7,4,0,6,10,60.0,4,20,17,3,19,64,1
1565,Philipp Max,35,24,17,15,3,21,39,53.8,18,16,3,13,22,46,1
1566,Alexandru Maxim,16,10,6,9,1,10,19,52.6,9,12,0,12,5,7,0
1567,Eric Maxim Choupo-Moting,9,4,3,2,4,2,9,22.2,7,7,0,7,3,4,0
1568,Borja Mayoral,9,4,1,6,2,5,16,31.3,11,10,1,9,5,5,0
1569,Róbert Mazáň,3,3,3,0,0,2,2,100.0,0,2,0,2,3,0,0
1570,Luca Mazzitelli,5,2,3,1,1,2,3,66.7,1,4,1,3,6,7,0
1571,Kylian Mbappé,8,4,2,1,5,1,6,16.7,5,2,0,2,5,2,0
1572,Ibrahima Mbaye,48,32,30,16,2,19,32,59.4,13,21,12,9,19,66,1
1573,Loïc Mbe Soh,0,0,0,0,0,0,3,0.0,3,2,2,0,3,5,0
1574,Nolan Mbemba,14,8,10,4,0,6,9,66.7,3,4,1,3,10,4,2
1575,Adama Mbengue,48,32,34,12,2,19,26,73.1,7,15,4,11,7,22,0
1576,Isaac Mbenza,10,9,5,5,0,2,4,50.0,2,4,0,4,5,4,0
1577,Stéphane Mbia,1,0,1,0,0,1,2,50.0,1,9,4,5,7,25,1
1578,Kara Mbodji,12,10,10,1,1,6,8,75.0,2,4,1,3,6,25,0
1579,Jordi Mboula,3,0,0,1,2,3,6,50.0,3,1,0,1,1,5,0
1580,James McArthur,84,51,38,32,14,30,78,38.5,48,64,22,42,39,55,0
1581,Alex McCarthy,0,0,0,0,0,0,0,,0,0,0,0,0,6,2
1582,James McCarthy,2,1,1,1,0,0,0,,0,0,0,0,1,0,0
1583,Kevin McDonald,15,11,6,8,1,5,13,38.5,8,8,2,6,9,22,0
1584,Levan Mchedlidze,1,1,0,0,1,0,1,0.0,1,2,0,2,0,5,0
1585,Weston McKennie,28,14,5,17,6,11,35,31.4,24,28,9,19,36,46,1
1586,Dwight McNeil,36,22,16,17,3,13,44,29.5,31,30,3,27,13,35,0
1587,Scott McTominay,10,9,3,6,1,4,10,40.0,6,9,4,5,15,16,0
1588,Iuri Medeiros,2,2,0,1,1,1,2,50.0,1,2,0,2,0,1,0
1589,Nicky Medja,1,0,0,0,1,1,2,50.0,1,0,0,0,0,0,0
1590,Álvaro Medrán,15,8,5,6,4,6,21,28.6,15,10,1,9,17,9,0
1591,Ben Mee,55,24,38,17,0,35,44,79.5,9,59,50,9,48,235,4
1592,Riccardo Meggiorini,17,13,5,9,3,1,10,10.0,9,20,2,18,8,26,0
1593,Admir Mehmedi,46,28,19,19,8,18,44,40.9,26,25,0,25,12,9,0
1594,Soualiho Meïté,46,21,13,22,11,23,46,50.0,23,46,6,40,29,26,0
1595,Farid El Melali,8,4,3,4,1,3,12,25.0,9,2,0,2,5,1,0
1596,Óscar Melendo,17,8,7,6,4,10,26,38.5,16,17,1,16,13,9,0
1597,Gonzalo Melero,26,23,5,19,2,11,48,22.9,37,14,4,10,2,23,0
1598,Arthur Melo,15,10,5,6,4,6,13,46.2,7,8,0,8,9,9,1
1599,Memphis,12,9,0,7,5,5,21,23.8,16,16,2,14,9,1,0
1600,Pedro Mendes,71,42,56,13,2,31,47,66.0,16,42,22,20,48,73,1
1601,Thiago Mendes,85,47,42,41,2,39,71,54.9,32,44,11,33,68,49,0
1602,Brais Méndez,61,31,23,29,9,14,53,26.4,39,32,3,29,24,24,0
1603,Nathaniel Mendez-Laing,34,25,18,12,4,12,26,46.2,14,17,1,16,13,20,0
1604,Stiven Mendoza,29,18,10,12,7,14,38,36.8,24,18,0,18,17,12,0
1605,Alexandre Mendy,5,3,0,4,1,3,8,37.5,5,3,0,3,1,6,0
1606,Benjamin Mendy,16,10,10,5,1,9,17,52.9,8,13,4,9,10,18,0
1607,Edouard Mendy,0,0,0,0,0,0,1,0.0,1,1,0,1,2,16,3
1608,Ferland Mendy,44,28,25,14,5,14,17,82.4,3,22,5,17,34,53,2
1609,Nampalys Mendy,33,18,16,16,1,6,22,27.3,16,24,8,16,26,26,2
1610,Hamza Mendyl,17,15,6,8,3,8,18,44.4,10,11,2,9,8,8,0
1611,Chris Mepham,9,3,9,0,0,7,11,63.6,4,12,5,7,14,57,2
1612,Gabriel Mercado,35,23,21,12,2,18,36,50.0,18,24,12,12,26,75,1
1613,Alex Meret,0,0,0,0,0,0,0,,0,0,0,0,0,3,1
1614,Mehdi Merghem,25,18,15,7,3,11,21,52.4,10,14,1,13,9,6,0
1615,Mikel Merino,50,28,19,25,6,14,52,26.9,38,37,2,35,29,37,1
1616,Sabin Merino,1,1,0,0,1,1,1,100.0,0,1,0,1,0,4,0
1617,Martín Merquelanz,0,0,0,0,0,0,0,,0,0,0,0,0,0,0
1618,Dries Mertens,19,11,2,7,10,1,21,4.8,20,7,0,7,13,3,0
1619,Roque Mesa,46,27,16,22,8,15,38,39.5,23,16,0,16,14,12,4
1620,Lionel Messi,12,7,5,3,4,1,17,5.9,16,10,0,10,3,1,0
1621,Romain Métanire,12,9,10,1,1,5,7,71.4,2,4,3,1,6,13,0
1622,Thomas Meunier,44,33,25,15,4,21,35,60.0,14,13,2,11,19,29,0
1623,Mexer,23,12,18,5,0,12,18,66.7,6,26,18,8,30,125,0
1624,Max Meyer,33,18,14,18,1,11,20,55.0,9,6,0,6,15,19,0
1625,Matt Miazga,12,11,11,1,0,7,9,77.8,2,11,7,4,12,41,1
1626,Míchel,60,38,25,31,4,18,73,24.7,55,40,4,36,43,30,1
1627,Clément Michelin,3,2,2,1,0,2,3,66.7,1,0,0,0,3,7,0
1628,Petar Mićin,0,0,0,0,0,0,0,,0,0,0,0,0,0,0
1629,Miguel,0,0,0,0,0,0,1,0.0,1,0,0,0,1,0,0
1630,Florian Miguel,19,16,13,6,0,7,11,63.6,4,15,7,8,21,47,0
1631,Nikola Milenković,59,40,36,21,2,17,33,51.5,16,39,21,18,48,143,0
1632,Arkadiusz Milik,19,9,1,8,10,1,20,5.0,19,7,2,5,3,15,0
1633,Sergej Milinković-Savić,44,28,17,21,6,23,60,38.3,37,28,4,24,27,48,0
1634,Vanja Milinković-Savić,0,0,0,0,0,0,0,,0,0,0,0,0,1,0
1635,Luka Milivojević,90,69,36,47,7,39,91,42.9,52,47,15,32,72,68,3
1636,Pere Milla,7,6,1,5,1,0,5,0.0,5,4,1,3,2,1,0
1637,Vincenzo Millico,0,0,0,0,0,0,0,,0,0,0,0,0,0,0
1638,James Milner,43,23,14,24,5,15,41,36.6,26,40,5,35,18,30,0
1639,Santi Mina,17,10,1,15,1,3,25,12.0,22,19,2,17,4,20,0
1640,Yerry Mina,14,7,8,6,0,6,9,66.7,3,11,5,6,8,54,3
1641,Tyrone Mings,4,3,3,1,0,2,3,66.7,1,5,2,3,6,8,0
1642,Ignasi Miquel,1,0,0,1,0,1,2,50.0,1,4,4,0,5,25,0
1643,Kevin Mirallas,17,7,8,4,5,6,15,40.0,9,17,0,17,4,10,0
1644,Jorge Miramón,73,55,49,17,7,34,53,64.2,19,34,11,23,44,65,1
1645,Miranda,11,7,7,4,0,4,8,50.0,4,11,7,4,14,48,2
1646,Antonio Mirante,0,0,0,0,0,0,0,,0,0,0,0,0,6,1
1647,Virgil Misidjan,21,13,10,5,6,4,25,16.0,21,17,0,17,9,5,0
1648,Simone Missiroli,58,43,31,22,5,25,49,51.0,24,44,11,33,46,46,0
1649,Kostas Mitroglou,0,0,0,0,0,0,3,0.0,3,0,0,0,0,5,0
1650,Aleksandar Mitrović,19,9,3,13,3,5,15,33.3,10,22,8,14,6,53,0
1651,Stefan Mitrović,23,16,20,3,0,12,24,50.0,12,41,31,10,46,146,2
1652,Maximilian Mittelstädt,61,37,33,23,5,23,49,46.9,26,32,4,28,46,64,0
1653,Henrikh Mkhitaryan,28,22,8,17,3,6,22,27.3,16,34,2,32,16,13,0
1654,Luka Modrić,49,30,11,25,13,14,48,29.2,34,20,3,17,31,7,1
1655,Kevin Möhwald,16,10,3,11,2,3,20,15.0,17,14,0,14,17,14,0
1656,Niklas Moisander,34,23,26,8,0,22,51,43.1,29,42,19,23,39,140,2
1657,Johan Mojica,1,1,1,0,0,0,0,,0,0,0,0,0,0,0
1658,Hakim El Mokeddem,1,1,1,0,0,0,1,0.0,1,0,0,0,0,1,0
1659,Jorge Molina,12,9,1,4,7,2,15,13.3,13,22,0,22,7,26,1
1660,Cristian Molinaro,15,10,7,7,1,3,9,33.3,6,11,4,7,15,43,0
1661,Victor Mollejo,0,0,0,0,0,0,2,0.0,2,0,0,0,0,0,0
1662,Florent Mollet,36,20,8,20,8,13,51,25.5,38,32,1,31,23,7,0
1663,Gabriele Moncini,1,1,1,0,0,0,0,,0,0,0,0,0,0,0
1664,Thomas Monconduit,76,47,38,33,5,26,63,41.3,37,46,17,29,36,77,1
1665,Kévin Monnet-Paquet,46,25,23,16,7,20,36,55.6,16,22,4,18,14,28,0
1666,Nacho Monreal,35,17,21,9,5,15,25,60.0,10,28,10,18,31,62,0
1667,Francisco Montero,8,4,5,3,0,5,6,83.3,1,10,4,6,5,18,1
1668,Cristóbal Montiel,0,0,0,0,0,0,0,,0,0,0,0,0,0,0
1669,Martín Montoya,58,35,29,21,8,32,55,58.2,23,30,10,20,48,76,1
1670,Aaron Mooy,62,42,19,27,16,21,52,40.4,31,43,7,36,14,22,0
1671,Emre Mor,7,4,1,3,3,2,7,28.6,5,5,0,5,3,1,0
1672,Alfredo Morales,32,18,16,15,1,6,24,25.0,18,18,9,9,24,31,0
1673,Álvaro Morata,8,5,0,5,3,1,7,14.3,6,6,1,5,0,6,0
1674,Álvaro Morata,20,14,2,7,11,3,10,30.0,7,7,0,7,5,13,0
1675,Jan Morávek,38,21,17,16,5,19,42,45.2,23,21,1,20,9,13,0
1676,Steven Moreira,19,8,13,5,1,10,17,58.8,7,14,0,14,10,19,1
1677,Jérémy Morel,16,10,11,5,0,9,13,69.2,4,18,14,4,18,45,1
1678,Alberto Moreno,3,2,1,2,0,1,3,33.3,2,1,0,1,2,0,0
1679,Álex Moreno,63,40,41,18,4,29,53,54.7,24,35,9,26,41,97,0
1680,Gerard Moreno,22,12,2,15,5,8,27,29.6,19,23,9,14,9,39,0
1681,Héctor Moreno,16,9,12,4,0,9,17,52.9,8,34,19,15,31,73,0
1682,Sergio Moreno,0,0,0,0,0,0,0,,0,0,0,0,0,0,0
1683,Emiliano Moretti,30,21,21,9,0,13,20,65.0,7,14,6,8,24,65,1
1684,Wes Morgan,27,15,14,12,1,6,7,85.7,1,24,10,14,32,109,1
1685,Manu Morlanes,21,11,9,9,3,7,19,36.8,12,7,3,4,5,9,0
1686,Loren Morón,18,12,4,11,3,6,27,22.2,21,24,1,23,6,18,0
1687,Sean Morrison,35,17,29,4,2,15,28,53.6,13,47,30,17,52,204,5
1688,Victor Moses,0,0,0,0,0,0,0,,0,1,0,1,0,0,0
1689,Lebo Mothiba,10,9,2,7,1,0,8,0.0,8,5,1,4,0,6,0
1690,Lebo Mothiba,1,1,0,1,0,0,0,,0,0,0,0,0,8,0
1691,François Moubandje,38,22,22,10,6,17,22,77.3,5,18,4,14,27,74,0
1692,Jessy Moulin,1,0,1,0,0,1,1,100.0,0,0,0,0,0,2,0
1693,Steve Mounié,9,6,3,4,2,2,12,16.7,10,10,1,9,5,15,0
1694,Lucas Moura,35,18,8,20,7,9,27,33.3,18,15,1,14,24,24,0
1695,Herman Moussaki,3,3,2,1,0,1,4,25.0,3,2,1,1,0,3,0
1696,Lys Mousset,3,1,1,1,1,1,4,25.0,3,3,0,3,1,3,0
1697,João Moutinho,113,58,50,56,7,44,126,34.9,82,56,11,45,40,50,0
1698,Samuel Moutoussamy,35,20,16,11,8,12,34,35.3,22,17,2,15,9,17,0
1699,Toni Moya,2,2,2,0,0,0,1,0.0,1,0,0,0,0,3,0
1700,Javi Moyano,25,17,17,6,2,15,30,50.0,15,20,9,11,25,88,2
1701,Samuel Mráz,0,0,0,0,0,0,0,,0,2,0,2,0,2,0
1702,Ndombe Mubele,9,4,5,2,2,4,9,44.4,5,4,0,4,2,2,0
1703,Lukas Mühl,57,34,49,6,2,32,51,62.7,19,53,18,35,48,139,2
1704,Nordi Mukiele,38,21,23,12,3,19,22,86.4,3,17,3,14,24,35,0
1705,Florian Müller,1,1,1,0,0,1,2,50.0,1,0,0,0,3,8,5
1706,Nicolai Müller,18,9,7,7,4,8,27,29.6,19,9,1,8,1,7,0
1707,Nicolai Müller,4,2,3,1,0,1,2,50.0,1,4,1,3,0,0,0
1708,Thomas Müller,42,23,13,15,14,10,38,26.3,28,46,6,40,9,12,0
1709,Gianni Munari,0,0,0,0,0,0,0,,0,0,0,0,0,0,0
1710,Iker Muniain,29,20,10,14,5,6,29,20.7,23,17,3,14,12,6,0
1711,Marc Muniesa,49,34,27,17,5,15,28,53.6,13,18,6,12,37,49,1
1712,Aihen Muñoz,13,8,11,2,0,10,19,52.6,9,19,9,10,7,26,0
1713,Ezequiel Muñoz,3,2,1,2,0,0,0,,0,3,1,2,1,10,0
1714,Joaquín Muñoz,0,0,0,0,0,0,0,,0,0,0,0,0,0,0
1715,Alessandro Murgia,22,15,9,12,1,7,32,21.9,25,14,2,12,19,12,1
1716,Alessandro Murgia,0,0,0,0,0,0,0,,0,0,0,0,0,0,0
1717,Luis Muriel,19,11,4,13,2,6,18,33.3,12,10,0,10,3,1,0
1718,Luis Muriel,0,0,0,0,0,0,6,0.0,6,3,0,3,0,1,0
1719,Jeison Murillo,2,1,1,1,0,1,2,50.0,1,1,0,1,2,6,0
1720,Jeison Murillo,2,2,1,1,0,0,3,0.0,3,0,0,0,0,5,1
1721,Jacob Murphy,6,2,4,2,0,2,4,50.0,2,5,2,3,1,7,0
1722,Josh Murphy,26,17,15,7,4,9,29,31.0,20,30,0,30,11,17,0
1723,Glenn Murray,17,7,4,7,6,4,20,20.0,16,20,3,17,2,17,1
1724,Nicola Murru,83,59,42,25,16,41,54,75.9,13,50,22,28,41,99,0
1725,Mateo Musacchio,41,22,30,8,3,19,27,70.4,8,26,19,7,29,114,0
1726,Florent Muslija,16,10,8,6,2,8,12,66.7,4,4,0,4,3,4,0
1727,Juan Musso,0,0,0,0,0,0,1,0.0,1,0,0,0,0,10,4
1728,Shkodran Mustafi,62,45,42,17,3,31,40,77.5,9,34,17,17,58,168,1
1729,Damián Musto,52,34,22,27,3,16,33,48.5,17,30,11,19,34,54,1
1730,Yoshinori Mutō,8,4,3,5,0,2,7,28.6,5,9,0,9,5,3,1
1731,Yvon Mvogo,0,0,0,0,0,0,0,,0,0,0,0,0,1,0
1732,Phillipp Mwene,7,2,3,4,0,5,6,83.3,1,6,0,6,6,10,0
1733,Obite N'Dicka,43,28,31,10,2,31,52,59.6,21,29,11,18,29,123,0
1734,Kévin N'Doram,5,4,1,4,0,3,5,60.0,2,1,1,0,5,8,1
1735,Abdallah N'dour,6,4,3,3,0,4,9,44.4,5,4,2,2,5,8,0
1736,Cheikh N'Doye,25,15,14,11,0,10,32,31.3,22,33,8,25,25,61,0
1737,Nathan N'Goumou,1,1,0,1,0,0,1,0.0,1,1,0,1,0,3,0
1738,Clinton N'Jie,7,4,2,3,2,3,3,100.0,0,2,0,2,2,0,0
1739,Georges-Kévin N'Koudou,0,0,0,0,0,0,0,,0,0,0,0,0,0,0
1740,Georges-Kévin N'Koudou,2,1,0,0,2,1,1,100.0,0,2,0,2,0,0,0
1741,Stanley N'Soki,20,14,8,10,2,6,13,46.2,7,10,1,9,18,20,1
1742,Nacho,110,66,73,30,7,67,100,67.0,33,43,10,33,45,113,2
1743,Nacho,26,19,14,7,5,11,22,50.0,11,19,7,12,32,65,1
1744,Ádám Nagy,29,21,15,13,1,11,21,52.4,10,13,5,8,25,12,2
1745,Radja Nainggolan,35,26,7,20,8,10,24,41.7,14,17,2,15,8,5,0
1746,Naldo,18,10,9,5,4,6,10,60.0,4,19,13,6,26,112,1
1747,Naldo,5,3,4,1,0,2,4,50.0,2,5,2,3,5,23,0
1748,Naldo,10,7,8,2,0,5,8,62.5,3,8,3,5,14,25,0
1749,Samir Nasri,0,0,0,0,0,0,0,,0,1,0,1,1,1,0
1750,Matija Nastasić,35,23,22,13,0,20,29,69.0,9,32,20,12,38,114,1
1751,Marc Navarro,4,2,3,1,0,3,4,75.0,1,0,0,0,0,4,0
1752,Ximo Navarro,57,35,44,12,1,32,45,71.1,13,25,11,14,47,143,1
1753,Jesús Navas,28,21,15,11,2,16,24,66.7,8,23,5,18,29,62,0
1754,Keylor Navas,0,0,0,0,0,0,0,,0,0,0,0,1,5,0
1755,Raúl Navas,23,14,20,3,0,13,21,61.9,8,20,9,11,20,60,1
1756,Wilfred Ndidi,142,98,66,67,9,46,95,48.4,49,64,9,55,83,85,2
1757,Aly Ndom,0,0,0,0,0,0,0,,0,0,0,0,1,1,0
1758,Aly Ndom,11,9,5,5,1,3,7,42.9,4,6,2,4,3,9,1
1759,Tanguy Ndombele,66,43,21,35,10,22,54,40.7,32,29,9,20,30,13,3
1760,Angelo Ndrecka,1,1,1,0,0,1,2,50.0,1,3,2,1,0,1,0
1761,Reiss Nelson,17,10,8,4,5,2,13,15.4,11,12,1,11,5,2,0
1762,Neto,2,0,2,0,0,2,3,66.7,1,0,0,0,1,9,3
1763,Pedro Neto,0,0,0,0,0,0,0,,0,1,0,1,0,0,0
1764,Manuel Neuer,1,1,1,0,0,0,1,0.0,1,1,0,1,0,8,3
1765,Florian Neuhaus,22,15,9,9,4,10,36,27.8,26,20,1,19,10,23,0
1766,Rúben Neves,75,32,33,36,6,27,83,32.5,56,57,18,39,73,46,3
1767,Neymar,14,9,3,10,1,4,21,19.0,17,8,0,8,5,1,1
1768,Yeni Ngbakoto,9,4,4,3,2,4,8,50.0,4,7,0,7,4,2,0
1769,Moussa Niakhate,49,30,35,12,2,20,33,60.6,13,42,24,18,44,143,1
1770,M'Baye Niang,16,10,3,8,5,2,11,18.2,9,19,3,16,8,14,0
1771,Oumar Niasse,12,3,1,5,6,4,8,50.0,4,7,0,7,2,7,0
1772,Oumar Niasse,0,0,0,0,0,0,1,0.0,1,0,0,0,0,0,0
1773,Hans Nicolussi Caviglia,2,1,0,2,0,0,2,0.0,2,2,1,1,0,0,0
1774,Florian Niederlechner,7,5,1,4,2,0,5,0.0,5,12,4,8,6,10,0
1775,Saúl Ñíguez,83,56,35,41,7,32,81,39.5,49,57,10,47,42,86,1
1776,Dimitris Nikolaou,5,3,3,2,0,1,2,50.0,1,2,2,0,2,14,0
1777,Casimir Ninga,53,30,23,21,9,20,49,40.8,29,22,1,21,22,12,0
1778,Eddie Nketiah,1,1,0,1,0,0,0,,0,0,0,0,0,1,0
1779,Nicolas Nkoulou,45,29,34,10,1,15,25,60.0,10,42,28,14,70,174,2
1780,Christopher Nkunku,21,16,8,10,3,7,16,43.8,9,12,2,10,9,7,1
1781,Mark Noble,47,26,19,24,4,17,52,32.7,35,17,2,15,21,13,0
1782,Peru Nolaskoain,11,8,7,4,0,5,9,55.6,4,11,6,5,10,18,0
1783,Nolito,3,2,1,1,1,1,2,50.0,1,2,0,2,0,1,0
1784,Arnaud Nordin,14,12,4,4,6,4,11,36.4,7,13,2,11,5,9,0
1785,Håvard Nordtveit,9,4,8,1,0,4,5,80.0,1,3,3,0,8,15,1
1786,Håvard Nordtveit,8,5,2,4,2,3,7,42.9,4,8,5,3,4,14,0
1787,Will Norris,0,0,0,0,0,0,0,,0,0,0,0,0,0,0
1788,Alexander Nübel,0,0,0,0,0,0,1,0.0,1,0,0,0,1,4,1
1789,Kasim Nuhu,19,11,14,3,2,10,23,43.5,13,11,5,6,23,44,0
1790,Unai Núñez,15,11,11,4,0,7,11,63.6,4,20,12,8,28,60,2
1791,Hans Nunoo Sarpei,1,1,0,1,0,0,0,,0,0,0,0,0,0,0
1792,Bram Nuytinck,50,35,34,13,3,25,33,75.8,8,44,27,17,29,126,0
1793,Gerzino Nyamsi,6,3,5,1,0,4,9,44.4,5,8,4,4,4,17,0
1794,Allan Nyom,32,24,20,10,2,12,17,70.6,5,7,2,5,20,35,0
1795,Steven Nzonzi,66,45,24,36,6,21,34,61.8,13,40,24,16,27,55,2
1796,Christian Nørgaard,4,2,1,2,1,2,5,40.0,3,2,0,2,10,16,0
1797,Michael Obafemi,1,1,0,0,1,0,0,,0,1,1,0,1,0,0
1798,Dimitri Oberlin,1,1,0,0,1,0,3,0.0,3,1,0,1,0,1,0
1799,Joel Obi,22,15,9,11,2,7,17,41.2,10,12,1,11,14,15,0
1800,Pedro Obiang,41,23,23,16,2,18,43,41.9,25,27,9,18,12,18,0
1801,Jan Oblak,1,0,1,0,0,1,1,100.0,0,0,0,0,1,13,1
1802,Lucas Ocampos,80,54,37,33,10,34,80,42.5,46,40,5,35,29,30,0
1803,Bastian Oczipka,41,27,20,19,2,21,26,80.8,5,23,5,18,24,24,2
1804,Jens Odgaard,0,0,0,0,0,0,0,,0,1,0,1,0,1,0
1805,Denis Odoi,48,34,29,16,3,21,33,63.6,12,45,24,21,42,153,0
1806,Álvaro Odriozola,28,25,13,11,4,14,18,77.8,4,11,1,10,11,17,1
1807,Angelo Ogbonna,31,13,23,6,2,14,23,60.9,9,29,19,10,35,101,0
1808,Dani Ojeda,3,2,2,0,1,1,3,33.3,2,2,0,2,2,2,0
1809,Sheyi Ojo,8,6,2,4,2,2,8,25.0,6,1,0,1,3,2,0
1810,Stefano Okaka,0,0,0,0,0,0,0,,0,1,0,1,0,0,0
1811,Stefano Okaka,13,7,4,5,4,2,8,25.0,6,6,1,5,0,16,1
1812,Shinji Okazaki,5,5,2,3,0,0,1,0.0,1,7,1,6,2,1,0
1813,Chima Okoroji,3,0,1,1,1,1,1,100.0,0,0,0,0,1,1,0
1814,Orji Okwonkwo,4,3,1,2,1,2,2,100.0,0,0,0,0,1,0,0
1815,Lucas Olaza,29,18,19,8,2,14,18,77.8,4,13,6,7,8,18,0
1816,Oier Olazábal,1,1,1,0,0,1,2,50.0,1,1,0,1,1,15,2
1817,Kiko Olivas,51,38,35,15,1,22,48,45.8,26,31,18,13,46,173,2
1818,Paulo Oliveira,49,39,33,16,0,28,44,63.6,16,25,10,15,36,116,0
1819,Mathías Olivera,24,17,11,8,5,10,18,55.6,8,25,2,23,10,22,0
1820,Alexandre Olliero,0,0,0,0,0,0,0,,0,0,0,0,0,0,0
1821,Robin Olsen,0,0,0,0,0,0,1,0.0,1,1,0,1,0,10,4
1822,Stephane Omeonga,1,1,1,0,0,0,1,0.0,1,1,0,1,0,2,0
1823,Kenneth Omeruo,49,27,41,8,0,20,29,69.0,9,23,11,12,37,159,3
1824,Prince Oniangué,59,33,22,34,3,24,57,42.1,33,30,10,20,29,42,0
1825,Karim Onisiwo,23,15,6,12,5,4,12,33.3,8,14,3,11,9,13,0
1826,Nicholas Opoku,16,9,15,1,0,10,17,58.8,7,8,5,3,18,29,0
1827,Willi Orban,49,26,31,15,3,24,38,63.2,14,33,15,18,36,140,0
1828,Fabián Orellana,44,21,14,16,14,9,42,21.4,33,17,0,17,19,4,0
1829,Divock Origi,6,1,2,3,1,1,4,25.0,3,2,0,2,0,2,0
1830,Riccardo Orsolini,40,24,16,18,6,9,39,23.1,30,23,2,21,14,25,1
1831,Yuya Osako,23,11,6,12,5,7,22,31.8,15,15,3,12,7,8,0
1832,David Ospina,1,0,1,0,0,1,1,100.0,0,0,0,0,0,7,1
1833,Matthias Ostrzolek,32,18,24,8,0,20,33,60.6,13,20,5,15,26,44,2
1834,Nicolás Otamendi,24,14,17,6,1,5,9,55.6,4,6,4,2,29,56,1
1835,Otávio,127,74,59,64,4,49,109,45.0,60,45,11,34,43,54,1
1836,David Otto,2,1,1,1,0,0,1,0.0,1,0,0,0,0,0,0
1837,Remi Oudin,51,32,25,18,8,20,45,44.4,25,29,5,24,42,34,0
1838,Adam Ounas,5,2,0,3,2,2,11,18.2,9,6,0,6,2,0,1
1839,Reece Oxford,12,9,9,3,0,4,6,66.7,2,10,9,1,11,39,0
1840,Alex Oxlade-Chamberlain,1,1,0,1,0,1,1,100.0,0,0,0,0,1,0,0
1841,Mikel Oyarzabal,36,20,15,15,6,12,49,24.5,37,54,3,51,14,26,0
1842,Ambroise Oyongo,44,21,23,16,5,20,38,52.6,18,26,6,20,38,60,0
1843,Berkay Özcan,0,0,0,0,0,0,0,,0,1,0,1,0,0,0
1844,Ramazan Özcan,0,0,0,0,0,0,0,,0,0,0,0,1,2,0
1845,Mesut Özil,12,5,6,3,3,3,21,14.3,18,10,2,8,4,5,0
1846,Levin Öztunalı,17,7,5,9,3,4,18,22.2,14,14,2,12,7,10,0
1847,Pablo,26,15,22,3,1,13,23,56.5,10,28,22,6,32,173,2
1848,Fernando Pacheco,0,0,0,0,0,0,1,0.0,1,0,0,0,1,23,0
1849,Gonçalo Paciência,3,2,0,2,1,1,2,50.0,1,8,1,7,0,1,0
1850,Simone Padoin,34,25,12,18,4,14,33,42.4,19,18,5,13,14,54,0
1851,Luca Paganini,25,13,8,13,4,8,23,34.8,15,19,4,15,19,17,1
1852,Marko Pajač,7,7,2,3,2,5,11,45.5,6,3,0,3,7,18,0
1853,Marko Pajač,1,1,0,0,1,0,0,,0,1,1,0,1,3,0
1854,Vincent Pajot,18,14,6,8,4,4,14,28.6,10,9,0,9,8,6,0
1855,Rodrigo Palacio,24,13,8,12,4,4,34,11.8,30,35,0,35,5,13,0
1856,Federico Palacios Martínez,21,10,11,8,2,10,20,50.0,10,10,0,10,9,4,0
1857,Sergi Palencia,74,50,46,20,8,27,55,49.1,28,22,3,19,17,70,1
1858,Nicolas Pallois,77,48,60,17,0,40,69,58.0,29,30,14,16,34,114,0
1859,Emerson Palmieri,14,9,6,5,3,6,10,60.0,4,11,1,10,8,14,0
1860,Alberto Paloschi,13,9,3,5,5,1,2,50.0,1,2,0,2,1,0,0
1861,Goran Pandev,14,10,0,10,4,2,8,25.0,6,7,0,7,1,3,0
1862,Mickaël Panos,1,0,0,1,0,1,2,50.0,1,2,0,2,1,0,0
1863,Sokratis Papastathopoulos,42,25,30,11,1,15,28,53.6,13,34,17,17,26,112,1
1864,Elhadji Pape Diaw,0,0,0,0,0,0,0,,0,0,0,0,1,0,0
1865,Lucas Paquetá,18,9,9,8,1,7,24,29.2,17,12,0,12,4,11,2
1866,Gaëtan Paquiez,43,29,30,10,3,23,48,47.9,25,24,6,18,22,50,0
1867,Rubén Pardo,11,7,2,9,0,4,17,23.5,13,14,6,8,21,9,0
1868,Leandro Paredes,34,19,16,15,3,13,30,43.3,17,17,5,12,14,20,2
1869,Daniel Parejo,73,42,41,24,8,31,90,34.4,59,41,7,34,46,26,2
1870,Vittorio Parigini,11,10,3,6,2,6,9,66.7,3,3,0,3,1,5,0
1871,Marco Parolo,68,45,24,37,7,18,56,32.1,38,48,11,37,28,56,0
1872,Thomas Partey,66,42,32,25,9,21,49,42.9,28,26,5,21,49,22,2
1873,Mario Pašalić,32,19,9,13,10,7,29,24.1,22,19,4,15,12,14,1
1874,Manuel Pasqual,26,19,12,11,3,17,45,37.8,28,7,0,7,11,31,0
1875,Javier Pastore,10,4,4,3,3,4,16,25.0,12,7,0,7,3,5,0
1876,Callum Paterson,21,14,7,7,7,5,26,19.2,21,23,2,21,8,29,0
1877,Patric,19,11,8,8,3,8,15,53.3,7,14,7,7,12,29,1
1878,Rui Patrício,2,0,2,0,0,2,3,66.7,1,0,0,0,1,7,4
1879,Paulinho,4,4,2,2,0,1,2,50.0,1,3,0,3,2,0,1
1880,Gabriel Paulista,29,16,20,6,3,14,28,50.0,14,37,21,16,70,162,1
1881,Benjamin Pavard,28,20,21,6,1,12,19,63.2,7,27,19,8,48,189,2
1882,Jiří Pavlenka,3,0,3,0,0,3,6,50.0,3,1,0,1,3,14,1
1883,Mateo Pavlović,26,18,24,2,0,12,24,50.0,12,37,29,8,20,164,2
1884,Leonardo Pavoletti,32,21,6,17,9,6,16,37.5,10,12,3,9,7,26,0
1885,Dimitri Payet,11,9,2,8,1,5,22,22.7,17,14,0,14,8,8,0
1886,Nehuén Paz,2,1,2,0,0,1,2,50.0,1,3,1,2,0,2,0
1887,Alfonso Pedraza,59,44,34,19,6,22,62,35.5,40,33,7,26,29,55,0
1888,Pedro,27,14,11,10,6,9,35,25.7,26,13,2,11,18,8,1
1889,João Pedro,17,12,4,8,5,4,11,36.4,7,14,5,9,6,14,0
1890,Adrià Pedrosa,14,9,11,2,1,7,14,50.0,7,10,4,6,8,27,0
1891,Stef Peeters,15,8,8,4,3,4,11,36.4,7,1,0,1,6,1,0
1892,Jordan Pefok,6,2,0,3,3,2,4,50.0,2,7,2,5,4,5,0
1893,Gianluca Pegolo,0,0,0,0,0,0,0,,0,0,0,0,0,0,0
1894,Peter Pekarík,2,1,1,1,0,1,3,33.3,2,2,1,1,1,5,0
1895,Pelé,8,7,3,5,0,2,6,33.3,4,2,1,1,3,10,0
1896,Yohann Pelé,0,0,0,0,0,0,2,0.0,2,0,0,0,0,1,1
1897,Maxime Pélican,1,1,0,1,0,0,0,,0,1,0,1,0,0,0
1898,Pietro Pellegri,1,1,0,0,1,0,0,,0,0,0,0,0,0,0
1899,Lorenzo Pellegrini,39,23,16,18,5,10,30,33.3,20,20,2,18,12,21,0
1900,Luca Pellegrini,28,19,16,11,1,14,25,56.0,11,13,3,10,18,22,0
1901,Luca Pellegrini,1,1,1,0,0,1,2,50.0,1,2,1,1,3,2,0
1902,Théo Pellenard,11,6,7,2,2,5,8,62.5,3,6,2,4,5,16,0
1903,Sergio Pellissier,4,3,1,1,2,3,4,75.0,1,8,1,7,2,8,0
1904,Andy Pelmard,5,5,3,2,0,1,4,25.0,3,0,0,0,3,3,0
1905,Lee Peltier,39,25,27,11,1,15,27,55.6,12,18,12,6,18,60,0
1906,Federico Peluso,23,14,15,5,3,13,16,81.3,3,8,3,5,23,70,0
1907,Rubén Peña,63,46,24,27,12,24,53,45.3,29,37,9,28,35,57,0
1908,Nicolas Pépé,27,10,6,15,6,8,35,22.9,27,33,0,33,13,11,1
1909,Pepín,4,2,3,1,0,1,4,25.0,3,0,0,0,3,0,0
1910,Andreas Pereira,8,6,5,2,1,4,15,26.7,11,9,2,7,11,8,1
1911,Matheus Pereira,16,11,4,8,4,2,13,15.4,11,15,2,13,14,7,0
1912,Pedro Pereira,20,14,15,2,3,11,19,57.9,8,10,5,5,14,55,1
1913,Ricardo Pereira,118,66,66,40,12,54,112,48.2,58,60,6,54,60,130,1
1914,Roberto Pereyra,21,12,10,10,1,7,24,29.2,17,26,0,26,24,27,2
1915,Ayoze Pérez,59,22,24,28,7,17,63,27.0,46,55,4,51,42,33,1
1916,Carles Pérez,0,0,0,0,0,0,0,,0,1,0,1,0,0,0
1917,Hernán Pérez,13,10,8,3,2,6,27,22.2,21,14,3,11,5,13,0
1918,Lucas Pérez,6,4,3,2,1,1,3,33.3,2,2,1,1,2,2,0
1919,Rubén Pérez,71,42,27,40,4,32,80,40.0,48,35,8,27,40,34,1
1920,Stipe Perica,5,3,2,2,1,1,3,33.3,2,3,1,2,0,4,0
1921,Mattia Perin,0,0,0,0,0,0,0,,0,0,0,0,0,3,2
1922,Ivan Perišić,34,26,7,20,7,16,51,31.4,35,40,4,36,23,55,0
1923,Diego Perotti,14,12,5,5,4,6,19,31.6,13,4,0,4,4,2,0
1924,Loïc Perrin,53,36,34,17,2,20,33,60.6,13,37,24,13,44,118,2
1925,Pavao Pervan,0,0,0,0,0,0,0,,0,0,0,0,0,3,1
1926,Matteo Pessina,4,2,0,4,0,2,3,66.7,1,2,1,1,0,4,0
1927,Andrea Petagna,15,6,5,5,5,2,9,22.2,7,23,8,15,4,15,0
1928,Nils Petersen,29,21,10,16,3,4,24,16.7,20,28,2,26,13,34,0
1929,Ondřej Petrák,36,24,17,18,1,14,25,56.0,11,18,4,14,40,22,0
1930,Germán Pezzella,56,36,42,13,1,31,51,60.8,20,42,30,12,60,159,1
1931,Giuseppe Pezzella,5,4,4,1,0,2,8,25.0,6,2,1,1,1,9,0
1932,Giuseppe Pezzella,2,1,1,1,0,0,0,,0,1,0,1,1,4,0
1933,Matthias Phaeton,1,1,0,1,0,0,0,,0,0,0,0,0,0,0
1934,Maximilian Philipp,7,5,3,4,0,2,9,22.2,7,10,0,10,3,6,0
1935,Lebogang Phiri,60,38,16,41,3,24,43,55.8,19,26,3,23,29,19,0
1936,Krzysztof Piątek,9,4,2,5,2,1,15,6.7,14,18,3,15,3,19,0
1937,Krzysztof Piątek,8,6,2,1,5,3,10,30.0,7,7,2,5,1,15,0
1938,Pablo Piatti,21,15,8,10,3,8,16,50.0,8,15,0,15,2,8,0
1939,Lucas Piazon,2,0,1,1,0,0,2,0.0,2,1,0,1,1,0,0
1940,Cristiano Piccini,32,23,25,7,0,13,26,50.0,13,27,7,20,27,64,1
1941,Roberto Piccoli,2,2,0,1,1,1,1,100.0,0,1,0,1,0,0,0
1942,Jordan Pickford,0,0,0,0,0,0,0,,0,0,0,0,0,20,8
1943,Jérémy Pied,12,8,5,6,1,3,9,33.3,6,8,1,7,5,13,0
1944,Ronaël Pierre-Gabriel,13,8,10,2,1,9,10,90.0,1,3,1,2,3,18,0
1945,Erik Pieters,49,28,28,18,3,25,33,75.8,8,21,13,8,17,56,0
1946,Tomás Pina Isla,64,41,23,36,5,18,46,39.1,28,15,4,11,41,43,1
1947,Andrea Pinamonti,14,6,6,5,3,4,20,20.0,16,16,3,13,5,17,0
1948,Carlo Pinsoglio,0,0,0,0,0,0,0,,0,0,0,0,0,0,0
1949,Virgile Pinson,0,0,0,0,0,0,0,,0,0,0,0,0,0,0
1950,Lenny Pintor,0,0,0,0,0,0,0,,0,0,0,0,0,0,0
1951,Gerard Piqué,42,27,25,17,0,24,37,64.9,13,41,27,14,36,154,5
1952,Facundo Píriz,9,6,3,4,2,4,9,44.4,5,2,1,1,0,2,0
1953,Fabio Pisacane,33,17,22,8,3,18,31,58.1,13,36,23,13,23,108,0
1954,Łukasz Piszczek,57,36,34,15,8,18,33,54.5,15,26,3,23,39,69,0
1955,Claudio Pizarro,10,6,4,2,4,4,7,57.1,3,14,1,13,1,7,0
1956,Marko Pjaca,9,4,3,4,2,2,6,33.3,4,2,0,2,7,6,0
1957,Miralem Pjanić,41,20,15,18,8,16,59,27.1,43,34,6,28,36,19,2
1958,Carles Planas,12,6,7,5,0,4,11,36.4,7,2,0,2,4,15,0
1959,Óscar Plano,63,45,23,28,12,14,48,29.2,34,19,3,16,22,28,1
1960,Jaroslav Plašil,34,26,11,20,3,18,44,40.9,26,21,5,16,19,28,1
1961,Marvin Plattenhardt,27,21,12,10,5,14,21,66.7,7,18,3,15,7,56,0
1962,Stiven Plaza,0,0,0,0,0,0,0,,0,0,0,0,0,0,0
1963,Alassane Pléa,14,10,7,4,3,5,22,22.7,17,17,2,15,3,15,2
1964,Luca Plogmann,0,0,0,0,0,0,0,,0,0,0,0,0,0,0
1965,Morgan Poaty,1,1,1,0,0,0,0,,0,1,0,1,0,2,0
1966,Paul Pogba,47,30,21,21,5,17,43,39.5,26,30,9,21,18,39,0
1967,Denis-Will Poha,0,0,0,0,0,0,1,0.0,1,0,0,0,1,1,0
1968,Andrea Poli,65,47,30,28,7,24,67,35.8,43,36,5,31,35,13,2
1969,Matteo Politano,18,7,9,4,5,8,30,26.7,22,18,0,18,14,10,1
1970,Pierre-Yves Polomat,18,13,11,6,1,10,18,55.6,8,4,2,2,21,27,0
1971,Giacomo Poluzzi,0,0,0,0,0,0,0,,0,0,0,0,0,0,0
1972,Pere Pons,83,46,34,38,11,30,82,36.6,52,48,12,36,35,39,0
1973,Pedro Porro,51,31,28,16,7,32,80,40.0,48,36,2,34,39,60,1
1974,Manolo Portanova,1,1,0,1,0,0,1,0.0,1,2,0,2,1,2,0
1975,Francisco Portillo,26,16,6,15,5,9,29,31.0,20,14,0,14,17,9,0
1976,Portu,33,24,8,15,10,12,43,27.9,31,16,1,15,8,5,0
1977,Stefan Posch,45,32,28,15,2,17,28,60.7,11,26,11,15,21,58,0
1978,Sergio Postigo,25,15,22,3,0,15,19,78.9,4,21,12,9,20,77,0
1979,Yussuf Poulsen,20,10,5,10,5,3,25,12.0,22,33,2,31,7,28,0
1980,Maxime Poundjé,48,35,34,12,2,31,62,50.0,31,24,5,19,29,79,0
1981,Gaëtan Poussin,0,0,0,0,0,0,0,,0,0,0,0,0,0,0
1982,José Pozo,13,10,4,5,4,4,25,16.0,21,7,1,6,4,6,0
1983,Dennis Praet,62,44,30,25,7,27,51,52.9,24,33,4,29,36,31,0
1984,Sanjin Prcić,18,13,7,9,2,5,11,45.5,6,11,7,4,11,11,1
1985,Sanjin Prcić,19,14,11,7,1,8,18,44.4,10,22,8,14,18,7,1
1986,Nicolas de Préville,28,19,10,15,3,8,29,27.6,21,23,1,22,10,21,1
1987,Edgar Prib,10,9,3,5,2,2,4,50.0,2,4,0,4,2,1,0
1988,Alex Pritchard,36,24,10,18,8,10,35,28.6,25,26,2,24,17,9,0
1989,Sebastian Prödl,0,0,0,0,0,0,0,,0,0,0,0,0,0,0
1990,Quincy Promes,35,25,23,9,3,15,22,68.2,7,19,3,16,25,22,1
1991,Davy Pröpper,50,28,23,21,6,16,52,30.8,36,21,6,15,53,37,0
1992,Silvio Proto,0,0,0,0,0,0,1,0.0,1,0,0,0,0,1,0
1993,Ivan Provedel,0,0,0,0,0,0,1,0.0,1,0,0,0,0,4,0
1994,Javi Puado,2,1,0,2,0,0,7,0.0,7,5,1,4,6,4,0
1995,Manuel Pucciarelli,4,2,2,1,1,2,5,40.0,3,5,0,5,3,4,0
1996,Riqui Puig,3,3,0,2,1,2,3,66.7,1,0,0,0,0,1,0
1997,Erick Pulgar,65,36,35,23,7,22,73,30.1,51,35,5,30,50,54,1
1998,Jorge Pulido,63,42,40,19,4,32,51,62.7,19,39,18,21,50,158,0
1999,Christian Pulisic,10,6,2,6,2,2,6,33.3,4,12,2,10,6,10,0
2000,Jason Puncheon,1,1,1,0,0,0,0,,0,0,0,0,0,0,0
2001,Jason Puncheon,7,4,1,5,1,1,7,14.3,6,3,1,2,3,8,0
2002,Ignacio Pussetto,65,40,25,30,10,15,43,34.9,28,28,3,25,29,34,0
2003,Fabio Quagliarella,14,8,6,4,4,2,15,13.3,13,32,1,31,8,17,0
2004,Robin Quaison,19,12,3,10,6,5,12,41.7,7,9,1,8,7,4,0
2005,Collin Quaner,0,0,0,0,0,0,1,0.0,1,0,0,0,0,0,0
2006,Domingos Quina,9,7,3,5,1,3,11,27.3,8,6,0,6,3,1,0
2007,Xavi Quintillà,10,4,5,4,1,6,12,50.0,6,5,2,3,8,17,0
2008,Dani Raba,6,5,1,2,3,1,5,20.0,4,1,0,1,1,0,0
2009,Adrien Rabiot,35,20,13,17,5,9,12,75.0,3,9,2,7,10,20,0
2010,Nemanja Radonjić,8,5,1,5,2,5,16,31.3,11,3,0,3,5,4,0
2011,Ivan Radovanović,20,12,11,8,1,8,17,47.1,9,12,4,8,13,20,1
2012,Ivan Radovanović,27,22,20,7,0,11,31,35.5,20,19,7,12,26,36,0
2013,Ionuț Radu,0,0,0,0,0,0,1,0.0,1,0,0,0,1,11,4
2014,Ștefan Radu,43,27,24,15,4,25,38,65.8,13,20,14,6,42,85,1
2015,Rafael,31,19,14,12,5,17,24,70.8,7,19,2,17,15,30,2
2016,Raffael,8,4,2,4,2,2,7,28.6,5,5,0,5,1,0,0
2017,Rafinha,8,6,2,3,3,2,2,100.0,0,5,1,4,1,2,0
2018,Rafinha,15,7,6,6,3,6,14,42.9,8,8,3,5,19,11,0
2019,Andrea Raggi,7,5,7,0,0,6,6,100.0,0,1,0,1,7,21,0
2020,Baba Rahman,26,20,17,8,1,18,21,85.7,3,21,3,18,16,37,2
2021,Baba Rahman,3,1,1,1,1,1,1,100.0,0,3,0,3,2,2,0
2022,Ivan Rakitić,30,24,10,14,6,12,37,32.4,25,32,8,24,51,33,0
2023,Joe Ralls,45,23,21,21,3,10,33,30.3,23,21,6,15,29,30,0
2024,Jonás Ramalho,13,6,12,1,0,8,14,57.1,6,24,11,13,16,80,1
2025,Benito Raman,35,20,14,16,5,11,53,20.8,42,30,2,28,15,8,0
2026,Adil Rami,14,9,12,2,0,8,12,66.7,4,14,14,0,18,52,3
2027,Gastón Ramírez,38,22,12,18,8,11,31,35.5,20,28,4,24,8,27,0
2028,Sandro Ramírez,19,10,7,10,2,4,11,36.4,7,12,1,11,9,3,0
2029,Iván Ramis,23,13,10,11,2,17,23,73.9,6,10,5,5,18,65,2
2030,Chris Ramos,1,1,0,0,1,1,1,100.0,0,0,0,0,0,1,0
2031,Sergio Ramos,41,32,25,12,4,22,39,56.4,17,29,15,14,37,90,2
2032,Aaron Ramsey,34,18,11,15,8,7,25,28.0,18,7,1,6,9,3,0
2033,Kayne Ramsey,0,0,0,0,0,0,0,,0,0,0,0,0,7,0
2034,Andrea Ranocchia,2,2,1,1,0,0,1,0.0,1,1,0,1,0,3,0
2035,Marcus Rashford,24,12,4,12,8,7,29,24.1,22,27,0,27,3,24,0
2036,Milot Rashica,24,16,8,11,5,9,24,37.5,15,16,2,14,6,6,1
2037,Jacob Rasmussen,18,12,10,6,2,5,14,35.7,9,18,13,5,12,55,1
2038,Giacomo Raspadori,0,0,0,0,0,0,0,,0,0,0,0,0,0,0
2039,Yoric Ravet,2,1,1,0,1,1,2,50.0,1,2,1,1,0,1,0
2040,Tim Ream,23,14,16,7,0,14,28,50.0,14,19,10,9,25,80,2
2041,Ante Rebić,22,9,5,12,5,5,12,41.7,7,18,1,17,8,3,0
2042,Pedro Rebocho,61,35,31,22,8,29,54,53.7,25,48,13,35,40,92,1
2043,Arkadiusz Reca,2,0,1,0,1,0,1,0.0,1,0,0,0,3,0,0
2044,Recio,30,21,14,13,3,6,24,25.0,18,14,2,12,14,14,0
2045,Nathan Redmond,45,22,14,19,12,14,41,34.1,27,54,2,52,20,23,1
2046,Vasco Regini,1,0,0,1,0,1,3,33.3,2,2,1,1,0,4,0
2047,Sergio Reguilón,25,14,15,9,1,10,21,47.6,11,13,3,10,20,41,1
2048,Bobby Reid,16,9,6,7,3,3,8,37.5,5,13,0,13,3,12,0
2049,Pepe Reina,0,0,0,0,0,0,0,,0,0,0,0,0,1,0
2050,Jeff Reine-Adélaïde,40,22,18,19,3,16,39,41.0,23,20,0,20,19,10,0
2051,Karim Rekik,36,22,23,12,1,12,18,66.7,6,24,16,8,34,88,0
2052,Loïc Rémy,2,1,0,2,0,0,3,0.0,3,3,1,2,2,17,1
2053,Michael Rensing,2,1,2,0,0,1,5,20.0,4,1,0,1,2,13,2
2054,Marco Reus,33,22,11,16,6,6,31,19.4,25,28,1,27,8,32,0
2055,Elvis Rexhbeçaj,28,18,11,12,5,12,24,50.0,12,18,2,16,14,21,0
2056,Diego Reyes,7,4,4,3,0,3,4,75.0,1,4,4,0,7,17,1
2057,Baptiste Reynet,0,0,0,0,0,0,3,0.0,3,0,0,0,1,14,2
2058,Simon Rhein,7,4,7,0,0,2,7,28.6,5,6,1,5,7,6,0
2059,Franck Ribéry,15,7,7,6,2,4,10,40.0,6,9,0,9,7,1,0
2060,Declan Rice,98,60,35,58,5,38,88,43.2,50,51,12,39,52,56,0
2061,Jazz Richards,0,0,0,0,0,0,1,0.0,1,2,1,1,2,5,0
2062,Richarlison,49,34,19,20,10,8,24,33.3,16,30,2,28,16,39,0
2063,Marco Richter,13,8,4,5,4,7,20,35.0,13,16,1,15,13,9,1
2064,Diego Rico,14,9,8,2,4,4,12,33.3,8,13,2,11,14,20,0
2065,Mikel Rico,5,2,1,4,0,2,7,28.6,5,3,2,1,2,3,0
2066,Sergio Rico,1,1,1,0,0,1,1,100.0,0,0,0,0,1,13,5
2067,Asier Riesgo,1,1,1,0,0,1,3,33.3,2,0,0,0,0,8,1
2068,Sascha Riether,0,0,0,0,0,0,0,,0,0,0,0,0,0,0
2069,Emiliano Rigoni,6,1,2,2,2,2,6,33.3,4,3,0,3,3,3,0
2070,Luca Rigoni,42,25,25,15,2,9,26,34.6,17,19,2,17,18,39,0
2071,Nicola Rigoni,43,25,22,15,6,22,51,43.1,29,20,5,15,23,45,1
2072,Kévin Rimane,0,0,0,0,0,0,0,,0,0,0,0,0,0,0
2073,Tomás Rincón,75,44,25,41,9,31,68,45.6,37,35,5,30,42,71,1
2074,Renaud Ripart,76,49,41,22,13,32,76,42.1,44,43,7,36,27,79,0
2075,Mihailo Ristić,14,9,8,5,1,6,10,60.0,4,11,3,8,9,6,0
2076,Matt Ritchie,70,44,35,27,8,19,47,40.4,28,34,11,23,51,76,1
2077,Cristian Rivera,38,25,18,19,1,11,25,44.0,14,21,4,17,31,31,0
2078,Arjen Robben,3,1,0,3,0,0,1,0.0,1,6,1,5,3,0,0
2079,Rober,41,29,33,6,2,24,48,50.0,24,52,36,16,51,129,2
2080,Sergi Roberto,28,20,15,9,4,16,24,66.7,8,18,3,15,43,31,0
2081,Patrick Roberts,7,6,5,2,0,3,15,20.0,12,5,0,5,3,2,1
2082,Andrew Robertson,80,49,41,31,8,39,70,55.7,31,33,6,27,29,57,3
2083,Joel Robles,1,0,1,0,0,1,1,100.0,0,0,0,0,0,5,1
2084,Marc Roca,71,45,36,26,9,28,70,40.0,42,43,21,22,36,60,3
2085,Christopher Rocchia,0,0,0,0,0,0,0,,0,0,0,0,0,1,0
2086,Kenny Rocha Santos,0,0,0,0,0,0,0,,0,0,0,0,0,0,0
2087,Rubén Rochina,51,33,26,16,9,23,81,28.4,58,29,0,29,21,19,1
2088,Sebastian Rode,31,19,17,9,5,16,35,45.7,19,17,0,17,19,14,0
2089,Ronny Rodelin,13,5,2,7,4,3,8,37.5,5,8,1,7,8,13,0
2090,Rodri,103,70,45,50,8,39,75,52.0,36,35,11,24,41,68,0
2091,Rodrigo,21,10,6,9,6,3,17,17.6,14,17,1,16,3,18,0
2092,Kévin Rodrigues,21,11,14,6,1,9,17,52.9,8,13,3,10,8,15,0
2093,Alejandro Rodríguez,0,0,0,0,0,0,0,,0,0,0,0,0,1,0
2094,Ángel Rodríguez,16,7,1,6,9,6,26,23.1,20,15,1,14,8,8,0
2095,Óscar Rodríguez Arnaiz,46,25,26,15,5,16,58,27.6,42,12,2,10,16,16,0
2096,James Rodríguez,12,8,3,4,5,5,19,26.3,14,9,0,9,4,1,0
2097,Ricardo Rodríguez,57,32,34,21,2,32,39,82.1,7,25,5,20,38,98,0
2098,Marko Rog,12,9,3,7,2,5,11,45.5,6,8,2,6,5,1,0
2099,Marko Rog,12,11,4,8,0,5,9,55.6,4,4,0,4,8,1,0
2100,Rogério,55,38,35,13,7,30,55,54.5,25,32,7,25,37,109,1
2101,Marcos Rojo,5,3,3,2,0,1,6,16.7,5,3,2,1,6,9,1
2102,Diego Rolán,6,4,3,3,0,2,9,22.2,7,2,0,2,3,3,0
2103,Diego Rolán,7,4,3,1,3,0,2,0.0,2,1,0,1,1,4,0
2104,Rolando,18,7,15,3,0,8,10,80.0,2,8,6,2,11,25,0
2105,Esteban Rolón,46,29,14,20,12,20,44,45.5,24,18,2,16,16,12,0
2106,Filippo Romagna,14,9,10,4,0,4,8,50.0,4,20,12,8,19,68,0
2107,Alessio Romagnoli,34,19,26,6,2,16,19,84.2,3,48,32,16,37,173,1
2108,Alaixys Romao,118,71,61,50,7,43,102,42.2,59,44,16,28,58,65,1
2109,Cristian Romero,61,35,38,18,5,27,40,67.5,13,49,27,22,37,128,1
2110,Oriol Romeu,81,46,39,38,4,32,77,41.6,45,43,17,26,52,44,1
2111,Rômulo,26,18,9,10,7,7,17,41.2,10,16,3,13,18,20,0
2112,Rômulo,10,5,8,2,0,5,7,71.4,2,10,2,8,5,13,0
2113,Cristiano Ronaldo,10,7,5,4,1,1,11,9.1,10,7,2,5,6,32,0
2114,Facundo Roncaglia,13,10,8,5,0,4,6,66.7,2,4,2,2,10,22,0
2115,Facundo Roncaglia,34,22,26,8,0,17,24,70.8,7,12,5,7,20,51,2
2116,Salomón Rondón,8,3,2,4,2,4,24,16.7,20,14,3,11,5,39,0
2117,Valentin Rongier,86,54,24,46,16,26,65,40.0,39,46,6,40,33,19,0
2118,Marten de Roon,102,57,32,61,9,34,94,36.2,60,48,9,39,53,49,1
2119,Roberto Rosales,48,31,22,16,10,21,44,47.7,23,19,7,12,22,68,0
2120,Danny Rose,49,31,26,16,7,20,32,62.5,12,24,4,20,24,28,3
2121,Valentin Rosier,44,25,22,19,3,16,31,51.6,15,25,4,21,32,45,1
2122,Luca Rossettini,26,17,18,8,0,15,20,75.0,5,23,15,8,35,114,0
2123,Francesco Rossi,0,0,0,0,0,0,0,,0,0,0,0,0,0,0
2124,Jérôme Roussillon,42,29,25,15,2,20,30,66.7,10,50,7,43,31,54,0
2125,Nolan Roux,11,9,0,6,5,4,14,28.6,10,6,2,4,4,21,0
2126,Aaron Rowe,1,0,1,0,0,0,0,,0,0,0,0,1,1,0
2127,Waldo Rubio,4,2,3,1,0,1,6,16.7,5,2,0,2,1,8,1
2128,John Ruddy,0,0,0,0,0,0,0,,0,0,0,0,0,0,0
2129,Antonio Rüdiger,34,16,27,6,1,15,27,55.6,12,15,8,7,32,96,1
2130,Sebastian Rudy,44,24,11,27,6,11,41,26.8,30,23,2,21,15,15,0
2131,Stéphane Ruffier,2,2,2,0,0,2,4,50.0,2,0,0,0,0,18,3
2132,Daniele Rugani,8,5,5,3,0,2,5,40.0,3,19,14,5,16,51,1
2133,Mário Rui,24,18,9,12,3,14,25,56.0,11,15,3,12,21,38,0
2134,Abel Ruiz,1,1,1,0,0,1,1,100.0,0,0,0,0,0,0,0
2135,Fabián Ruiz Peña,54,33,22,25,7,20,46,43.5,26,23,4,19,21,29,2
2136,Víctor Ruiz,28,19,20,6,2,13,18,72.2,5,28,16,12,38,67,1
2137,Gerónimo Rulli,2,1,2,0,0,1,3,33.3,2,1,0,1,1,12,6
2138,Lukas Rupp,1,1,0,0,1,0,0,,0,0,0,0,0,0,0
2139,Marco Russ,7,2,5,2,0,4,6,66.7,2,2,2,0,7,8,0
2140,Mathew Ryan,1,0,1,0,0,1,2,50.0,1,0,0,0,0,13,1
2141,Frederik Rønnow,0,0,0,0,0,0,0,,0,0,0,0,0,1,0
2142,Idriss Saadi,0,0,0,0,0,0,0,,0,0,0,0,0,0,0
2143,Youssouf Sabaly,46,32,32,12,2,25,46,54.3,21,19,2,17,26,42,0
2144,Abdelhamid Sabiri,2,1,1,1,0,0,0,,0,1,0,1,1,0,0
2145,Marcel Sabitzer,45,28,17,21,7,18,46,39.1,28,21,2,19,33,31,0
2146,Ihsan Sacko,7,2,2,5,0,2,5,40.0,3,5,0,5,2,2,0
2147,Nuri Şahin,60,33,22,33,5,23,59,39.0,36,30,3,27,37,39,1
2148,Samuel Şahin-Radlinger,0,0,0,0,0,0,0,,0,1,0,1,0,2,0
2149,Wesley Saïd,25,18,6,11,8,5,20,25.0,15,9,0,9,9,9,0
2150,Allan Saint-Maximin,12,6,1,7,4,2,14,14.3,12,11,0,11,4,3,0
2151,Théo Sainte-Luce,0,0,0,0,0,0,0,,0,0,0,0,0,0,0
2152,Romain Saïss,39,26,23,14,2,20,37,54.1,17,25,12,13,26,61,0
2153,Samuel Sáiz,4,3,0,3,1,2,5,40.0,3,1,0,1,0,2,0
2154,Bukayo Saka,0,0,0,0,0,0,0,,0,0,0,0,0,0,0
2155,Hiroki Sakai,59,41,30,23,6,29,54,53.7,25,25,10,15,37,77,0
2156,Diafra Sakho,2,1,0,0,2,0,0,,0,0,0,0,0,0,0
2157,Mamadou Sakho,25,16,22,3,0,11,18,61.1,7,26,16,10,41,136,2
2158,Bakary Sako,2,1,2,0,0,1,1,100.0,0,0,0,0,0,0,0
2159,Emiliano Sala,7,5,0,2,5,1,8,12.5,7,8,1,7,2,20,0
2160,Jacopo Sala,38,23,20,14,4,23,41,56.1,18,11,3,8,20,47,2
2161,Mohamed Salah,21,9,3,11,7,5,16,31.3,11,9,0,9,5,6,0
2162,Bartosz Salamon,17,10,12,5,0,6,14,42.9,8,27,19,8,27,143,1
2163,Carlos Salcedo,7,3,4,3,0,4,7,57.1,3,7,3,4,9,22,0
2164,William Saliba,32,20,28,4,0,16,24,66.7,8,11,10,1,28,44,2
2165,Yannis Salibur,9,5,1,7,1,1,7,14.3,6,6,0,6,8,4,0
2166,Yannis Salibur,0,0,0,0,0,0,0,,0,0,0,0,0,0,0
2167,Roland Sallai,12,7,5,5,2,5,13,38.5,8,3,0,3,3,8,0
2168,Edgar Salli,2,1,1,1,0,0,1,0.0,1,0,0,0,1,1,0
2169,Brice Samba,1,0,1,0,0,0,1,0.0,1,0,0,0,1,12,4
2170,Junior Sambia,15,7,7,7,1,6,15,40.0,9,14,2,12,5,3,0
2171,Paolo Sammarco,16,7,7,6,3,6,9,66.7,3,5,0,5,3,1,2
2172,Frédéric Sammaritano,11,5,5,5,1,5,13,38.5,8,8,1,7,8,2,1
2173,Mikel San José,43,25,19,19,5,15,48,31.3,33,27,6,21,21,35,0
2174,Antonio Sanabria,6,3,1,1,4,0,1,0.0,1,8,0,8,4,3,0
2175,Antonio Sanabria,8,6,0,5,3,1,6,16.7,5,8,2,6,3,4,0
2176,Renato Sanches,5,5,2,1,2,3,10,30.0,7,7,0,7,4,2,0
2177,Alexis Sánchez,17,10,5,9,3,5,13,38.5,8,7,0,7,9,2,0
2178,Carlos Sánchez,4,3,4,0,0,3,8,37.5,5,1,0,1,1,5,2
2179,Davinson Sánchez,37,20,28,9,0,20,37,54.1,17,17,9,8,30,103,2
2180,Javi Sánchez,1,0,1,0,0,0,0,,0,0,0,0,0,4,0
2181,Víctor Sánchez,45,30,21,17,7,14,67,20.9,53,17,2,15,25,25,0
2182,Jadon Sancho,19,10,7,6,6,10,31,32.3,21,21,1,20,14,12,1
2183,Sandro,18,10,10,8,0,7,13,53.8,6,14,5,9,11,16,0
2184,Sandro,27,17,12,11,4,9,17,52.9,8,9,4,5,20,25,0
2185,Alex Sandro,68,45,28,33,7,21,36,58.3,15,32,8,24,38,71,0
2186,Leroy Sané,24,15,8,7,9,2,23,8.7,21,21,2,19,8,2,0
2187,Salif Sané,54,37,34,19,1,27,46,58.7,19,44,29,15,68,146,3
2188,Luca Sangalli,19,13,6,11,2,5,22,22.7,17,9,1,8,5,5,0
2189,Ibrahim Sangaré,102,66,50,44,8,32,63,50.8,31,52,20,32,29,49,2
2190,Younousse Sankharé,25,12,2,19,4,6,19,31.6,13,14,0,14,9,4,0
2191,Baissama Sankoh,4,1,4,0,0,1,4,25.0,3,8,1,7,5,16,0
2192,Yaya Sanogo,4,2,0,2,2,2,4,50.0,2,3,0,3,3,15,0
2193,Morgan Sanson,70,47,27,35,8,21,77,27.3,56,40,1,39,42,8,1
2194,Nicola Sansone,29,17,9,14,6,9,27,33.3,18,13,1,12,9,4,0
2195,Nicola Sansone,0,0,0,0,0,0,0,,0,0,0,0,0,0,0
2196,Baptiste Santamaria,118,60,48,63,7,51,106,48.1,55,41,4,37,57,57,2
2197,Roberto Santamaría,0,0,0,0,0,0,0,,0,0,0,0,1,12,1
2198,Federico Santander,18,10,6,8,4,2,23,8.7,21,20,2,18,9,30,0
2199,Davide Santon,14,6,8,6,0,8,12,66.7,4,11,7,4,15,27,0
2200,Michael Santos,12,5,1,7,4,2,7,28.6,5,7,1,6,1,1,0
2201,Samir Santos,47,33,27,18,2,19,25,76.0,6,18,9,9,34,96,0
2202,Riccardo Saponara,12,6,2,6,4,3,12,25.0,9,5,1,4,4,10,0
2203,Pablo Sarabia,30,15,6,15,9,6,47,12.8,41,30,3,27,22,20,0
2204,Marcelo Saracchi,17,11,12,4,1,8,13,61.5,5,12,1,11,11,14,0
2205,Josh Sargent,2,1,1,0,1,2,2,100.0,0,2,0,2,0,3,0
2206,Bouna Sarr,67,48,27,27,13,26,42,61.9,16,28,3,25,39,56,1
2207,Ismaila Sarr,35,24,16,15,4,17,34,50.0,17,17,2,15,14,4,0
2208,Malang Sarr,59,36,38,17,4,31,57,54.4,26,29,12,17,68,107,2
2209,Lluís Sastre,5,3,0,5,0,0,1,0.0,1,0,0,0,1,0,0
2210,Marco Sau,0,0,0,0,0,0,0,,0,1,0,1,0,0,0
2211,Marco Sau,4,2,0,2,2,0,3,0.0,3,5,0,5,1,4,0
2212,Téji Savanier,95,58,35,52,8,43,116,37.1,73,32,15,17,64,53,2
2213,Stefan Savić,11,10,9,2,0,7,12,58.3,5,13,9,4,22,67,0
2214,Fabian Schär,60,39,37,19,4,24,50,48.0,26,40,16,24,67,145,2
2215,Ezequiel Schelotto,3,0,3,0,0,2,3,66.7,1,1,0,1,2,8,0
2216,Nicolás Schiappacasse,0,0,0,0,0,0,0,,0,2,0,2,0,0,0
2217,Pasquale Schiattarella,43,27,18,21,4,13,38,34.2,25,17,5,12,22,25,1
2218,Patrik Schick,11,5,3,5,3,1,19,5.3,18,19,2,17,3,15,1
2219,Julian Schieber,3,2,1,2,0,0,1,0.0,1,1,0,1,1,3,0
2220,Christopher Schindler,61,36,46,14,1,27,47,57.4,20,69,34,35,70,138,4
2221,Keven Schlotterbeck,22,16,19,2,1,8,12,66.7,4,17,11,6,13,26,0
2222,Nico Schlotterbeck,6,6,6,0,0,2,2,100.0,0,3,1,2,5,10,0
2223,Jeffrey Schlupp,41,20,18,18,5,10,27,37.0,17,30,8,22,19,27,1
2224,Kasper Schmeichel,1,1,1,0,0,1,1,100.0,0,0,0,0,3,14,3
2225,Marcel Schmelzer,10,5,7,2,1,5,9,55.6,4,7,1,6,9,14,0
2226,Jonathan Schmid,44,22,23,19,2,16,28,57.1,12,22,8,14,43,70,2
2227,Morgan Schneiderlin,24,16,11,11,2,6,14,42.9,8,16,3,13,15,16,0
2228,Alessandro Schöpf,26,16,12,13,1,12,29,41.4,17,14,0,14,9,12,0
2229,Nico Schulz,34,20,19,12,3,15,36,41.7,21,32,4,28,24,36,0
2230,André Schürrle,30,19,14,10,6,12,42,28.6,30,16,1,15,8,17,1
2231,Pirmin Schwegler,63,34,30,29,4,34,60,56.7,26,21,5,16,41,54,0
2232,Alexander Schwolow,0,0,0,0,0,0,1,0.0,1,0,0,0,0,13,2
2233,Matteo Scozzarella,18,13,9,8,1,9,33,27.3,24,22,10,12,23,33,0
2234,Simone Scuffet,0,0,0,0,0,0,1,0.0,1,0,0,0,0,4,2
2235,Andrea Seculin,0,0,0,0,0,0,0,,0,0,0,0,0,1,0
2236,Stanley Segarel,0,0,0,0,0,0,0,,0,0,0,0,0,0,0
2237,Davie Selke,5,2,1,4,0,2,9,22.2,7,11,0,11,1,7,0
2238,Ole Selnæs,44,26,12,23,9,13,35,37.1,22,24,7,17,19,29,0
2239,Matz Sels,0,0,0,0,0,0,1,0.0,1,0,0,0,1,24,1
2240,Ken Sema,15,7,7,5,3,9,21,42.9,12,7,0,7,8,5,0
2241,Alfa Semedo,0,0,0,0,0,0,3,0.0,3,1,1,0,2,0,0
2242,Nélson Semedo,38,27,23,12,3,12,18,66.7,6,23,7,16,22,26,0
2243,Rúben Semedo,20,16,14,6,0,12,16,75.0,4,15,9,6,16,35,2
2244,Adrian Šemper,0,0,0,0,0,0,0,,0,0,0,0,1,3,0
2245,Stefano Sensi,36,20,15,18,3,6,30,20.0,24,36,7,29,33,17,0
2246,Luigi Sepe,1,1,1,0,0,1,2,50.0,1,0,0,0,3,21,3
2247,Suat Serdar,51,32,20,26,5,14,49,28.6,35,37,6,31,23,5,1
2248,Jean Seri,41,28,20,20,1,13,45,28.9,32,40,9,31,32,17,4
2249,Leonardo Sernicola,0,0,0,0,0,0,0,,0,0,0,0,0,0,0
2250,Julien Serrano,5,4,3,2,0,3,6,50.0,3,1,0,1,3,3,0
2251,Grégory Sertic,2,0,1,1,0,0,1,0.0,1,2,1,1,1,2,0
2252,Ryan Sessegnon,22,14,8,8,6,6,22,27.3,16,25,2,23,19,49,1
2253,Paik Seung-ho,0,0,0,0,0,0,1,0.0,1,1,0,1,3,1,0
2254,Stephan El Shaarawy,27,14,14,8,5,9,24,37.5,15,11,2,9,20,9,0
2255,Meritan Shabani,0,0,0,0,0,0,0,,0,0,0,0,0,0,0
2256,Xherdan Shaqiri,14,4,3,9,2,9,19,47.4,10,6,1,5,6,6,0
2257,Luke Shaw,55,29,17,31,7,28,47,59.6,19,42,12,30,21,93,2
2258,Jonjo Shelvey,22,12,10,9,3,8,17,47.1,9,10,3,7,7,15,0
2259,Gaku Shibasaki,7,3,2,4,1,3,6,50.0,3,2,0,2,3,4,0
2260,Gen Shoji,24,13,16,8,0,11,24,45.8,13,22,14,8,21,56,0
2261,Djibril Sidibé,50,34,27,12,11,26,48,54.2,22,25,9,16,30,51,0
2262,Kalidou Sidibé,24,12,11,12,1,7,15,46.7,8,16,3,13,17,26,1
2263,Sidnei,48,29,33,12,3,18,34,52.9,16,21,8,13,41,57,0
2264,Francisco Sierralta,11,8,8,3,0,4,6,66.7,2,1,1,0,4,27,0
2265,Gylfi Sigurðsson,56,36,20,25,11,16,47,34.0,31,38,4,34,28,24,0
2266,Luca Siligardi,30,20,10,13,7,8,23,34.8,15,19,3,16,15,11,0
2267,Adrien Silva,2,2,0,1,1,0,2,0.0,2,1,0,1,1,1,0
2268,Adrien Silva,50,31,19,26,5,30,62,48.4,32,15,2,13,16,23,0
2269,André Silva,8,5,1,4,3,1,11,9.1,10,17,1,16,3,32,0
2270,Bernardo Silva,52,39,18,21,13,16,67,23.9,51,47,3,44,25,26,1
2271,David Silva,30,18,12,11,7,1,20,5.0,19,18,1,17,22,15,0
2272,Gabriel Silva,19,10,13,6,0,6,17,35.3,11,15,3,12,14,60,1
2273,Jonathan Silva,51,38,30,17,4,23,52,44.2,29,23,2,21,29,86,0
2274,Matheus Pereira da Silva,3,2,0,2,1,2,4,50.0,2,1,0,1,0,1,0
2275,Thiago Silva,16,13,7,8,1,6,11,54.5,5,28,20,8,32,99,1
2276,Xande Silva,0,0,0,0,0,0,0,,0,1,0,1,0,0,0
2277,Matías Silvestre,31,17,22,5,4,17,26,65.4,9,29,24,5,21,165,0
2278,Giovanni Simeone,43,27,10,23,10,7,29,24.1,22,26,2,24,4,14,0
2279,Lorenco Šimić,6,3,5,1,0,2,4,50.0,2,2,1,1,12,19,1
2280,Moses Simon,14,8,10,2,2,5,9,55.6,4,10,1,9,12,14,0
2281,Unai Simón,0,0,0,0,0,0,1,0.0,1,0,0,0,1,1,1
2282,Danny Simpson,11,3,8,3,0,3,5,60.0,2,7,3,4,6,20,0
2283,Jack Simpson,9,5,8,1,0,6,9,66.7,3,5,4,1,9,25,2
2284,Josh Sims,1,0,1,0,0,1,3,33.3,2,2,0,2,1,1,0
2285,Giovanni Sio,0,0,0,0,0,0,0,,0,0,0,0,0,0,0
2286,Dimitris Siovas,57,32,38,18,1,27,47,57.4,20,32,15,17,65,155,1
2287,Salvatore Sirigu,0,0,0,0,0,0,2,0.0,2,0,0,0,2,21,1
2288,Ibrahima Sissoko,60,41,23,34,3,23,55,41.8,32,37,3,34,34,39,1
2289,Moussa Sissoko,36,25,18,14,4,15,29,51.7,14,31,4,27,16,25,2
2290,Pione Sisto,4,3,4,0,0,0,9,0.0,9,5,0,5,3,3,0
2291,Antonio Sivera,0,0,0,0,0,0,0,,0,0,0,0,0,4,1
2292,Ellyes Skhiri,105,58,31,64,10,43,91,47.3,48,60,7,53,60,41,0
2293,Oliver Skipp,7,3,4,3,0,4,6,66.7,2,2,1,1,1,7,0
2294,Łukasz Skorupski,0,0,0,0,0,0,0,,0,0,0,0,3,12,4
2295,Milan Škriniar,64,37,46,17,1,38,60,63.3,22,48,29,19,27,138,0
2296,Steven Skrzybski,9,3,0,6,3,3,11,27.3,8,8,1,7,3,2,0
2297,Petar Škuletić,9,5,4,2,3,1,15,6.7,14,7,1,6,3,14,1
2298,Callum Slattery,4,3,0,4,0,3,7,42.9,4,1,1,0,2,1,0
2299,Naïm Sliti,56,33,24,19,13,15,46,32.6,31,18,0,18,11,9,0
2300,Chris Smalling,30,17,21,9,0,11,17,64.7,6,37,25,12,26,109,1
2301,Adam Smith,46,32,26,14,6,19,41,46.3,22,26,7,19,31,68,1
2302,Emile Smith Rowe,1,0,0,1,0,1,1,100.0,0,0,0,0,1,0,0
2303,Tommy Smith,26,13,14,11,1,10,25,40.0,15,12,4,8,18,25,0
2304,Robert Snodgrass,44,27,18,24,2,13,46,28.3,33,24,4,20,11,23,0
2305,Cédric Soares,22,16,15,6,1,9,15,60.0,6,21,5,16,22,60,2
2306,Cédric Soares,8,6,2,4,2,4,7,57.1,3,4,1,3,2,3,0
2307,Ramadan Sobhi,1,1,0,1,0,0,0,,0,2,0,2,1,0,0
2308,Marcel Sobottka,30,20,12,18,0,10,19,52.6,9,13,5,8,24,17,0
2309,Rubén Sobrino,16,11,7,6,3,5,13,38.5,8,16,1,15,2,13,0
2310,Rubén Sobrino,6,3,1,4,1,1,1,100.0,0,1,1,0,1,1,0
2311,Danilo Soddimo,11,9,3,6,2,3,6,50.0,3,2,1,1,7,3,0
2312,Alex Sola,4,3,0,3,1,3,4,75.0,1,0,0,0,1,2,0
2313,Dominic Solanke,8,3,1,4,3,1,8,12.5,7,4,1,3,2,9,0
2314,Andrés Solano,4,3,2,2,0,2,2,100.0,0,1,0,1,0,1,0
2315,Carlos Soler,41,28,15,23,3,16,65,24.6,49,46,6,40,19,37,0
2316,Oumar Solet,1,0,1,0,0,1,1,100.0,0,1,0,1,0,0,0
2317,Yann Sommer,2,2,2,0,0,2,2,100.0,0,1,0,1,1,12,5
2318,Kévin Soni,3,2,0,2,1,2,4,50.0,2,3,0,3,1,0,0
2319,Jérémy Sorbon,33,20,23,10,0,14,22,63.6,8,33,23,10,34,105,2
2320,Oliver Sorg,42,28,26,16,0,20,43,46.5,23,16,9,7,46,47,0
2321,David Soria,1,0,1,0,0,1,2,50.0,1,2,0,2,1,15,6
2322,Juan Soriano,0,0,0,0,0,0,0,,0,0,0,0,1,1,0
2323,Roberto Soriano,9,5,0,5,4,1,8,12.5,7,9,0,9,6,1,0
2324,Roberto Soriano,27,18,14,10,3,8,24,33.3,16,21,2,19,3,11,0
2325,Stefano Sorrentino,1,1,1,0,0,1,2,50.0,1,0,0,0,3,10,1
2326,Borna Sosa,13,7,8,4,1,4,9,44.4,5,5,1,4,6,34,0
2327,Sebastian Soto,0,0,0,0,0,0,0,,0,0,0,0,0,0,0
2328,Riccardo Sottil,1,1,0,1,0,1,1,100.0,0,0,0,0,0,0,0
2329,Pape Souaré,0,0,0,0,0,0,0,,0,0,0,0,1,0,0
2330,Adama Soumaoro,14,11,12,2,0,4,6,66.7,2,21,18,3,21,92,1
2331,Boubakary Soumaré,20,15,9,11,0,10,18,55.6,8,9,3,6,7,5,0
2332,Çağlar Söyüncü,5,2,4,1,0,3,6,50.0,3,8,5,3,7,22,3
2333,Julián Speroni,0,0,0,0,0,0,0,,0,0,0,0,0,1,2
2334,Leonardo Spinazzola,9,4,4,2,3,4,8,50.0,4,5,0,5,3,7,0
2335,Nicolás Spolli,7,6,3,4,0,0,2,0.0,2,8,6,2,7,39,1
2336,Marco Sportiello,1,0,1,0,0,1,1,100.0,0,1,0,1,0,8,2
2337,Mattia Sprocati,10,4,5,5,0,5,11,45.5,6,6,0,6,7,6,0
2338,Bassem Srarfi,20,11,8,8,4,6,17,35.3,11,8,0,8,5,5,0
2339,Darijo Srna,24,16,6,13,5,9,14,64.3,5,24,5,19,18,66,0
2340,Kostas Stafylidis,22,14,17,4,1,10,19,52.6,9,13,2,11,15,31,0
2341,Benjamin Stambouli,51,31,24,24,3,25,46,54.3,21,41,9,32,32,65,2
2342,Jozo Stanić,0,0,0,0,0,0,0,,0,0,0,0,0,0,0
2343,Junior Stanislas,12,6,5,4,3,3,7,42.9,4,8,1,7,2,15,0
2344,Niklas Stark,34,19,23,11,0,9,24,37.5,15,45,26,19,37,141,1
2345,Timo Stavitski,0,0,0,0,0,0,1,0.0,1,0,0,0,0,0,0
2346,Renato Steffen,26,17,5,17,4,7,17,41.2,10,13,2,11,16,14,0
2347,Marc Stendera,6,1,2,4,0,2,4,50.0,2,4,1,3,0,0,0
2348,Pascal Stenzel,42,26,26,14,2,24,43,55.8,19,16,3,13,30,48,1
2349,Dale Stephens,83,57,37,41,5,28,74,37.8,46,33,13,20,46,47,0
2350,Jack Stephens,25,13,17,7,1,16,28,57.1,12,25,13,12,37,96,2
2351,Mariusz Stępiński,18,13,1,11,6,1,17,5.9,16,10,2,8,5,20,0
2352,Raheem Sterling,32,16,11,12,9,9,25,36.0,16,28,3,25,17,4,0
2353,Lars Stindl,21,14,8,11,2,3,15,20.0,12,22,2,20,14,13,0
2354,Kevin Stöger,63,35,28,27,8,30,67,44.8,37,32,5,27,31,19,1
2355,John Stones,16,11,9,5,2,4,9,44.4,5,15,9,6,14,64,1
2356,Thomas Strakosha,1,1,1,0,0,1,1,100.0,0,0,0,0,1,8,1
2357,Tobias Strobl,31,17,17,13,1,9,29,31.0,20,36,14,22,29,35,1
2358,Kevin Strootman,2,2,1,0,1,0,1,0.0,1,5,0,5,2,2,0
2359,Kevin Strootman,76,40,21,47,8,20,52,38.5,32,24,6,18,24,26,0
2360,Jens Stryger Larsen,42,20,24,14,4,22,44,50.0,22,27,8,19,26,98,1
2361,Cristhian Stuani,23,13,7,13,3,5,20,25.0,15,13,1,12,4,39,0
2362,Leo Štulac,21,13,10,10,1,4,17,23.5,13,29,13,16,34,31,1
2363,Stefano Sturaro,4,3,0,3,1,2,9,22.2,7,3,1,2,3,2,0
2364,Daniel Sturridge,3,3,1,1,1,2,3,66.7,1,4,0,4,1,0,0
2365,Damián Suárez,96,62,43,41,12,53,120,44.2,67,47,6,41,46,57,2
2366,Denis Suárez,1,1,0,1,0,0,5,0.0,5,0,0,0,1,0,0
2367,Denis Suárez,0,0,0,0,0,0,0,,0,1,0,1,0,0,0
2368,Leonardo Suárez,3,3,2,0,1,2,4,50.0,2,7,1,6,1,4,0
2369,Luis Suárez,18,11,1,6,11,4,10,40.0,6,12,4,8,8,24,0
2370,Mario Suárez,37,23,17,17,3,15,28,53.6,13,10,3,7,14,17,2
2371,Mathías Suárez,20,11,7,10,3,10,23,43.5,13,11,0,11,9,18,0
2372,Danijel Subašić,0,0,0,0,0,0,1,0.0,1,0,0,0,0,6,2
2373,Neven Subotić,44,23,36,7,1,20,39,51.3,19,14,6,8,38,107,3
2374,Isaac Success,15,12,4,8,3,2,5,40.0,3,6,0,6,2,11,0
2375,Niklas Süle,28,23,17,10,1,18,25,72.0,7,23,13,10,40,83,0
2376,Ki Sung-yueng,14,10,5,8,1,3,12,25.0,9,11,1,10,19,20,0
2377,Andrew Surman,11,6,6,5,0,3,13,23.1,10,20,7,13,10,34,1
2378,Sam Surridge,1,0,0,0,1,0,0,,0,0,0,0,0,0,0
2379,Markel Susaeta,17,10,4,6,7,3,23,13.0,20,10,1,9,12,5,0
2380,Suso,28,18,10,14,4,10,41,24.4,31,26,1,25,16,3,0
2381,Markus Suttner,10,7,5,4,1,4,8,50.0,4,8,3,5,8,10,0
2382,Mattias Svanberg,22,11,14,7,1,11,25,44.0,14,25,6,19,11,16,2
2383,Sanasi Sy,0,0,0,0,0,0,0,,0,0,0,0,0,0,0
2384,Seydou Sy,0,0,0,0,0,0,0,,0,0,0,0,0,0,1
2385,Issiaga Sylla,54,36,30,24,0,28,53,52.8,25,36,10,26,39,77,0
2386,Moussa Sylla,6,4,4,1,1,2,6,33.3,4,5,2,3,2,5,0
2387,Eddy Sylvestre,3,2,0,3,0,3,9,33.3,6,1,0,1,0,0,0
2388,Ádám Szalai,19,13,3,12,4,4,11,36.4,7,8,1,7,4,8,0
2389,Wojciech Szczęsny,2,1,2,0,0,1,1,100.0,0,0,0,0,1,8,2
2390,Alexander Sørloth,2,1,0,0,2,1,2,50.0,1,0,0,0,0,3,0
2391,Franck Tabanou,4,3,4,0,0,1,2,50.0,1,0,0,0,6,15,0
2392,Jonathan Tah,44,30,30,10,4,17,32,53.1,15,39,26,13,45,142,1
2393,Flavien Tait,58,35,33,16,9,23,59,39.0,36,29,2,27,28,15,0
2394,Adrien Tameze,74,44,32,31,11,39,92,42.4,53,53,12,41,56,59,1
2395,Strahinja Tanasijević,0,0,0,0,0,0,0,,0,0,0,0,0,0,0
2396,Matt Targett,27,19,15,7,5,12,26,46.2,14,19,3,16,27,42,0
2397,Rodrigo Tarín,22,14,15,5,2,7,10,70.0,3,11,5,6,31,79,0
2398,James Tarkowski,71,36,52,18,1,29,50,58.0,21,72,56,16,42,240,2
2399,Ciprian Tătărușanu,0,0,0,0,0,0,0,,0,0,0,0,2,20,0
2400,Júlio Tavares,15,9,1,7,7,3,9,33.3,6,17,3,14,13,51,0
2401,Júnior Tavares,2,1,1,1,0,2,4,50.0,2,0,0,0,2,1,0
2402,Taleb Tawatha,1,1,1,0,0,1,2,50.0,1,0,0,0,0,1,0
2403,Charlie Taylor,55,26,37,15,3,24,50,48.0,26,74,35,39,40,120,0
2404,Malik Tchokounté,21,13,6,12,3,5,10,50.0,5,11,0,11,6,26,0
2405,Aurélien Tchouaméni,24,12,10,14,0,7,18,38.9,11,11,5,6,21,14,0
2406,Georg Teigl,5,3,4,0,1,2,2,100.0,0,1,0,1,7,5,1
2407,Cristian Tello,32,20,18,9,5,17,35,48.6,18,19,0,19,16,17,1
2408,Łukasz Teodorczyk,4,2,2,2,0,2,8,25.0,6,8,2,6,1,4,0
2409,Hidde ter Avest,26,14,17,6,3,14,20,70.0,6,14,3,11,10,39,1
2410,Marc-André ter Stegen,0,0,0,0,0,0,3,0.0,3,0,0,0,2,5,2
2411,Pietro Terracciano,0,0,0,0,0,0,0,,0,0,0,0,0,1,1
2412,Pietro Terracciano,0,0,0,0,0,0,0,,0,0,0,0,1,4,0
2413,Marco Terrazzino,6,3,4,2,0,1,7,14.3,6,5,2,3,3,2,0
2414,Martin Terrier,23,13,5,13,5,9,23,39.1,14,17,2,15,6,14,0
2415,Kenny Tete,30,23,11,16,3,13,19,68.4,6,13,5,8,18,29,0
2416,Cedric Teuchert,0,0,0,0,0,0,0,,0,2,0,2,1,0,0
2417,Florian Thauvin,42,23,10,21,11,16,35,45.7,19,19,1,18,8,4,0
2418,Cyril Théréau,0,0,0,0,0,0,0,,0,0,0,0,0,1,0
2419,Cyril Théréau,1,1,0,1,0,1,1,100.0,0,0,0,0,0,2,0
2420,Sada Thioub,30,19,13,10,7,20,45,44.4,25,29,1,28,16,11,0
2421,Romain Thomas,35,26,25,10,0,14,19,73.7,5,31,24,7,29,133,1
2422,Adrien Thomasson,54,27,18,23,13,21,66,31.8,45,29,5,24,18,12,1
2423,Erik Thommy,5,3,3,1,1,1,7,14.3,6,16,1,15,14,4,0
2424,Marcus Thuram,45,28,23,15,7,20,43,46.5,23,24,1,23,10,14,0
2425,Youri Tielemans,17,8,5,9,3,5,17,29.4,12,13,2,11,5,13,1
2426,Youri Tielemans,45,24,17,23,5,24,47,51.1,23,20,3,17,18,22,0
2427,Timmy Tillman,0,0,0,0,0,0,4,0.0,4,3,0,3,3,0,2
2428,Cheick Timite,18,13,5,7,6,3,16,18.8,13,14,2,12,12,13,0
2429,David Timor,2,2,1,1,0,0,1,0.0,1,1,1,0,3,3,0
2430,George Timotheou,3,3,3,0,0,0,0,,0,1,1,0,1,4,0
2431,Marcel Tisserand,14,9,9,5,0,10,13,76.9,3,12,5,7,20,42,1
2432,Tito,14,9,12,2,0,7,22,31.8,15,22,2,20,17,41,0
2433,Jean-Clair Todibo,7,2,4,3,0,5,6,83.3,1,1,0,1,3,8,0
2434,Jean-Clair Todibo,21,18,19,2,0,11,13,84.6,2,14,5,9,14,62,2
2435,Karl Toko Ekambi,11,8,1,6,4,2,14,14.3,12,8,0,8,11,9,1
2436,Corentin Tolisso,0,0,0,0,0,0,2,0.0,2,1,1,0,0,0,0
2437,Rafael Tolói,27,17,15,9,3,16,24,66.7,8,28,10,18,33,54,1
2438,Raúl de Tomás,8,3,0,7,1,0,12,0.0,12,18,4,14,9,45,0
2439,James Tomkins,34,20,27,7,0,15,28,53.6,13,23,10,13,34,184,3
2440,Nenad Tomović,9,7,5,4,0,7,10,70.0,3,5,1,4,13,34,0
2441,Lorenzo Tonelli,31,22,19,9,3,15,19,78.9,4,27,21,6,24,92,0
2442,Toño,17,13,12,3,2,10,21,47.6,11,20,5,15,14,42,0
2443,Ömer Toprak,1,1,0,1,0,0,1,0.0,1,1,1,0,0,7,0
2444,Lucas Torreira,65,39,24,32,9,25,57,43.9,32,34,7,27,41,33,2
2445,Daniel Torres,2,1,2,0,0,0,3,0.0,3,0,0,0,2,0,0
2446,Ferrán Torres,15,8,4,8,3,5,11,45.5,6,10,1,9,10,9,0
2447,Lucas Torró,14,7,5,7,2,5,11,45.5,6,12,1,11,14,13,0
2448,Jordan Torunarigha,34,30,23,10,1,18,28,64.3,10,19,7,12,29,55,0
2449,Cenk Tosun,13,9,3,6,4,4,13,30.8,9,12,0,12,5,3,0
2450,Abdoulaye Touré,48,31,14,28,6,19,56,33.9,37,25,10,15,47,29,1
2451,Almamy Touré,13,6,6,7,0,3,10,30.0,7,3,1,2,11,12,0
2452,Almamy Touré,18,11,7,11,0,5,8,62.5,3,4,1,3,9,25,0
2453,Lucas Tousart,74,38,33,34,7,25,59,42.4,34,30,13,17,26,27,0
2454,Andros Townsend,62,35,38,16,8,35,89,39.3,54,48,5,43,38,28,0
2455,Adama Traoré,16,13,11,3,2,4,9,44.4,5,11,0,11,6,7,0
2456,Adama Traoré,2,1,1,0,1,1,4,25.0,3,4,0,4,3,1,0
2457,Bertrand Traoré,36,22,19,13,4,12,26,46.2,14,23,5,18,15,18,0
2458,Charles Traore,40,20,22,16,2,23,34,67.6,11,16,3,13,19,46,0
2459,Cheick Traoré,37,21,23,11,3,15,25,60.0,10,13,3,10,23,46,1
2460,Gaoussou Traoré,10,5,6,4,0,4,8,50.0,4,1,0,1,0,0,0
2461,Hamari Traoré,61,33,32,27,2,36,71,50.7,35,39,11,28,44,82,0
2462,Ibrahima Traoré,12,6,8,2,2,3,11,27.3,8,3,1,2,3,1,0
2463,Ismaël Traoré,27,11,19,8,0,9,24,37.5,15,27,16,11,42,120,2
2464,Kevin Trapp,0,0,0,0,0,0,2,0.0,2,0,0,0,0,17,1
2465,Mark Travers,0,0,0,0,0,0,0,,0,0,0,0,0,2,0
2466,Óscar Trejo,57,41,21,25,11,8,33,24.2,25,24,2,22,18,15,0
2467,Driss Trichard,2,2,2,0,0,1,1,100.0,0,1,0,1,1,4,0
2468,Manu Trigueros,46,35,18,23,5,20,57,35.1,37,17,6,11,16,17,0
2469,Kieran Trippier,67,37,43,16,8,37,62,59.7,25,38,5,33,23,77,2
2470,William Troost-Ekong,31,15,21,9,1,13,24,54.2,11,53,41,12,40,200,2
2471,Marcello Trotta,7,6,2,4,1,1,3,33.3,2,2,1,1,3,3,0
2472,Marcello Trotta,0,0,0,0,0,0,1,0.0,1,0,0,0,0,0,0
2473,Philipp Tschauner,0,0,0,0,0,0,0,,0,0,0,0,0,0,0
2474,Marco Tumminello,0,0,0,0,0,0,0,,0,0,0,0,0,0,0
2475,Patrick Twumasi,3,3,2,0,1,0,4,0.0,4,2,0,2,1,1,0
2476,Salih Uçan,10,4,3,5,2,3,10,30.0,7,4,0,4,6,2,0
2477,Anthony Ujah,2,0,0,1,1,1,2,50.0,1,7,2,5,1,10,0
2478,Sven Ulreich,0,0,0,0,0,0,0,,0,0,0,0,0,2,1
2479,Samuel Umtiti,8,5,3,4,1,4,6,66.7,2,10,8,2,18,28,2
2480,Enes Ünal,17,10,3,4,10,4,24,16.7,20,17,4,13,2,18,0
2481,Cengiz Ünder,6,3,3,3,0,2,11,18.2,9,7,0,7,13,5,0
2482,Joel Untersee,3,2,1,2,0,2,3,66.7,1,2,1,1,1,5,1
2483,Dayot Upamecano,22,16,14,8,0,15,18,83.3,3,19,5,14,33,47,0
2484,Takashi Usami,18,12,7,11,0,9,26,34.6,17,15,2,13,8,13,1
2485,Mark Uth,20,11,8,8,4,4,23,17.4,19,19,2,17,8,12,0
2486,Tomáš Vaclík,0,0,0,0,0,0,1,0.0,1,0,0,0,0,9,6
2487,Valentín Vada,2,1,0,2,0,1,1,100.0,0,0,0,0,0,0,0
2488,Valentín Vada,7,4,4,3,0,3,12,25.0,9,4,1,3,7,4,0
2489,William Vainqueur,6,3,4,2,0,1,1,100.0,0,1,0,1,0,0,0
2490,Mirko Valdifiori,20,15,12,7,1,8,14,57.1,6,4,2,2,5,9,0
2491,Pierrick Valdivia,1,1,0,1,0,1,2,50.0,1,1,0,1,1,0,0
2492,Antonio Valencia,8,6,2,4,2,3,4,75.0,1,9,0,9,5,10,0
2493,Enrico Valentini,44,27,31,10,3,22,40,55.0,18,17,3,14,13,58,0
2494,Borja Valero,22,19,9,10,3,8,30,26.7,22,11,1,10,16,27,2
2495,Yan Valery,42,36,26,10,6,16,29,55.2,13,24,3,21,22,72,1
2496,Jesús Vallejo,6,5,4,2,0,5,6,83.3,1,4,4,0,7,12,0
2497,Theo Valls,37,21,16,19,2,15,43,34.9,28,17,4,13,22,15,0
2498,Mattia Valoti,33,19,13,14,6,13,29,44.8,16,23,0,23,19,17,1
2499,Federico Valverde,12,8,3,7,2,5,11,45.5,6,10,2,8,21,10,0
2500,Luca Valzania,21,12,7,10,4,13,33,39.4,20,18,0,18,16,8,1
2501,Luca Valzania,5,4,2,3,0,3,5,60.0,2,0,0,0,1,0,0
2502,Virgil van Dijk,38,28,26,11,1,14,14,100.0,0,29,18,11,40,201,1
2503,Raphaël Varane,33,18,25,7,1,15,19,78.9,4,21,9,12,32,141,1
2504,Jamie Vardy,14,8,3,6,5,4,17,23.5,13,16,1,15,6,28,0
2505,Franco Vázquez,51,37,21,21,9,23,66,34.8,43,25,2,23,23,27,1
2506,Kevin Vázquez,6,5,5,0,1,4,7,57.1,3,8,3,5,2,9,0
2507,Lucas Vázquez,43,26,11,21,11,15,41,36.6,26,16,1,15,12,11,0
2508,Matías Vecino,50,39,18,23,9,26,53,49.1,27,38,9,29,17,22,0
2509,Koke Vegas,0,0,0,0,0,0,0,,0,0,0,0,0,0,0
2510,Emiliano Velázquez,49,32,38,9,2,20,34,58.8,14,29,7,22,47,106,1
2511,Miloš Veljković,36,24,29,6,1,22,37,59.5,15,27,13,14,27,111,0
2512,Miguel Veloso,31,20,14,13,4,9,26,34.6,17,12,1,11,13,21,0
2513,Daniele Verde,6,3,2,2,2,1,6,16.7,5,3,0,3,7,3,1
2514,Francesco Verde,1,0,0,1,0,0,0,,0,0,0,0,0,0,0
2515,Simone Verdi,16,11,5,9,2,8,16,50.0,8,6,0,6,4,3,0
2516,Jordan Veretout,64,40,22,31,11,21,52,40.4,31,33,7,26,46,54,2
2517,Paul Verhaegh,1,0,0,0,1,1,2,50.0,1,5,0,5,1,7,1
2518,Thomas Vermaelen,6,4,3,3,0,3,7,42.9,4,4,2,2,6,21,0
2519,Marco Verratti,72,42,25,39,8,36,81,44.4,45,26,1,25,18,8,2
2520,Jan Vertonghen,39,24,17,20,2,14,24,58.3,10,18,11,7,32,81,0
2521,Freddie Veseli,34,21,16,15,3,19,27,70.4,8,28,17,11,30,99,1
2522,Mikel Vesga,50,32,27,15,8,20,82,24.4,62,42,4,38,39,26,0
2523,Jannik Vestergaard,53,33,37,13,3,28,45,62.2,17,35,20,15,35,174,1
2524,Rúben Vezo,26,17,17,8,1,14,22,63.6,8,23,20,3,19,88,0
2525,Rúben Vezo,2,1,2,0,0,2,4,50.0,2,2,1,1,2,10,0
2526,Francesco Vicari,28,24,21,7,0,18,28,64.3,10,31,24,7,34,139,1
2527,Aleix Vidal,13,11,5,5,3,5,14,35.7,9,5,0,5,4,12,0
2528,Arturo Vidal,78,44,32,37,9,30,69,43.5,39,46,5,41,29,23,1
2529,Ronaldo Vieira,19,10,3,14,2,5,9,55.6,4,10,2,8,8,24,1
2530,Luciano Vietto,15,11,5,5,5,4,19,21.1,15,9,0,9,6,5,0
2531,Carlos Vigaray,15,8,10,4,1,9,15,60.0,6,6,1,5,6,24,1
2532,Emanuel Vignato,8,4,4,3,1,0,6,0.0,6,4,0,4,10,0,0
2533,Dídac Vilà,67,31,33,26,8,31,58,53.4,27,41,12,29,53,94,1
2534,Toni Villa,51,32,24,18,9,20,47,42.6,27,15,0,15,12,10,0
2535,Rúben Vinagre,14,9,7,7,0,2,5,40.0,3,10,2,8,14,16,1
2536,Carlos Vinícius,4,1,1,2,1,0,1,0.0,1,7,0,7,1,2,0
2537,Vitolo,17,13,8,6,3,6,19,31.6,13,8,1,7,10,6,0
2538,Federico Viviani,6,5,2,3,1,3,8,37.5,5,6,3,3,8,2,0
2539,Emiliano Viviano,0,0,0,0,0,0,0,,0,0,0,0,0,5,2
2540,Felipe Vizeu,0,0,0,0,0,0,0,,0,0,0,0,0,0,0
2541,Dušan Vlahović,0,0,0,0,0,0,0,,0,2,0,2,0,4,0
2542,Rai Vloet,4,2,1,2,1,0,3,0.0,3,4,0,4,0,1,0
2543,Kevin Vogt,24,15,20,4,0,12,32,37.5,20,28,11,17,33,103,3
2544,Sam Vokes,4,2,1,2,1,0,0,,0,2,1,1,0,17,0
2545,Kevin Volland,33,20,7,14,12,13,27,48.1,14,17,1,16,6,33,0
2546,Michel Vorm,0,0,0,0,0,0,0,,0,0,0,0,0,1,0
2547,Stefan de Vrij,25,16,14,10,1,8,15,53.3,7,32,23,9,25,95,1
2548,Šime Vrsaljko,20,14,8,6,6,9,14,64.3,5,5,1,4,11,27,1
2549,Nikola Vukčević,25,18,12,9,4,9,24,37.5,15,15,5,10,10,17,0
2550,Matěj Vydra,2,1,0,1,1,0,3,0.0,3,4,1,3,1,6,0
2551,Paul Wade,0,0,0,0,0,0,3,0.0,3,0,0,0,0,1,0
2552,Sandro Wagner,3,2,0,2,1,0,1,0.0,1,0,0,0,0,2,0
2553,Molla Wagué,1,1,1,0,0,0,1,0.0,1,1,0,1,4,5,0
2554,Moussa Wagué,6,5,1,4,1,3,7,42.9,4,1,0,1,4,3,0
2555,Wakaso,46,30,23,19,4,12,36,33.3,24,37,9,28,16,19,2
2556,Walace,52,22,17,28,7,27,61,44.3,34,30,4,26,45,36,1
2557,Theo Walcott,27,17,11,9,7,10,22,45.5,12,17,1,16,22,8,0
2558,Luca Waldschmidt,20,13,7,10,3,2,20,10.0,18,20,3,17,13,8,1
2559,Kyle Walker,40,26,20,20,0,24,38,63.2,14,19,5,14,36,58,2
2560,Kyle Walker-Peters,7,4,4,2,1,3,4,75.0,1,5,1,4,4,6,0
2561,Wallace,17,13,11,6,0,8,17,47.1,9,13,7,6,30,60,2
2562,Anthony Walongwa,0,0,0,0,0,0,0,,0,3,2,1,1,2,0
2563,Rémi Walter,20,12,7,10,3,5,15,33.3,10,9,1,8,6,11,0
2564,Aaron Wan-Bissaka,129,90,90,33,6,55,65,84.6,10,49,16,33,84,161,0
2565,Victor Wanyama,13,13,8,5,0,6,12,50.0,6,9,3,6,7,11,0
2566,Danny Ward,2,1,0,1,1,0,3,0.0,3,3,1,2,0,9,0
2567,Joel Ward,12,7,7,4,1,3,10,30.0,7,2,0,2,10,35,0
2568,Stephen Ward,4,2,1,2,1,1,4,25.0,3,3,1,2,4,14,0
2569,James Ward-Prowse,36,17,19,13,4,14,43,32.6,29,30,6,24,27,59,0
2570,Daniel Wass,35,25,9,19,7,20,42,47.6,22,23,4,19,34,49,0
2571,Timothy Weah,0,0,0,0,0,0,0,,0,0,0,0,0,0,0
2572,Wout Weghorst,30,23,10,12,8,7,35,20.0,28,27,3,24,9,33,0
2573,Julian Weigl,32,18,19,12,1,24,41,58.5,17,18,10,8,16,56,2
2574,Mitchell Weiser,63,37,34,22,7,26,50,52.0,24,31,3,28,27,48,0
2575,Danny Welbeck,3,2,0,2,1,0,0,,0,2,0,2,1,2,0
2576,Wendell,75,48,47,24,4,34,57,59.6,23,49,13,36,29,66,0
2577,Oscar Wendt,45,34,34,8,3,31,53,58.5,22,37,11,26,19,90,0
2578,Axel Werner,0,0,0,0,0,0,0,,0,0,0,0,0,2,0
2579,Timo Werner,18,12,6,8,4,3,16,18.8,13,18,2,16,3,7,0
2580,Ashley Westwood,58,30,24,27,7,14,39,35.9,25,38,9,29,47,42,2
2581,Hendrik Weydandt,18,12,7,8,3,3,24,12.5,21,14,4,10,5,44,0
2582,Connor Wickham,0,0,0,0,0,0,0,,0,0,0,0,0,2,0
2583,Georginio Wijnaldum,41,28,14,20,7,14,27,51.9,13,21,7,14,21,24,0
2584,Jetro Willems,20,15,10,8,2,9,15,60.0,6,10,4,6,10,14,0
2585,William,82,57,52,21,9,35,75,46.7,40,41,2,39,85,127,3
2586,Danny Williams,0,0,0,0,0,0,0,,0,4,1,3,1,2,0
2587,Iñaki Williams,27,18,9,7,11,5,22,22.7,17,22,1,21,7,33,0
2588,Willian,35,21,11,15,9,9,25,36.0,16,16,1,15,14,12,2
2589,Joe Willock,1,0,0,1,0,0,0,,0,1,0,1,1,0,0
2590,Ben Wilmot,0,0,0,0,0,0,1,0.0,1,2,1,1,0,1,0
2591,Ben Wilmot,0,0,0,0,0,0,2,0.0,2,2,2,0,2,11,0
2592,Jack Wilshere,7,4,1,4,2,2,6,33.3,4,3,1,2,7,0,0
2593,Callum Wilson,9,7,4,3,2,0,8,0.0,8,14,4,10,4,16,0
2594,Kevin Wimmer,25,17,17,6,2,15,27,55.6,12,30,23,7,41,63,0
2595,Harry Winks,22,13,12,9,1,5,30,16.7,25,19,3,16,21,19,0
2596,Axel Witsel,47,33,19,24,4,17,28,60.7,11,33,6,27,47,49,0
2597,Maximilian Wöber,12,9,8,2,2,3,6,50.0,3,6,0,6,7,16,0
2598,Marius Wolf,14,10,11,3,0,5,13,38.5,8,6,0,6,13,12,0
2599,Jeong Woo-yeong,0,0,0,0,0,0,1,0.0,1,0,0,0,0,0,0
2600,Bobby Wood,13,10,2,10,1,5,8,62.5,3,2,0,2,4,6,0
2601,Chris Wood,12,8,0,7,5,5,17,29.4,12,17,4,13,3,26,0
2602,Haji Wright,3,2,1,1,1,0,1,0.0,1,1,0,1,0,1,0
2603,Xeka,59,31,25,27,7,18,57,31.6,39,20,2,18,21,30,4
2604,Granit Xhaka,52,29,29,20,3,24,59,40.7,35,35,9,26,36,56,3
2605,Cédric Yamberé,47,31,36,11,0,21,39,53.8,18,45,32,13,52,136,4
2606,Andriy Yarmolenko,4,1,2,1,1,4,6,66.7,2,4,1,3,2,4,2
2607,John Yeboah,0,0,0,0,0,0,3,0.0,3,1,0,1,1,0,0
2608,DeAndre Yedlin,54,32,36,14,4,19,41,46.3,22,36,10,26,28,88,0
2609,Yoel,0,0,0,0,0,0,0,,0,0,0,0,0,0,1
2610,Okay Yokuşlu,61,39,31,28,2,28,45,62.2,17,32,11,21,37,53,2
2611,Maya Yoshida,16,12,5,10,1,4,13,30.8,9,24,20,4,42,103,1
2612,Elie Youan,1,0,0,1,0,0,0,,0,0,0,0,0,0,0
2613,Amin Younes,11,6,3,6,2,3,6,50.0,3,7,0,7,2,0,0
2614,Ashley Young,52,32,34,16,2,20,39,51.3,19,36,10,26,55,74,0
2615,Zaydou Youssouf,7,5,3,4,0,3,7,42.9,4,5,1,4,5,0,0
2616,Pablo Zabaleta,47,24,26,15,6,17,44,38.6,27,39,15,24,48,96,3
2617,Dan-Axel Zagadou,13,10,10,2,1,4,6,66.7,2,17,11,6,25,70,2
2618,Wilfried Zaha,39,20,11,23,5,12,34,35.3,22,19,0,19,10,4,0
2619,Younn Zahary,16,9,7,6,3,8,14,57.1,6,13,8,5,16,35,0
2620,Miha Zajc,6,4,1,1,4,2,11,18.2,9,15,4,11,5,8,0
2621,Denis Zakaria,40,21,15,24,1,12,30,40.0,18,38,9,29,26,20,0
2622,Joseba Zaldúa,36,27,23,10,3,15,32,46.9,17,19,3,16,38,72,0
2623,Andre-Frank Zambo Anguissa,48,29,23,20,5,18,52,34.6,34,25,6,19,34,32,0
2624,Francesco Zampano,35,25,23,9,3,15,31,48.4,16,24,4,20,13,48,0
2625,Nicolò Zaniolo,35,21,7,18,10,7,37,18.9,30,14,0,14,13,8,0
2626,Cristián Zapata,23,16,15,7,1,9,10,90.0,1,18,15,3,8,59,0
2627,Duván Zapata,9,5,3,2,4,1,9,11.1,8,26,6,20,4,25,0
2628,Davide Zappacosta,0,0,0,0,0,0,1,0.0,1,0,0,0,3,5,0
2629,Simone Zaza,20,9,3,12,5,1,8,12.5,7,12,1,11,4,9,0
2630,Marvin Zeegelaar,30,23,21,6,3,16,24,66.7,8,11,2,9,17,38,0
2631,Mehdi Zeffane,19,13,12,7,0,10,26,38.5,16,14,5,9,18,35,1
2632,Arton Zekaj,0,0,0,0,0,0,0,,0,0,0,0,0,0,0
2633,Mootaz Zemzemi,1,0,0,0,1,0,0,,0,0,0,0,0,0,0
2634,Arber Zeneli,8,6,3,2,3,0,10,0.0,10,3,0,3,2,3,1
2635,Robin Zentner,0,0,0,0,0,0,1,0.0,1,0,0,0,1,3,0
2636,Nabil El Zhar,8,4,2,4,2,0,5,0.0,5,4,0,4,4,1,0
2637,Luca Zidane,0,0,0,0,0,0,0,,0,0,0,0,0,0,0
2638,Ron-Robert Zieler,2,1,2,0,0,1,4,25.0,3,1,0,1,1,19,3
2639,Piotr Zieliński,41,25,11,20,10,13,34,38.2,21,30,4,26,20,18,0
2640,Jean Zimmer,17,11,11,5,1,6,16,37.5,10,13,2,11,11,32,1
2641,Matthias Zimmermann,97,64,69,24,4,45,90,50.0,45,51,18,33,67,90,2
2642,Oleksandr Zinchenko,34,20,13,15,6,14,33,42.4,19,14,3,11,20,19,1
2643,Kévin Zohi,14,10,6,6,2,5,9,55.6,4,8,0,8,7,5,0
2644,Kenneth Zohore,3,2,0,3,0,1,3,33.3,2,4,2,2,2,5,0
2645,Kurt Zouma,32,21,16,14,2,4,11,36.4,7,27,12,15,54,126,2
2646,Adam Zreľák,14,9,2,11,1,5,9,55.6,4,14,2,12,2,13,0
2647,Igor Zubeldia,61,35,32,24,5,22,54,40.7,32,30,6,24,45,60,0
2648,Steven Zuber,12,9,5,6,1,6,13,46.2,7,5,1,4,5,4,0
2649,Steven Zuber,6,3,2,2,2,1,13,7.7,12,14,2,12,6,6,0
2650,Martín Zubimendi,1,0,0,1,0,0,1,0.0,1,0,0,0,0,0,0
2651,Ervin Zukanović,28,16,20,7,1,17,30,56.7,13,17,9,8,19,96,0
2652,Bongani Zungu,3,2,0,1,2,2,8,25.0,6,0,0,0,2,5,0
2653,David Zurutuza,27,16,9,15,3,8,22,36.4,14,19,4,15,24,26,1
2654,Filip Đorđević,11,6,3,6,2,3,12,25.0,9,7,1,6,2,8,1
2655,Filip Đuričić,17,13,2,11,4,5,22,22.7,17,20,1,19,8,8,1
