,Player,Tkl,TklW,Def 3rd,Mid 3rd,Att 3rd,TklDribblers,Att,Tkl%,Lost,Blocks,Sh,Pass,Int,Clr,Err
0,Patrick van Aanholt,43,23,31,10,2,23,50,46.0,27,31,9,22,45,52,1
1,Max Aarons,48,30,33,9,6,18,36,50.0,18,46,29,17,37,97,1
2,Yunis Abdelhamid,46,33,29,15,2,17,30,56.7,13,26,14,12,47,99,1
3,Suleiman Abdullahi,0,0,0,0,0,0,3,0.0,3,2,1,1,1,1,0
4,Mehdi Abeid,55,29,18,32,5,20,53,37.7,33,16,3,13,23,8,1
5,Charles Abi,9,9,2,5,2,2,7,28.6,5,2,0,2,4,4,0
6,David Abraham,21,14,16,4,1,15,32,46.9,17,27,11,16,25,61,1
7,Tammy Abraham,8,4,2,5,1,3,14,21.4,11,20,2,18,6,27,0
8,Amir Abrashi,16,8,7,8,1,10,19,52.6,9,18,3,15,7,16,2
9,Francesco Acerbi,59,29,42,12,5,14,20,70.0,6,40,27,13,42,109,1
10,Che Adams,6,4,1,5,0,1,4,25.0,3,9,1,8,2,10,0
11,Tyler Adams,22,15,13,8,1,12,25,48.0,13,16,1,15,14,14,0
12,Sargis Adamyan,11,7,3,6,2,3,21,14.3,18,8,1,7,2,4,0
13,Antonio Adán,0,0,0,0,0,0,0,,0,0,0,0,0,0,0
14,Bobby Adekanye,3,2,0,3,0,0,5,0.0,5,0,0,0,2,1,0
15,Claud Adjapong,5,3,4,1,0,2,3,66.7,1,4,3,1,3,7,0
16,Amine Adli,0,0,0,0,0,0,1,0.0,1,0,0,0,1,0,0
17,Yacine Adli,22,14,4,15,3,11,34,32.4,23,10,0,10,8,3,0
18,Adrián,1,1,1,0,0,1,1,100.0,0,0,0,0,0,8,3
19,Aritz Aduriz,3,2,0,3,0,0,0,,0,0,0,0,0,2,0
20,Lumor Agbenyenu,31,21,19,9,3,16,35,45.7,19,13,2,11,21,66,1
21,Martin Agirregabiria,55,30,32,18,5,30,54,55.6,24,19,7,12,18,48,0
22,Lucien Agoume,3,2,0,2,1,0,0,,0,3,1,2,0,0,0
23,Kevin Agudelo,2,1,0,1,1,0,1,0.0,1,1,0,1,1,0,0
24,Kevin Agudelo,23,14,9,12,2,10,20,50.0,10,12,1,11,6,2,0
25,Nayef Aguerd,13,9,7,5,1,8,12,66.7,4,11,11,0,18,54,0
26,Sergio Agüero,7,4,0,4,3,1,8,12.5,7,9,1,8,3,2,0
27,Ruben Aguilar,36,22,19,15,2,19,28,67.9,9,6,2,4,11,21,0
28,Emmanuel Agyemang-Badu,1,1,0,1,0,1,2,50.0,1,2,2,0,1,6,0
29,Jean-Eudes Aholou,16,12,2,11,3,3,9,33.3,6,6,1,5,15,10,0
30,Joseph Aidoo,43,27,30,11,2,13,27,48.1,14,31,14,17,45,124,3
31,Ola Aina,45,24,23,18,4,17,37,45.9,20,24,6,18,41,61,0
32,Youssef Aït Bennasser,11,8,6,4,1,4,24,16.7,20,6,1,5,4,10,1
33,Rayan Aït-Nouri,29,22,14,8,7,10,21,47.6,11,14,1,13,18,33,0
34,Albian Ajeti,1,0,0,0,1,0,0,,0,0,0,0,0,0,0
35,Ludovic Ajorque,15,10,2,10,3,2,13,15.4,11,11,0,11,2,20,0
36,Manuel Akanji,38,21,23,14,1,12,20,60.0,8,20,11,9,30,61,2
37,Marley Aké,2,2,1,1,0,1,3,33.3,2,0,0,0,1,1,0
38,Nathan Aké,31,21,23,8,0,14,23,60.9,9,40,29,11,36,152,0
39,Chadrac Akolo,16,8,8,6,2,5,12,41.7,7,6,1,5,5,5,0
40,Kevin Akpoguma,24,16,20,4,0,13,24,54.2,11,21,11,10,13,48,0
41,David Alaba,30,17,14,15,1,16,25,64.0,9,19,10,9,29,40,0
42,Sofiane Alakouch,45,26,25,13,7,25,48,52.1,23,13,2,11,23,39,3
43,Lucas Alario,6,3,0,4,2,1,8,12.5,7,12,2,10,1,9,0
44,Jordi Alba,20,13,9,7,4,6,27,22.2,21,12,3,9,37,40,0
45,Luis Alberto,50,30,21,19,10,27,82,32.9,55,32,1,31,21,9,1
46,Raúl Albiol,43,23,27,16,0,18,27,66.7,9,29,21,8,42,175,2
47,Marc Albrighton,24,17,10,13,1,9,30,30.0,21,19,2,17,10,8,0
48,Paco Alcácer,3,3,2,1,0,1,7,14.3,6,4,1,3,2,10,0
49,Paco Alcácer,2,2,0,2,0,1,5,20.0,4,4,1,3,2,3,0
50,Thiago Alcántara,45,26,17,23,5,12,33,36.4,21,12,3,9,45,13,1
51,Rubén Alcaraz,61,30,37,20,4,30,63,47.6,33,46,15,31,15,41,0
52,Toby Alderweireld,40,29,24,13,3,11,24,45.8,13,48,32,16,31,172,2
53,Haitam Aleesami,36,16,25,9,2,18,43,41.9,25,33,10,23,34,59,1
54,Álex Alegría,1,0,1,0,0,0,0,,0,2,0,2,0,0,0
55,Carles Aleñá,2,1,1,1,0,1,4,25.0,3,1,0,1,0,0,0
56,Carles Aleñá,14,9,5,7,2,3,17,17.6,14,4,1,3,1,3,0
57,Rúnar Alex Rúnarsson,0,0,0,0,0,0,2,0.0,2,0,0,0,0,3,3
58,Trent Alexander-Arnold,55,34,35,17,3,36,78,46.2,42,27,9,18,45,84,3
59,Enrico Alfonso,0,0,0,0,0,0,0,,0,0,0,0,0,2,0
60,Rachid Alioui,8,5,0,7,1,2,13,15.4,11,3,0,3,2,9,0
61,Alisson,0,0,0,0,0,0,2,0.0,2,0,0,0,1,13,3
62,Allan,50,27,20,21,9,18,54,33.3,36,19,3,16,16,11,1
63,Dele Alli,34,16,11,20,3,13,37,35.1,24,35,3,32,17,17,2
64,Miguel Almirón,60,39,32,20,8,19,52,36.5,33,25,1,24,31,25,0
65,Marcos Alonso,28,16,20,6,2,14,33,42.4,19,18,2,16,20,32,0
66,Mickaël Alphonse,39,25,26,12,1,23,37,62.2,14,19,3,16,17,64,0
67,Sergio Álvarez,37,22,11,24,2,8,24,33.3,16,16,2,14,17,26,1
68,Sergio Álvarez,0,0,0,0,0,0,0,,0,0,0,0,0,1,0
69,Yeray Álvarez,36,19,28,7,1,17,30,56.7,13,33,22,11,62,138,2
70,Bruno Alves,17,11,12,5,0,8,13,61.5,5,30,21,9,25,150,2
71,Steven Alzate,33,19,20,11,2,17,27,63.0,10,18,3,15,14,13,0
72,Ibrahim Amadou,18,11,9,8,1,3,11,27.3,8,8,5,3,16,55,1
73,Ibrahim Amadou,16,9,5,9,2,4,11,36.4,7,5,0,5,12,6,0
74,Romain Amalfitano,43,27,18,21,4,21,61,34.4,40,23,9,14,36,14,2
75,Amath,2,1,1,1,0,0,5,0.0,5,2,0,2,0,0,0
76,Jordan Amavi,55,29,31,19,5,31,64,48.4,33,27,6,21,56,97,0
77,Thierry Ambrose,7,5,2,2,3,2,7,28.6,5,3,0,3,3,3,0
78,Kelvin Amian,27,21,21,5,1,14,25,56.0,11,14,7,7,18,56,0
79,Nadiem Amiri,26,16,7,15,4,16,34,47.1,18,12,2,10,14,8,1
80,Ethan Ampadu,5,4,3,2,0,1,1,100.0,0,3,1,2,1,3,0
81,Opoku Ampomah,9,4,3,4,2,3,12,25.0,9,3,0,3,4,5,0
82,Sofyan Amrabat,58,36,26,21,11,26,55,47.3,29,29,10,19,31,15,1
83,Joachim Andersen,17,9,15,2,0,7,19,36.8,12,16,12,4,10,74,2
84,Djavan Anderson,0,0,0,0,0,0,0,,0,1,0,1,3,3,0
85,Felipe Anderson,46,32,20,21,5,11,47,23.4,36,19,1,18,22,11,0
86,Sebastian Andersson,20,10,0,12,8,4,19,21.1,15,19,3,16,5,36,0
87,Florin Andone,1,1,0,1,0,1,1,100.0,0,1,1,0,0,1,0
88,Benjamin André,72,44,31,35,6,29,74,39.2,45,32,9,23,59,40,1
89,Lorenzo Andrenacci,1,0,1,0,0,1,3,33.3,2,0,0,0,0,0,0
90,Robert Andrich,52,27,28,18,6,19,60,31.7,41,27,7,20,47,36,0
91,Victorien Angban,23,18,11,11,1,11,24,45.8,13,9,2,7,8,5,0
92,Miguel Ángel Guerrero,1,0,0,1,0,1,10,10.0,9,4,0,4,2,4,0
93,José Ángel,54,31,26,25,3,26,43,60.5,17,23,7,16,33,61,1
94,Miguel Ángel Moyá,0,0,0,0,0,0,1,0.0,1,0,0,0,1,6,2
95,Angeliño,5,2,3,1,1,5,7,71.4,2,1,0,1,9,15,0
96,Angeliño,15,9,7,5,3,5,15,33.3,10,14,1,13,19,24,0
97,Faustino Anjorin,0,0,0,0,0,0,0,,0,1,0,1,0,0,0
98,Peter Ankersen,16,4,7,7,2,4,13,30.8,9,19,5,14,9,25,1
99,Cristian Ansaldi,37,25,24,7,6,19,34,55.9,15,23,3,20,14,20,4
100,Janis Antiste,0,0,0,0,0,0,0,,0,0,0,0,0,0,0
101,Michail Antonio,13,9,5,4,4,4,14,28.6,10,17,2,15,9,5,0
102,Antoñito,26,18,19,7,0,12,20,60.0,8,9,0,9,15,20,1
103,Mirko Antonucci,4,3,1,0,3,3,3,100.0,0,2,0,2,2,1,0
104,Vitorino Antunes,0,0,0,0,0,0,0,,0,0,0,0,0,1,0
105,Christopher Antwi-Adjei,25,16,13,9,3,9,33,27.3,24,29,2,27,15,14,0
106,Anuar,4,2,1,2,1,2,6,33.3,4,7,3,4,5,0,0
107,Houssem Aouar,28,12,6,18,4,10,35,28.6,25,15,1,14,13,11,0
108,Adil Aouchiche,3,2,1,2,0,2,4,50.0,2,3,0,3,0,0,0
109,Dennis Appiah,58,35,32,20,6,28,52,53.8,24,9,3,6,23,34,0
110,Mauro Arambarri,72,33,24,40,8,31,69,44.9,38,52,5,47,43,40,2
111,Guilherme Arana,4,4,1,3,0,3,5,60.0,2,0,0,0,2,0,0
112,Charles Aránguiz,56,37,19,29,8,27,74,36.5,47,27,6,21,22,21,1
113,Luiz Araújo,20,11,3,8,9,5,31,16.1,26,14,0,14,4,6,0
114,Néstor Araujo,44,27,35,8,1,22,36,61.1,14,26,18,8,52,142,0
115,Ronald Araújo,3,2,2,1,0,1,1,100.0,0,6,2,4,0,9,0
116,Anaitz Arbilla,33,20,23,8,2,16,34,47.1,18,20,4,16,29,82,0
117,Alphonse Areola,0,0,0,0,0,0,0,,0,0,0,0,0,0,0
118,Alphonse Areola,0,0,0,0,0,0,0,,0,0,0,0,0,1,1
119,Santiago Arias,36,24,20,12,4,10,18,55.6,8,12,7,5,19,20,1
120,Nicolò Armini,1,1,1,0,0,1,1,100.0,0,0,0,0,0,1,0
121,Stuart Armstrong,32,19,19,11,2,9,38,23.7,29,22,4,18,11,23,1
122,José Arnaiz,3,2,0,2,1,0,12,0.0,12,7,0,7,5,5,0
123,José Arnaiz,3,0,1,2,0,2,5,40.0,3,4,0,4,2,1,0
124,Maximilian Arnold,42,24,15,23,4,16,62,25.8,46,25,6,19,25,35,0
125,Kepa Arrizabalaga,1,1,1,0,0,1,2,50.0,1,0,0,0,1,7,2
126,Kwadwo Asamoah,10,8,4,5,1,6,14,42.9,8,8,1,7,9,13,0
127,Santiago Ascacíbar,26,13,15,11,0,11,28,39.3,17,13,2,11,16,13,0
128,Sergio Asenjo,0,0,0,0,0,0,2,0.0,2,0,0,0,1,15,1
129,Marco Asensio,4,3,3,1,0,1,4,25.0,3,2,0,2,1,4,0
130,Kristoffer Askildsen,1,1,1,0,0,0,0,,0,1,0,1,1,0,0
131,Iago Aspas,29,19,7,9,13,12,45,26.7,33,16,1,15,22,7,0
132,Roger Assalé,3,2,1,0,2,1,9,11.1,8,8,0,8,0,1,0
133,Youcef Atal,24,11,15,6,3,13,31,41.9,18,12,1,11,24,11,1
134,Miguel Atienza,1,1,0,1,0,1,2,50.0,1,1,1,0,2,1,0
135,Christian Atsu,10,8,5,5,0,5,14,35.7,9,19,0,19,5,9,0
136,Pierre-Emerick Aubameyang,31,19,10,12,9,12,51,23.5,39,39,1,38,14,16,0
137,Emil Audero,1,1,1,0,0,1,3,33.3,2,0,0,0,0,21,1
138,Tommaso Augello,14,9,6,3,5,5,7,71.4,2,8,0,8,15,21,1
139,Jean-Kévin Augustin,3,0,1,2,0,1,6,16.7,5,2,0,2,3,0,0
140,Ludwig Augustinsson,29,12,15,9,5,12,23,52.2,11,19,5,14,10,29,0
141,Serge Aurier,93,69,58,27,8,39,69,56.5,30,38,6,32,47,98,2
142,Mathias Autret,23,17,5,11,7,8,25,32.0,17,14,1,13,10,3,0
143,Ezequiel Ávila,17,12,6,7,4,6,18,33.3,12,12,0,12,3,5,0
144,Javier Avilés,9,7,2,7,0,2,4,50.0,2,3,0,3,3,1,0
145,Chidozie Awaziem,34,22,29,5,0,16,27,59.3,11,26,15,11,28,73,1
146,Taiwo Awoniyi,2,0,0,2,0,0,4,0.0,4,4,2,2,2,3,0
147,Florian Ayé,17,9,9,5,3,6,13,46.2,7,17,2,15,4,18,1
148,Jordan Ayew,48,30,10,22,16,17,49,34.7,32,29,4,25,15,21,0
149,Kaan Ayhan,38,25,26,11,1,20,37,54.1,17,28,15,13,45,72,1
150,Ramon Azeez,11,8,2,8,1,7,19,36.8,12,8,2,6,19,11,1
151,César Azpilicueta,86,56,40,32,14,35,69,50.7,34,56,21,35,67,94,0
152,Ludovic Baal,27,15,13,12,2,10,22,45.5,12,9,3,6,17,20,0
153,Iddrisu Baba,59,37,26,29,4,20,70,28.6,50,31,8,23,39,42,0
154,Khouma Babacar,12,8,2,6,4,1,7,14.3,6,12,3,9,3,34,0
155,Carlos Bacca,5,1,1,2,2,2,6,33.3,4,4,0,4,0,7,0
156,Milan Badelj,29,17,10,16,3,15,50,30.0,35,21,3,18,45,34,1
157,Matthias Bader,1,1,1,0,0,1,2,50.0,1,0,0,0,0,1,0
158,Benoît Badiashile,18,12,12,5,1,6,12,50.0,6,20,11,9,27,57,1
159,Bastian Badu,0,0,0,0,0,0,0,,0,0,0,0,0,0,0
160,Alex Baena,0,0,0,0,0,0,0,,0,1,0,1,0,0,0
161,Stéphane Bahoken,7,4,1,2,4,1,7,14.3,6,4,1,3,2,2,0
162,Daniel Baier,33,17,14,14,5,15,43,34.9,28,19,7,12,58,27,0
163,Leon Bailey,6,3,1,5,0,6,16,37.5,10,9,0,9,8,3,0
164,Eric Bailly,0,0,0,0,0,0,1,0.0,1,3,3,0,4,7,1
165,Dénys Bain,21,14,15,6,0,9,9,100.0,0,13,10,3,28,66,0
166,Leighton Baines,10,6,6,2,2,8,10,80.0,2,5,2,3,5,14,0
167,Stefan Bajic,0,0,0,0,0,0,0,,0,1,0,1,0,2,0
168,Tiemoué Bakayoko,48,24,16,27,5,29,54,53.7,25,12,4,8,29,17,0
169,Lewis Baker,8,5,6,2,0,2,10,20.0,8,5,2,3,2,5,0
170,Mitchel Bakker,2,2,1,1,0,1,1,100.0,0,0,0,0,0,2,0
171,Ridle Baku,54,31,25,22,7,26,53,49.1,27,45,7,38,42,57,0
172,Fabián Balbuena,17,12,13,3,1,9,25,36.0,16,15,5,10,26,75,3
173,Keita Baldé,6,5,1,1,4,3,9,33.3,6,4,1,3,2,7,1
174,George Baldock,62,43,35,17,10,27,47,57.4,20,26,3,23,34,83,3
175,Gareth Bale,9,5,5,2,2,3,14,21.4,11,8,2,6,6,9,0
176,Mikel Balenziaga,15,10,4,10,1,9,11,81.8,2,4,1,3,2,20,0
177,Leonardo Balerdi,2,1,1,1,0,2,2,100.0,0,0,0,0,4,3,0
178,Marco Ballarini,0,0,0,0,0,0,0,,0,0,0,0,0,0,0
179,Fodé Ballo-Touré,36,25,21,11,4,17,32,53.1,15,10,1,9,24,45,0
180,Florent Balmont,12,6,5,7,0,7,12,58.3,5,6,0,6,1,3,0
181,Mario Balotelli,2,2,0,2,0,0,2,0.0,2,1,1,0,8,22,0
182,Abdoulaye Bamba,10,7,7,1,2,8,15,53.3,7,4,1,3,4,18,0
183,Jonathan Bamba,12,6,5,5,2,7,29,24.1,22,19,3,16,16,8,2
184,Éver Banega,43,28,16,18,9,21,70,30.0,49,19,1,18,15,5,0
185,Mattia Bani,47,28,27,19,1,25,36,69.4,11,29,15,14,52,92,2
186,Antonín Barák,5,4,3,0,2,1,5,20.0,4,6,1,5,0,4,0
187,Antonín Barák,19,10,9,10,0,6,24,25.0,18,18,1,17,9,20,2
188,Federico Barba,12,6,10,2,0,7,9,77.8,2,5,2,3,8,12,0
189,Danilo Barbosa,28,21,17,9,2,13,29,44.8,16,21,6,15,20,38,0
190,Melvin Bard,0,0,0,0,0,0,0,,0,0,0,0,1,0,0
191,Enis Bardhi,24,11,7,15,2,8,35,22.9,27,15,4,11,15,19,0
192,Phil Bardsley,49,36,16,24,9,24,37,64.9,13,24,11,13,30,73,0
193,Nicolò Barella,36,21,14,15,7,8,37,21.6,29,20,5,15,14,14,0
194,Philipp Bargfrede,15,12,8,5,2,6,23,26.1,17,8,2,6,16,15,0
195,Antonino Barillà,43,31,22,19,2,16,45,35.6,29,26,8,18,17,32,0
196,Kike Barja,1,1,1,0,0,1,1,100.0,0,3,1,2,0,2,0
197,Ross Barkley,16,9,6,6,4,5,18,27.8,13,7,2,5,7,7,0
198,Aymen Barkok,1,1,0,0,1,0,2,0.0,2,2,0,2,3,1,0
199,Ashley Barnes,10,5,3,5,2,3,9,33.3,6,7,2,5,6,9,0
200,Harvey Barnes,16,11,7,7,2,5,23,21.7,18,13,3,10,8,6,1
201,Antonio Barragán,7,5,4,2,1,3,6,50.0,3,2,2,0,8,22,0
202,Antonio Barreca,10,7,5,3,2,4,5,80.0,1,12,7,5,1,22,0
203,Leandro Barreiro Martins,38,21,16,19,3,14,29,48.3,15,18,3,15,9,18,1
204,Ander Barrenetxea,12,9,5,5,2,4,10,40.0,6,3,0,3,3,4,0
205,Édgar Barreto,4,3,0,1,3,2,3,66.7,1,1,0,1,0,0,0
206,Musa Barrow,20,13,11,7,2,6,20,30.0,14,15,0,15,5,11,0
207,Musa Barrow,1,1,0,0,1,1,4,25.0,3,4,0,4,0,1,0
208,Fin Bartels,9,5,4,4,1,3,12,25.0,9,3,1,2,1,1,0
209,Marc Bartra,62,34,39,23,0,27,54,50.0,27,45,24,21,35,127,0
210,Daniele Baselli,43,23,17,19,7,13,40,32.5,27,20,4,16,25,25,0
211,Chris Basham,85,48,58,20,7,48,81,59.3,33,38,15,23,77,173,1
212,Toma Bašić,26,22,9,16,1,12,27,44.4,15,14,2,12,9,12,1
213,Thomas Basila,6,3,2,4,0,4,4,100.0,0,0,0,0,4,14,0
214,Gil Bastião Dias,19,14,10,6,3,7,17,41.2,10,4,1,3,3,7,0
215,Gil Bastião Dias,53,33,30,21,2,29,58,50.0,29,15,1,14,13,22,1
216,Borja Bastón,1,0,0,1,0,0,2,0.0,2,1,0,1,0,0,1
217,Alessandro Bastoni,32,17,14,11,7,15,24,62.5,9,18,9,9,26,54,0
218,Bastos,9,5,6,3,0,4,11,36.4,7,13,8,5,13,26,0
219,Oliver Batista-Meier,0,0,0,0,0,0,2,0.0,2,0,0,0,0,0,0
220,Michy Batshuayi,4,1,2,2,0,0,5,0.0,5,1,1,0,0,1,0
221,Cristian Battocchio,31,24,13,13,5,14,36,38.9,22,13,4,9,19,21,0
222,Oliver Baumann,0,0,0,0,0,0,0,,0,1,0,1,3,15,0
223,Julian Baumgartlinger,42,21,15,21,6,18,42,42.9,24,37,4,33,20,16,1
224,Christoph Baumgartner,32,17,15,16,1,10,37,27.0,27,25,1,24,8,13,0
225,Noah Joel Sarenren Bazee,4,3,0,4,0,1,4,25.0,3,2,1,1,5,4,0
226,Ihlas Bebou,27,15,9,13,5,8,23,34.8,15,25,4,21,11,25,0
227,Rodrigo Becão,56,25,34,19,3,26,46,56.5,20,40,20,20,45,77,0
228,Sheraldo Becker,2,1,2,0,0,1,3,33.3,2,1,0,1,0,1,0
229,Timo Becker,10,9,3,6,1,5,9,55.6,4,6,1,5,3,8,0
230,Jan Bednarek,65,38,41,18,6,31,61,50.8,30,44,23,21,77,198,4
231,Asmir Begović,0,0,0,0,0,0,0,,0,0,0,0,0,0,0
232,Valon Behrami,34,26,13,17,4,8,32,25.0,24,25,10,15,9,16,0
233,Maximilian Beier,5,2,0,1,4,1,2,50.0,1,2,0,2,0,0,0
234,Gaëtan Belaud,13,7,10,2,1,4,8,50.0,4,8,3,5,15,15,0
235,Ishak Belfodil,0,0,0,0,0,0,1,0.0,1,0,0,0,0,2,0
236,Haris Belkebla,44,24,17,17,10,10,28,35.7,18,25,5,20,53,21,2
237,Raoul Bellanova,0,0,0,0,0,0,0,,0,0,0,0,0,0,0
238,Raoul Bellanova,1,1,1,0,0,0,1,0.0,1,0,0,0,0,0,0
239,Karim Bellarabi,19,11,9,7,3,9,28,32.1,19,16,0,16,10,4,0
240,Jean-Ricner Bellegarde,40,27,18,19,3,13,21,61.9,8,16,3,13,22,6,0
241,Héctor Bellerín,20,13,7,11,2,11,29,37.9,18,20,4,16,19,27,1
242,Andrea Belotti,29,16,7,17,5,5,31,16.1,26,23,5,18,5,20,1
243,Fran Beltrán,31,19,15,12,4,11,35,31.4,24,14,1,13,14,17,0
244,Sami Ben Amar,1,1,0,0,1,1,1,100.0,0,1,0,1,1,0,0
245,Hatem Ben Arfa,0,0,0,0,0,0,4,0.0,4,1,0,1,0,0,0
246,Wissam Ben Yedder,22,16,2,12,8,8,19,42.1,11,12,0,12,4,1,0
247,Marco Benassi,18,12,9,5,4,10,24,41.7,14,11,1,10,4,9,0
248,Cristian Benavente,8,5,2,5,1,2,8,25.0,6,1,0,1,3,0,0
249,Lars Bender,42,26,17,20,5,19,38,50.0,19,32,6,26,24,30,0
250,Sven Bender,53,34,29,17,7,23,48,47.9,25,42,13,29,67,88,2
251,Darío Benedetto,12,9,0,9,3,3,18,16.7,15,15,2,13,3,23,1
252,László Bénes,15,8,3,5,7,6,19,31.6,13,6,2,4,8,3,1
253,Walter Benítez,1,1,1,0,0,1,3,33.3,2,0,0,0,0,8,0
254,Loris Benito,40,25,23,11,6,16,43,37.2,27,14,5,9,29,58,1
255,Bilal Benkhedim,3,3,1,1,1,1,4,25.0,3,1,0,1,1,0,0
256,Ismaël Bennacer,67,47,21,34,12,29,73,39.7,44,25,7,18,54,15,2
257,Ryan Bennett,4,2,4,0,0,2,6,33.3,4,14,8,6,9,29,0
258,Ryan Bennett,5,4,3,2,0,4,6,66.7,2,3,1,2,7,8,0
259,Keanan Bennetts,0,0,0,0,0,0,1,0.0,1,0,0,0,0,0,0
260,Yassine Benrahou,3,0,1,1,1,2,5,40.0,3,1,0,1,2,1,0
261,Yassine Benrahou,13,8,3,3,7,5,16,31.3,11,1,0,1,2,0,0
262,Ramy Bensebaini,33,17,17,12,4,18,31,58.1,13,24,4,20,38,49,0
263,Nabil Bentaleb,23,13,14,9,0,7,25,28.0,18,9,2,7,19,9,1
264,Rodrigo Bentancur,58,32,27,18,13,31,66,47.0,35,44,9,35,32,34,1
265,Christian Benteke,9,5,1,6,2,0,10,0.0,10,11,4,7,4,28,1
266,Romario Benzar,2,2,1,1,0,2,3,66.7,1,1,0,1,0,2,0
267,Karim Benzema,18,8,3,11,4,2,16,12.5,14,16,4,12,7,30,1
268,Yassine Benzia,3,2,2,1,0,1,6,16.7,5,4,2,2,3,1,0
269,Domenico Berardi,32,16,19,8,5,13,59,22.0,46,31,3,28,33,27,0
270,Yuri Berchiche,48,35,32,15,1,21,40,52.5,19,26,4,22,30,73,1
271,Álex Berenguer,20,6,6,13,1,8,33,24.2,25,17,1,16,18,17,0
272,Bartosz Bereszyński,53,35,25,23,5,26,52,50.0,26,38,16,22,35,88,1
273,Jóhann Berg Guðmundsson,4,2,2,2,0,1,8,12.5,7,8,1,7,7,9,0
274,Markel Bergara,0,0,0,0,0,0,0,,0,0,0,0,0,2,0
275,Sander Berge,22,15,3,14,5,5,10,50.0,5,15,1,14,10,16,0
276,Steven Bergwijn,10,6,3,6,1,4,12,33.3,8,12,0,12,1,5,0
277,Robert Berić,3,2,0,2,1,0,5,0.0,5,2,0,2,4,2,0
278,Etrit Berisha,3,2,3,0,0,2,3,66.7,1,0,0,0,1,9,0
279,Valon Berisha,1,1,0,1,0,1,2,50.0,1,0,0,0,0,1,0
280,Valon Berisha,14,9,3,8,3,6,21,28.6,15,4,1,3,9,8,0
281,Sergio Bermejo,0,0,0,0,0,0,0,,0,0,0,0,0,0,0
282,Bernard,32,22,12,14,6,13,44,29.5,31,22,2,20,16,7,0
283,Federico Bernardeschi,13,5,4,5,4,5,25,20.0,20,11,0,11,13,12,1
284,Bernardo,27,16,12,9,6,13,17,76.5,4,7,3,4,6,24,0
285,Paul Bernardoni,0,0,0,0,0,0,1,0.0,1,0,0,0,0,11,1
286,Juan Bernat,42,27,19,16,7,20,51,39.2,31,13,1,12,10,26,0
287,Dimitry Bertaud,0,0,0,0,0,0,0,,0,0,0,0,0,0,0
288,Andrea Bertolacci,7,4,2,3,2,1,8,12.5,7,4,1,3,2,13,0
289,Ryan Bertrand,47,29,22,15,10,26,58,44.8,32,27,12,15,37,31,1
290,Muhamed Bešić,8,6,4,4,0,2,5,40.0,3,4,0,4,1,6,0
291,Jordan Beyer,3,1,3,0,0,0,1,0.0,1,4,2,2,1,4,0
292,Ermin Bičakčić,7,3,5,2,0,4,11,36.4,7,14,8,6,25,64,2
293,Pedro Bigas,18,9,11,7,0,9,19,47.4,10,16,10,6,36,82,0
294,Lucas Biglia,13,7,7,6,0,4,15,26.7,11,12,4,8,7,10,1
295,El Bilal Touré,3,3,1,0,2,0,0,,0,6,0,6,1,1,0
296,Philip Billing,72,46,30,37,5,17,65,26.2,48,59,16,43,66,97,1
297,Cristiano Biraghi,22,6,10,8,4,10,24,41.7,14,21,7,14,13,41,0
298,Davide Biraschi,32,17,17,13,2,15,26,57.7,11,22,12,10,34,69,0
299,Valter Birsa,10,6,3,6,1,7,21,33.3,14,6,1,5,4,3,0
300,Dimitri Bisoli,64,35,34,20,10,30,49,61.2,19,41,7,34,25,49,0
301,Yves Bissouma,49,38,24,22,3,17,40,42.5,23,18,2,16,21,23,0
302,Leonardo Bittencourt,1,1,0,0,1,0,0,,0,0,0,0,0,0,0
303,Leonardo Bittencourt,52,28,23,18,11,9,51,17.6,42,20,3,17,12,14,0
304,Birkir Bjarnason,5,3,1,3,1,2,13,15.4,11,9,4,5,5,4,0
305,Rubén Blanco,1,1,1,0,0,1,1,100.0,0,0,0,0,0,14,1
306,Ludovic Blas,26,18,7,15,4,5,26,19.2,21,17,1,16,14,11,0
307,Pablo de Blasis,41,32,22,13,6,30,63,47.6,33,13,0,13,24,21,0
308,Alejandro Blesa,0,0,0,0,0,0,1,0.0,1,0,0,0,0,0,0
309,Alexis Blin,39,25,18,15,6,20,61,32.8,41,25,6,19,16,49,0
310,Jérôme Boateng,21,14,9,12,0,11,22,50.0,11,15,11,4,33,58,1
311,Kevin-Prince Boateng,3,1,0,2,1,2,8,25.0,6,3,0,3,1,7,0
312,Antonin Bobichon,4,3,1,3,0,3,3,100.0,0,1,0,1,1,0,0
313,Antonin Bobichon,9,4,4,5,0,2,19,10.5,17,7,0,7,7,4,0
314,Salvatore Bocchetti,5,3,3,2,0,2,3,66.7,1,2,2,0,17,23,0
315,Mathieu Bodmer,0,0,0,0,0,0,1,0.0,1,1,1,0,1,1,0
316,Adam Bodzek,42,26,21,20,1,14,46,30.4,32,34,11,23,25,39,0
317,Jean-Paul Boëtius,63,33,21,31,11,20,57,35.1,37,38,1,37,26,6,0
318,Sacha Boey,6,4,3,1,2,4,8,50.0,4,0,0,0,2,5,0
319,Jeremie Boga,12,7,3,8,1,6,20,30.0,14,24,0,24,3,4,0
320,Melayro Bogarde,2,1,2,0,0,2,2,100.0,0,0,0,0,0,3,0
321,Quentin Boisgard,31,19,10,14,7,14,35,40.0,21,11,0,11,12,4,1
322,Willy Boly,57,33,36,21,0,25,43,58.1,18,28,11,17,39,108,3
323,Giacomo Bonaventura,16,9,5,6,5,5,17,29.4,12,8,3,5,7,10,0
324,Federico Bonazzoli,7,5,1,4,2,0,7,0.0,7,3,0,3,5,2,0
325,Gaëtan Bong,1,0,0,0,1,0,0,,0,1,1,0,0,0,0
326,Kevin Bonifazi,9,8,6,3,0,5,6,83.3,1,3,2,1,5,10,0
327,Kevin Bonifazi,16,9,15,1,0,9,18,50.0,9,20,12,8,35,50,2
328,Federico Bonini,0,0,0,0,0,0,0,,0,0,0,0,0,0,0
329,Leonardo Bonucci,28,17,18,8,2,12,17,70.6,5,32,29,3,31,94,2
330,Fabio Borini,2,1,2,0,0,0,4,0.0,4,3,0,3,13,6,0
331,Fabio Borini,2,2,0,0,2,0,2,0.0,2,1,0,1,0,3,0
332,Dennis Borkowski,0,0,0,0,0,0,0,,0,0,0,0,0,0,0
333,Robin Bormuth,2,1,2,0,0,2,3,66.7,1,6,5,1,0,12,0
334,Sebastiaan Bornauw,37,24,24,12,1,20,39,51.3,19,32,12,20,42,99,0
335,Brandon Borrello,10,4,6,4,0,4,10,40.0,6,7,1,6,1,1,0
336,Gabriel Boschilia,3,1,0,3,0,1,5,20.0,4,1,1,0,2,2,0
337,Denis Bouanga,45,34,10,25,10,20,55,36.4,35,30,0,30,10,15,0
338,Hicham Boudaoui,20,10,6,11,3,9,23,39.1,14,10,3,7,13,7,0
339,Ryad Boudebouz,25,16,9,14,2,8,25,32.0,17,14,1,13,7,5,0
340,Sofiane Boufal,16,8,6,5,5,6,15,40.0,9,17,0,17,4,1,0
341,Nassim Boujellab,12,10,5,4,3,5,14,35.7,9,8,1,7,7,5,0
342,Farid Boulaya,14,10,7,4,3,7,19,36.8,12,5,0,5,6,3,0
343,Yassine Bounou,0,0,0,0,0,0,0,,0,0,0,0,0,0,0
344,Mehdi Bourabia,19,9,8,10,1,9,22,40.9,13,12,2,10,22,23,0
345,Benjamin Bourigeaud,40,12,18,20,2,17,68,25.0,51,38,7,31,20,25,0
346,Bilal Boutobba,0,0,0,0,0,0,1,0.0,1,0,0,0,0,0,0
347,Jarrod Bowen,19,15,7,9,3,4,17,23.5,13,6,0,6,16,8,0
348,Dedryck Boyata,24,18,17,5,2,4,12,33.3,8,39,32,7,62,158,1
349,John Boye,30,19,25,5,0,19,32,59.4,13,31,18,13,31,116,0
350,Can Bozdogan,8,6,5,3,0,3,12,25.0,9,2,0,2,2,2,0
351,Domagoj Bradarić,28,11,9,17,2,12,27,44.4,15,16,3,13,22,28,0
352,Filip Bradarić,12,9,5,5,2,3,8,37.5,5,12,3,9,17,19,0
353,Robbie Brady,11,9,5,4,2,3,10,30.0,7,10,2,8,5,8,0
354,Martin Braithwaite,2,2,2,0,0,0,8,0.0,8,3,0,3,1,1,0
355,Martin Braithwaite,13,7,4,5,4,4,12,33.3,8,10,2,8,4,9,0
356,Federico Brancolini,0,0,0,0,0,0,0,,0,0,0,0,0,0,0
357,Brandon,5,3,1,3,1,0,5,0.0,5,4,0,4,0,1,0
358,Julian Brandt,48,33,15,21,12,25,55,45.5,30,35,2,33,16,10,1
359,Jarrad Branthwaite,8,7,5,3,0,3,5,60.0,2,6,3,3,2,12,0
360,Darko Brašanac,45,25,14,26,5,15,41,36.6,26,19,4,15,20,21,0
361,Claudio Bravo,0,0,0,0,0,0,0,,0,0,0,0,0,1,1
362,Josip Brekalo,18,8,5,6,7,5,23,21.7,18,26,0,26,16,4,0
363,Gleison Bremer,63,36,37,20,6,20,34,58.8,14,48,22,26,74,118,1
364,Marco Brescianini,1,1,1,0,0,0,0,,0,0,0,0,2,0,0
365,Anthony Briançon,29,19,20,9,0,17,34,50.0,17,22,16,6,39,80,0
366,Jimmy Briand,12,8,5,4,3,3,13,23.1,10,8,4,4,6,12,0
367,Yan Brice Eteki,37,21,14,18,5,15,31,48.4,16,17,4,13,24,20,1
368,Armando Broja,0,0,0,0,0,0,0,,0,0,0,0,0,0,0
369,Dylan Bronn,7,5,6,1,0,4,7,57.1,3,11,9,2,6,42,0
370,David Brooks,5,5,1,2,2,2,14,14.3,12,5,1,4,2,1,0
371,John Brooks,38,27,27,9,2,24,49,49.0,25,31,12,19,41,93,0
372,Daniel Brosinski,40,27,13,23,4,15,34,44.1,19,16,2,14,14,58,0
373,Josh Brownhill,14,8,5,7,2,5,13,38.5,8,9,4,5,14,18,0
374,Marcelo Brozović,67,35,26,31,10,19,71,26.8,52,26,9,17,46,46,2
375,Gastón Brugman,47,24,25,15,7,19,46,41.3,27,33,15,18,27,19,2
376,Jeffrey Bruma,9,5,4,5,0,7,13,53.8,6,6,3,3,13,51,1
377,Jeffrey Bruma,12,8,8,4,0,4,6,66.7,2,11,5,6,6,34,1
378,Jacob Bruun Larsen,3,2,3,0,0,3,8,37.5,5,3,0,3,3,1,0
379,Jacob Bruun Larsen,0,0,0,0,0,0,0,,0,0,0,0,0,0,0
380,Lucas Buadés,4,4,3,1,0,1,5,20.0,4,0,0,0,1,3,0
381,Ante Budimir,31,15,4,22,5,7,29,24.1,22,21,4,17,8,29,0
382,Emi Buendía,82,39,57,21,4,38,118,32.2,80,58,5,53,23,32,2
383,Gianluigi Buffon,0,0,0,0,0,0,0,,0,0,0,0,0,3,1
384,Marius Bülter,38,22,19,13,6,17,54,31.5,37,37,3,34,11,20,1
385,Esteban Burgos,11,9,9,2,0,5,9,55.6,4,11,6,5,17,66,2
386,Guido Burgstaller,7,3,0,5,2,4,15,26.7,11,12,3,9,4,10,0
387,Burgui,0,0,0,0,0,0,0,,0,0,0,0,0,0,0
388,Jonathan Burkardt,9,4,2,5,2,3,8,37.5,5,6,1,5,0,1,0
389,Oliver Burke,19,14,8,9,2,10,23,43.5,13,24,0,24,8,16,0
390,Roman Bürki,2,2,2,0,0,2,3,66.7,1,1,0,1,2,13,1
391,Dan Burn,67,42,35,27,5,25,53,47.2,28,44,20,24,42,130,0
392,Patrick Burner,35,25,15,17,3,14,25,56.0,11,11,2,9,30,37,0
393,Sergio Busquets,80,44,23,43,14,41,71,57.7,30,36,5,31,44,24,2
394,Unai Bustinza,66,40,40,19,7,32,53,60.4,21,30,9,21,65,77,0
395,Ludovic Butelle,1,1,1,0,0,1,2,50.0,1,1,0,1,0,10,4
396,Marcin Bułka,0,0,0,0,0,0,0,,0,0,0,0,0,0,0
397,Sam Byram,40,22,24,11,5,18,37,48.6,19,16,8,8,26,73,0
398,Erick Cabaco,3,2,1,2,0,0,3,0.0,3,1,1,0,3,11,0
399,Erick Cabaco,12,9,9,3,0,4,6,66.7,2,12,7,5,12,50,1
400,Willy Caballero,0,0,0,0,0,0,0,,0,0,0,0,0,3,0
401,Yohan Cabaye,29,18,11,14,4,14,25,56.0,11,10,0,10,22,7,1
402,Manuel Cabit,3,1,1,2,0,2,10,20.0,8,5,0,5,4,5,0
403,Ariday Cabrera,1,1,1,0,0,0,1,0.0,1,2,0,2,0,0,0
404,Leandro Cabrera,10,6,5,5,0,5,12,41.7,7,10,4,6,21,66,0
405,Leandro Cabrera,27,11,17,9,1,17,28,60.7,11,19,12,7,21,78,1
406,Fabrizio Cacciatore,14,4,9,4,1,6,9,66.7,3,10,6,4,16,44,0
407,Martín Cáceres,47,31,34,11,2,16,34,47.1,18,29,13,16,31,74,2
408,Anthony Caci,29,17,19,9,1,8,17,47.1,9,15,5,10,19,15,1
409,Jhonder Cádiz,16,8,6,7,3,3,7,42.9,4,4,2,2,1,9,0
410,Mathieu Cafaro,12,6,5,5,2,6,17,35.3,11,13,0,13,2,0,0
411,Jonathan Cafu,7,3,4,3,0,4,7,57.1,3,1,0,1,1,3,0
412,Gary Cahill,15,8,11,4,0,7,15,46.7,8,34,25,9,18,114,1
413,Felipe Caicedo,17,10,4,7,6,2,11,18.2,9,9,1,8,4,2,0
414,Arturo Calabresi,53,33,29,20,4,33,75,44.0,42,24,11,13,29,60,0
415,Davide Calabria,52,33,28,22,2,17,41,41.5,24,23,5,18,21,47,1
416,Riccardo Calafiori,0,0,0,0,0,0,1,0.0,1,0,0,0,2,0,0
417,Mattia Caldara,21,11,12,8,1,5,11,45.5,6,9,5,4,30,22,1
418,Marco Calderoni,38,25,22,13,3,20,39,51.3,19,27,10,17,37,54,1
419,Fernando Calero,14,9,10,4,0,7,15,46.7,8,13,5,8,8,42,1
420,Duje Ćaleta-Car,29,15,17,11,1,18,26,69.2,8,17,6,11,26,98,0
421,Hakan Çalhanoğlu,42,21,15,21,6,12,35,34.3,23,26,2,24,26,26,1
422,Daniel Caligiuri,58,37,18,25,15,27,74,36.5,47,67,6,61,25,39,0
423,José Callejón,13,9,3,7,3,9,25,36.0,16,15,3,12,10,14,1
424,Jonathan Calleri,12,8,6,4,2,3,24,12.5,21,11,3,8,7,22,0
425,Dominic Calvert-Lewin,7,5,1,4,2,1,10,10.0,9,15,2,13,6,36,0
426,Mahdi Camara,33,20,12,16,5,18,32,56.3,14,20,2,18,18,5,0
427,Souleymane Camara,0,0,0,0,0,0,2,0.0,2,0,0,0,0,1,0
428,Víctor Camarasa,0,0,0,0,0,0,0,,0,0,0,0,0,0,0
429,Víctor Camarasa,18,10,5,10,3,7,18,38.9,11,8,3,5,15,12,0
430,Eduardo Camavinga,105,64,45,56,4,48,96,50.0,48,26,8,18,34,35,0
431,Sergio Camello,0,0,0,0,0,0,0,,0,0,0,0,0,0,0
432,José Campaña,38,25,15,13,10,13,53,24.5,40,30,5,25,44,42,2
433,Xisco Campos,7,4,5,2,0,5,9,55.6,4,8,5,3,11,23,0
434,Víctor Campuzano,12,9,1,6,5,3,19,15.8,16,8,0,8,2,4,0
435,Emre Can,10,7,5,3,2,3,10,30.0,7,4,0,4,2,3,0
436,Emre Can,19,12,11,7,1,5,12,41.7,7,14,6,8,19,15,0
437,Sergio Canales,25,16,14,6,5,7,28,25.0,21,30,1,29,13,16,0
438,João Cancelo,40,24,21,12,7,24,40,60.0,16,9,2,7,21,18,0
439,Antonio Candreva,11,6,9,1,1,7,29,24.1,22,26,10,16,14,33,1
440,Gianmarco Cangiano,1,1,0,1,0,0,0,,0,0,0,0,1,0,0
441,Todd Cantwell,51,31,19,27,5,26,73,35.6,47,38,2,36,18,35,1
442,Ander Capa,64,36,37,21,6,24,59,40.7,35,26,7,19,28,63,0
443,Pierrick Capelle,42,32,18,16,8,16,48,33.3,32,17,3,14,21,28,0
444,Étienne Capoue,75,40,38,30,7,37,85,43.5,48,30,11,19,68,61,0
445,Gianluca Caprari,9,7,1,6,2,4,13,30.8,9,5,0,5,7,1,0
446,Gianluca Caprari,1,1,0,1,0,0,5,0.0,5,7,2,5,4,2,0
447,Francesco Caputo,7,4,3,2,2,3,11,27.3,8,15,0,15,1,8,0
448,Maxence Caqueret,24,15,10,13,1,11,25,44.0,14,14,2,12,9,6,1
449,Andrea Carboni,8,4,3,5,0,3,4,75.0,1,6,6,0,7,20,0
450,Irvin Cardona,13,8,5,6,2,9,32,28.1,23,8,0,8,1,7,0
451,Marc Cardona,1,0,0,1,0,0,8,0.0,8,3,1,2,2,2,0
452,Diego Carlos,35,23,25,9,1,15,25,60.0,10,33,24,9,37,176,1
453,Lionel Carole,23,8,15,6,2,13,17,76.5,4,2,1,1,19,22,0
454,Yannick Carrasco,11,7,4,4,3,7,21,33.3,14,9,0,9,5,2,0
455,Daniel Carriço,8,2,4,3,1,1,6,16.7,5,4,3,1,8,23,0
456,Guido Carrillo,13,10,3,6,4,2,14,14.3,12,9,1,8,3,22,0
457,Andy Carroll,5,3,3,2,0,2,8,25.0,6,2,1,1,2,24,1
458,Dani Carvajal,65,46,33,25,7,23,42,54.8,19,43,14,29,36,53,0
459,Matis Carvalho,0,0,0,0,0,0,1,0.0,1,0,0,0,0,1,0
460,William Carvalho,7,4,4,2,1,4,14,28.6,10,7,5,2,4,8,1
461,Casemiro,96,60,43,45,8,39,99,39.4,60,53,10,43,68,72,0
462,Moreto Cassamã,17,11,2,13,2,5,7,71.4,2,7,2,5,5,6,0
463,Francesco Cassata,20,10,12,5,3,9,30,30.0,21,12,2,10,11,11,0
464,Timothy Castagne,31,20,9,16,6,13,25,52.0,12,34,5,29,17,23,0
465,Koen Casteels,0,0,0,0,0,0,0,,0,0,0,0,0,9,1
466,Jean-Charles Castelletto,18,9,13,5,0,9,18,50.0,9,20,16,4,33,87,1
467,Samu Castillejo,24,15,10,11,3,9,42,21.4,33,17,2,15,24,5,0
468,Jonny Castro,91,55,54,26,11,29,82,35.4,53,45,10,35,53,45,2
469,Lucas Castro,13,5,5,5,3,2,4,50.0,2,4,0,4,2,3,0
470,Lucas Castro,7,3,3,4,0,1,12,8.3,11,6,1,5,8,14,0
471,Gaetano Castrovilli,59,31,25,23,11,18,53,34.0,35,29,2,27,15,31,1
472,Danilo Cataldi,17,11,10,5,2,10,20,50.0,10,7,1,6,13,10,0
473,Craig Cathcart,41,26,25,15,1,10,24,41.7,14,19,16,3,25,136,1
474,Edinson Cavani,5,1,0,2,3,0,3,0.0,3,7,0,7,1,2,0
475,Santi Cazorla,48,25,14,21,13,20,57,35.1,37,23,1,22,19,16,2
476,Dani Ceballos,45,23,26,14,5,18,61,29.5,43,14,3,11,32,16,1
477,Federico Ceccherini,14,8,11,3,0,10,10,100.0,0,9,5,4,13,37,1
478,Christian Celesia,0,0,0,0,0,0,0,,0,0,0,0,0,0,0
479,Zeki Çelik,53,28,18,28,7,27,60,45.0,33,24,4,20,26,39,0
480,Fabien Centonze,76,49,53,22,1,34,57,59.6,23,30,11,19,59,98,0
481,Luca Ceppitelli,22,15,16,6,0,6,11,54.5,5,23,17,6,23,66,2
482,Alberto Cerri,2,1,0,2,0,1,3,33.3,2,1,0,1,0,3,0
483,Alberto Cerri,3,1,1,0,2,2,6,33.3,4,1,0,1,2,4,0
484,Julian Chabot,11,7,6,5,0,6,11,54.5,5,3,2,1,15,26,0
485,Florian Chabrolle,0,0,0,0,0,0,0,,0,0,0,0,0,0,0
486,Fouad Chafik,32,21,22,7,3,17,36,47.2,19,12,5,7,26,36,0
487,Sofian Chakla,0,0,0,0,0,0,1,0.0,1,2,1,1,3,7,1
488,Nathaniel Chalobah,30,11,13,13,4,12,27,44.4,15,10,4,6,18,20,0
489,Calum Chambers,26,10,12,8,6,11,16,68.8,5,13,7,6,16,43,1
490,Jhon Chancellor,30,14,22,8,0,11,22,50.0,11,34,29,5,34,145,3
491,Timothy Chandler,22,10,9,8,5,9,16,56.3,7,9,4,5,13,21,0
492,Kwon Chang-hoon,7,4,2,3,2,1,10,10.0,9,5,1,4,7,14,0
493,Gaëtan Charbonnier,36,16,11,11,14,10,35,28.6,25,19,6,13,7,33,1
494,Brendan Chardonnet,12,6,10,2,0,7,12,58.3,5,8,5,3,15,50,0
495,Charles,10,5,0,6,4,4,22,18.2,18,7,2,5,7,6,0
496,Xavier Chavalerin,71,52,29,33,9,19,49,38.8,30,23,8,15,36,36,0
497,Pablo Chavarría,1,1,0,1,0,0,4,0.0,4,1,1,0,1,2,0
498,Aurélien Chedjou,27,19,18,9,0,10,22,45.5,12,15,11,4,40,120,3
499,Pape Cheikh Diop,10,4,6,3,1,2,12,16.7,10,4,2,2,5,3,0
500,Chema,4,3,1,3,0,1,2,50.0,1,1,0,1,5,12,0
501,Rayan Cherki,3,2,0,1,2,3,4,75.0,1,3,0,3,0,0,0
502,Denis Cheryshev,16,9,5,4,7,3,17,17.6,14,15,1,14,7,10,0
503,Giorgio Chiellini,3,0,3,0,0,1,1,100.0,0,2,2,0,1,9,0
504,Federico Chiesa,38,22,13,15,10,10,52,19.2,42,19,0,19,6,6,0
505,Ben Chilwell,43,26,28,13,2,23,52,44.2,29,30,6,24,28,68,2
506,Vlad Chiricheș,14,9,12,2,0,7,10,70.0,3,13,8,5,11,28,2
507,Tahith Chong,0,0,0,0,0,0,0,,0,0,0,0,0,0,0
508,Joris Chotard,30,18,13,17,0,15,35,42.9,20,12,5,7,20,12,1
509,Hamza Choudhury,17,8,7,8,2,3,25,12.0,22,15,6,9,24,13,0
510,Mounir Chouiar,36,23,13,18,5,12,42,28.6,30,8,0,8,13,13,0
511,Andreas Christensen,38,21,25,12,1,15,21,71.4,6,12,8,4,29,56,0
512,Samuel Chukwueze,23,14,12,6,5,13,30,43.3,17,15,1,14,10,14,1
513,Darko Churlinov,1,1,1,0,0,1,2,50.0,1,0,0,0,1,0,0
514,Churripi,1,1,1,0,0,1,1,100.0,0,0,0,0,0,2,0
515,Luca Cigarini,37,20,23,13,1,16,40,40.0,24,28,10,18,20,29,0
516,Per Ciljan Skjelbred,50,30,18,29,3,17,41,41.5,24,14,3,11,23,17,0
517,Jasper Cillessen,0,0,0,0,0,0,1,0.0,1,0,0,0,3,3,1
518,Thiago Cionek,53,32,36,12,5,22,53,41.5,31,30,11,19,46,91,2
519,Ibrahim Cissé,1,1,1,0,0,0,0,,0,0,0,0,0,6,0
520,Ibrahim Cissé,2,1,0,2,0,0,0,,0,0,0,0,0,2,0
521,Andrea Cistana,20,8,13,7,0,6,17,35.3,11,38,34,4,33,96,1
522,Ciaran Clark,20,12,18,2,0,9,15,60.0,6,18,14,4,11,82,0
523,Leon Clarke,0,0,0,0,0,0,0,,0,0,0,0,0,2,0
524,Alexis Claude-Maurice,26,16,8,11,7,13,35,37.1,22,20,4,16,11,4,0
525,Christian Clemens,0,0,0,0,0,0,0,,0,1,1,0,0,0,0
526,Óscar Clemente,0,0,0,0,0,0,0,,0,1,0,1,0,0,0
527,Yannis Clementia,0,0,0,0,0,0,0,,0,0,0,0,0,0,0
528,Denilho Cleonise,1,0,1,0,0,0,0,,0,0,0,0,1,0,0
529,Carlos Clerc,28,16,14,13,1,12,20,60.0,8,22,9,13,22,61,0
530,Tom Cleverley,28,15,8,14,6,9,36,25.0,27,13,1,12,10,15,0
531,Conor Coady,36,23,30,6,0,15,30,50.0,15,22,15,7,28,119,2
532,Marcus Coco,1,0,1,0,0,1,1,100.0,0,0,0,0,0,0,0
533,Renaud Cohade,28,20,11,12,5,12,28,42.9,16,14,3,11,8,6,0
534,Coke,25,18,14,8,3,14,30,46.7,16,9,2,7,13,19,0
535,Séamus Coleman,42,31,24,14,4,19,25,76.0,6,21,9,12,24,43,1
536,Álex Collado,0,0,0,0,0,0,0,,0,0,0,0,0,0,0
537,Ebrima Colley,2,1,1,0,1,1,2,50.0,1,1,0,1,1,0,0
538,Omar Colley,42,26,27,14,1,12,24,50.0,12,33,22,11,59,155,1
539,Jamilu Collins,69,43,44,21,4,37,62,59.7,25,53,19,34,70,91,1
540,Simone Colombi,0,0,0,0,0,0,0,,0,0,0,0,0,1,0
541,Lorenzo Colombo,0,0,0,0,0,0,0,,0,0,0,0,0,0,0
542,Racine Coly,21,13,15,5,1,9,17,52.9,8,5,0,5,12,23,0
543,Kingsley Coman,19,11,6,7,6,12,27,44.4,15,9,0,9,4,3,0
544,Daniel Congré,37,27,20,16,1,18,38,47.4,20,8,7,1,47,66,1
545,Aaron Connolly,7,6,1,4,2,3,10,30.0,7,11,0,11,0,3,0
546,Andrea Consigli,0,0,0,0,0,0,1,0.0,1,0,0,0,4,19,2
547,Andrea Conti,41,25,23,15,3,21,49,42.9,28,21,8,13,43,42,1
548,Lewis Cook,27,14,15,9,3,10,47,21.3,37,17,5,12,17,17,1
549,Steve Cook,22,11,18,4,0,8,20,40.0,12,32,23,9,44,153,1
550,Francis Coquelin,37,21,25,11,1,16,38,42.1,22,19,9,10,38,25,0
551,Gabriele Corbo,1,1,1,0,0,0,3,0.0,3,2,2,0,4,5,0
552,Sébastien Corchia,2,1,2,0,0,2,4,50.0,2,5,2,3,5,8,0
553,Iñigo Córdoba,33,20,16,12,5,14,52,26.9,38,30,2,28,16,13,0
554,Jhon Córdoba,9,6,1,5,3,3,13,23.1,10,19,1,18,5,17,0
555,Sergio Córdova,3,0,0,2,1,1,10,10.0,9,0,0,0,0,3,0
556,Benjamin Corgnet,1,1,1,0,0,1,3,33.3,2,2,0,2,2,3,0
557,Jack Cork,35,24,10,20,5,12,62,19.4,50,34,12,22,28,49,0
558,Andreas Cornelius,9,4,2,5,2,4,11,36.4,7,7,0,7,2,26,0
559,Maxwel Cornet,30,19,18,8,4,13,23,56.5,10,16,1,15,21,19,1
560,Quentin Cornette,8,3,3,2,3,3,9,33.3,6,7,1,6,6,5,0
561,Ángel Correa,25,9,7,9,9,9,36,25.0,27,23,5,18,14,21,0
562,Joaquín Correa,13,7,3,7,3,5,24,20.8,19,5,1,4,7,10,0
563,Rober Correa,13,6,8,3,2,6,10,60.0,4,6,4,2,16,31,0
564,Edmilson Correia,0,0,0,0,0,0,1,0.0,1,1,0,1,1,0,0
565,Thierry Correia,8,3,5,3,0,1,2,50.0,1,5,0,5,2,10,0
566,Antonio Cortés,1,1,0,1,0,0,1,0.0,1,0,0,0,0,2,0
567,Danny da Costa,26,17,14,8,4,6,16,37.5,10,16,1,15,15,26,0
568,Diego Costa,9,5,1,4,4,1,10,10.0,9,4,2,2,3,10,0
569,Douglas Costa,2,1,1,1,0,1,12,8.3,11,7,0,7,5,5,0
570,Jaume Costa,27,23,17,8,2,14,28,50.0,14,11,6,5,24,52,1
571,Angelo da Costa Júnior,0,0,0,0,0,0,0,,0,0,0,0,0,0,0
572,Nuno da Costa,15,10,3,8,4,4,10,40.0,6,7,0,7,4,3,0
573,David Costas,4,3,3,1,0,2,4,50.0,2,3,3,0,8,12,0
574,Benoît Costil,0,0,0,0,0,0,3,0.0,3,0,0,0,2,9,0
575,Kalifa Coulibaly,11,7,0,5,6,3,5,60.0,2,3,1,2,6,32,0
576,Senou Coulibaly,14,7,11,3,0,2,4,50.0,2,11,10,1,10,44,1
577,Yoann Court,48,26,28,17,3,20,64,31.3,44,21,0,21,15,14,0
578,Thibaut Courtois,0,0,0,0,0,0,2,0.0,2,0,0,0,2,18,2
579,Philippe Coutinho,21,15,1,13,7,2,13,15.4,11,9,2,7,6,0,0
580,Nicolas Cozza,5,5,3,2,0,2,3,66.7,1,8,6,2,9,18,0
581,Alessio Cragno,0,0,0,0,0,0,0,,0,0,0,0,0,10,0
582,Aaron Cresswell,43,26,21,18,4,23,46,50.0,23,33,10,23,35,75,2
583,Domenico Criscito,53,33,34,12,7,24,56,42.9,32,25,13,12,53,81,1
584,Bryan Cristante,25,15,6,14,5,8,27,29.6,19,13,4,9,22,23,0
585,Sebastián Cristóforo,5,5,2,2,1,1,5,20.0,4,2,1,1,1,0,0
586,Sebastián Cristóforo,35,19,11,14,10,13,32,40.6,19,25,3,22,8,2,0
587,Juan Cuadrado,67,43,32,28,7,35,62,56.5,27,22,8,14,35,47,0
588,Cucho,15,8,6,8,1,6,21,28.6,15,14,1,13,10,15,0
589,Marc Cucurella,74,51,23,38,13,24,76,31.6,52,58,8,50,36,28,1
590,Iván Cuéllar,0,0,0,0,0,0,2,0.0,2,0,0,0,0,28,2
591,Jaume Cuéllar,1,0,0,0,1,0,1,0.0,1,0,0,0,0,0,0
592,Mickaël Cuisance,2,1,0,2,0,1,9,11.1,8,1,1,0,3,0,0
593,Matheus Cunha,10,5,6,4,0,4,11,36.4,7,11,1,10,10,1,0
594,Matheus Cunha,6,2,0,1,5,0,2,0.0,2,5,1,4,1,0,0
595,Felipe Curcio,0,0,0,0,0,0,0,,0,0,0,0,0,0,0
596,Patrick Cutrone,4,2,2,1,1,1,5,20.0,4,1,1,0,2,1,0
597,Patrick Cutrone,4,2,2,1,1,1,15,6.7,14,6,1,5,2,6,0
598,Wylan Cyprien,17,11,5,12,0,7,27,25.9,20,8,2,6,19,16,3
599,Rafael Czichos,43,34,26,16,1,22,45,48.9,23,24,13,11,35,110,1
600,Lennart-Marten Czyborra,0,0,0,0,0,0,0,,0,2,0,2,0,0,0
601,Marco D'Alessandro,11,8,5,3,3,5,8,62.5,3,11,0,11,5,6,0
602,Danilo D'Ambrosio,30,16,16,12,2,16,33,48.5,17,15,4,11,14,25,0
603,Felice D'Amico,1,1,0,0,1,0,0,,0,0,0,0,0,0,0
604,Lucas Da Cunha,1,0,1,0,0,1,1,100.0,0,0,0,0,0,0,0
605,Jacopo Da Riva,0,0,0,0,0,0,0,,0,0,0,0,0,0,0
606,Damien Da Silva,27,14,20,5,2,10,19,52.6,9,21,13,8,26,143,1
607,Moanes Dabbur,1,1,0,0,1,0,0,,0,1,0,1,0,0,0
608,Moanes Dabbur,8,5,1,3,4,3,10,30.0,7,6,2,4,4,1,0
609,Bryan Dabo,18,10,13,4,1,5,15,33.3,10,13,2,11,9,14,0
610,Colin Dagba,10,4,2,4,4,5,9,55.6,4,6,1,5,6,9,0
611,Mahmoud Dahoud,10,6,4,4,2,6,18,33.3,12,8,2,6,8,4,0
612,Leon Dajaku,0,0,0,0,0,0,1,0.0,1,0,0,0,0,0,0
613,Felipe dal Belo,13,6,9,4,0,9,15,60.0,6,14,12,2,9,30,0
614,Christian Dalle Mura,0,0,0,0,0,0,0,,0,0,0,0,0,0,0
615,Diogo Dalot,3,2,3,0,0,3,4,75.0,1,1,0,1,2,1,0
616,Charlie Daniels,1,1,0,1,0,0,1,0.0,1,2,0,2,1,5,1
617,Danilo,30,20,16,12,2,18,30,60.0,12,12,3,9,26,44,0
618,Arnaut Danjuma,4,2,3,1,0,1,4,25.0,3,2,0,2,8,4,1
619,Scott Dann,8,4,7,1,0,8,14,57.1,6,9,7,2,14,67,0
620,Kevin Danso,6,4,3,3,0,4,7,57.1,3,7,3,4,2,7,0
621,Dante,34,21,24,10,0,17,25,68.0,8,27,16,11,26,79,0
622,Andrea Danzi,0,0,0,0,0,0,0,,0,0,0,0,0,0,0
623,Sergi Darder,47,23,11,26,10,17,58,29.3,41,30,1,29,24,23,1
624,Vladimír Darida,50,27,14,31,5,11,48,22.9,37,44,7,37,27,19,2
625,Matteo Darmian,81,42,48,30,3,40,83,48.2,43,38,16,22,25,78,1
626,Alphonso Davies,70,43,35,24,11,38,58,65.5,20,35,6,29,31,51,0
627,Ben Davies,28,15,13,11,4,7,21,33.3,14,28,12,16,22,47,0
628,Tom Davies,38,17,12,22,4,17,55,30.9,38,12,4,8,35,28,0
629,Keinan Davis,1,1,0,1,0,0,3,0.0,3,4,0,4,0,3,0
630,Paweł Dawidowicz,15,12,11,4,0,5,11,45.5,6,6,5,1,12,26,0
631,Craig Dawson,29,18,16,13,0,17,31,54.8,14,41,32,9,34,116,0
632,Kevin De Bruyne,45,24,8,20,17,18,66,27.3,48,26,4,22,18,24,2
633,Sebastien De Maio,18,11,11,7,0,7,11,63.6,4,28,20,8,32,86,2
634,Rodrigo De Paul,61,31,31,26,4,27,65,41.5,38,38,3,35,29,8,1
635,Mattia De Sciglio,10,8,6,4,0,6,14,42.9,8,5,2,3,8,18,1
636,Lorenzo De Silvestri,15,8,4,7,4,11,27,40.7,16,20,7,13,19,72,0
637,Lucas Deaux,49,26,16,29,4,16,45,35.6,29,20,4,16,15,19,0
638,Mathieu Debuchy,44,26,22,15,7,24,47,51.1,23,21,11,10,43,59,0
639,Troy Deeney,19,12,6,10,3,6,29,20.7,23,13,1,12,11,27,0
640,Grégoire Defrel,12,8,4,6,2,4,15,26.7,11,9,0,9,3,5,0
641,Alessandro Deiola,0,0,0,0,0,0,0,,0,0,0,0,1,0,0
642,Alessandro Deiola,16,9,9,7,0,9,24,37.5,15,12,4,8,8,14,1
643,Romain Del Castillo,20,14,5,11,4,6,27,22.2,21,12,2,10,7,7,0
644,Thomas Delaine,25,16,18,6,1,12,21,57.1,9,17,1,16,15,28,0
645,Thomas Delaney,22,10,10,11,1,9,15,60.0,6,16,7,9,26,26,0
646,Paul Delecroix,0,0,0,0,0,0,0,,0,0,0,0,0,0,0
647,Cristian Dell'Orco,22,12,14,7,1,8,14,57.1,6,11,7,4,16,33,0
648,Andy Delort,28,18,11,9,8,7,27,25.9,20,21,6,15,3,10,0
649,Fabian Delph,26,12,10,13,3,9,22,40.9,13,12,3,9,15,19,1
650,Moussa Dembélé,12,7,2,5,5,4,14,28.6,10,14,3,11,5,31,0
651,Ousmane Dembélé,2,2,1,1,0,2,5,40.0,3,4,0,4,0,0,1
652,Merih Demiral,8,7,5,3,0,1,3,33.3,2,4,3,1,4,16,1
653,Kerem Demirbay,35,19,10,21,4,12,31,38.7,19,19,5,14,22,7,1
654,Diego Demme,18,8,14,3,1,8,23,34.8,15,9,1,8,8,9,0
655,Diego Demme,41,18,17,19,5,17,42,40.5,25,14,2,12,15,14,0
656,Jason Denayer,17,13,12,5,0,10,14,71.4,4,32,29,3,20,83,0
657,Leander Dendoncker,68,31,41,19,8,28,67,41.8,39,39,12,27,38,64,2
658,Kévin Denkey,10,5,1,8,1,6,10,60.0,4,7,0,7,2,1,1
659,Stefano Denswil,49,28,29,19,1,26,44,59.1,18,23,8,15,31,68,0
660,Fabio Depaoli,41,28,26,10,5,17,31,54.8,14,29,3,26,16,39,0
661,Kastriot Dermaku,13,5,10,3,0,3,5,60.0,2,20,16,4,12,61,1
662,Daniele Dessena,21,11,5,14,2,6,25,24.0,19,11,1,10,11,21,0
663,Mattia Destro,3,2,1,2,0,1,3,33.3,2,1,0,1,0,0,0
664,Mattia Destro,0,0,0,0,0,0,0,,0,0,0,0,0,1,0
665,Gerard Deulofeu,33,16,18,9,6,12,59,20.3,47,10,0,10,25,6,0
666,Deyverson,0,0,0,0,0,0,1,0.0,1,2,1,1,0,5,0
667,Samuel Di Carmine,2,1,0,0,2,0,8,0.0,8,3,0,3,1,10,0
668,Federico Di Francesco,11,5,2,6,3,3,15,20.0,12,9,1,8,3,2,1
669,Giovanni Di Lorenzo,59,35,27,19,13,32,61,52.5,29,27,11,16,28,54,0
670,Ángel Di María,17,12,2,8,7,4,34,11.8,30,14,3,11,11,1,3
671,Boulaye Dia,15,9,7,6,2,3,10,30.0,7,9,2,7,7,16,0
672,Fousseni Diabaté,16,10,6,6,4,5,16,31.3,11,11,0,11,8,3,1
673,Moussa Diaby,10,8,3,7,0,5,15,33.3,10,6,0,6,9,4,0
674,Mouctar Diakhaby,11,8,7,3,1,5,8,62.5,3,17,15,2,11,73,0
675,Bafodé Diakité,23,19,15,8,0,7,13,53.8,6,18,9,9,20,75,0
676,Abdou Diallo,20,11,9,10,1,8,14,57.1,6,9,5,4,10,32,0
677,Amad Diallo,1,1,0,1,0,0,0,,0,0,0,0,0,0,0
678,Habib Diallo,2,1,0,2,0,0,6,0.0,6,6,5,1,4,43,0
679,Ibrahima Diallo,38,24,15,22,1,12,29,41.4,17,9,2,7,23,16,3
680,Moussa Diarra,3,3,2,1,0,1,1,100.0,0,0,0,0,3,2,0
681,Lucas Dias,1,1,1,0,0,1,1,100.0,0,0,0,0,0,2,0
682,Amadou Diawara,40,25,14,20,6,8,30,26.7,22,10,1,9,33,16,2
683,Brahim Díaz,1,0,0,1,0,0,2,0.0,2,2,0,2,0,0,0
684,Víctor Díaz,74,43,38,31,5,31,60,51.7,29,53,23,30,48,94,1
685,Bakaye Dibassy,26,14,17,8,1,15,20,75.0,5,29,18,11,37,78,2
686,Eric Dier,21,12,10,10,1,10,20,50.0,10,14,9,5,21,65,0
687,Lucas Digne,73,49,49,19,5,33,68,48.5,35,39,10,29,42,108,0
688,Mitchell Dijks,13,10,6,5,2,8,12,66.7,4,5,1,4,10,23,0
689,Javairô Dilrosun,15,8,11,1,3,5,13,38.5,8,20,0,20,18,10,0
690,Federico Dimarco,11,5,4,4,3,6,10,60.0,4,3,2,1,4,11,0
691,Federico Dimarco,1,0,0,1,0,0,0,,0,0,0,0,1,1,0
692,Tristan Dingomé,10,4,3,6,1,2,12,16.7,10,6,0,6,6,1,0
693,Lois Diony,15,5,0,11,4,5,9,55.6,4,3,0,3,1,0,0
694,Issa Diop,27,15,18,9,0,16,25,64.0,9,37,21,16,47,166,2
695,Papakouli Diop,39,26,13,22,4,18,42,42.9,24,24,7,17,34,38,0
696,Assane Dioussé,1,1,0,1,0,0,3,0.0,3,0,0,0,0,2,0
697,Axel Disasi,32,21,18,13,1,17,27,63.0,10,29,24,5,26,97,0
698,Tiago Djaló,9,4,5,3,1,2,7,28.6,5,3,2,1,11,28,0
699,Djené,42,32,27,15,0,17,30,56.7,13,20,7,13,34,105,1
700,Moussa Djenepo,27,21,13,9,5,11,21,52.4,10,15,1,14,9,9,0
701,Koffi Djidji,27,12,19,8,0,8,18,44.4,10,28,23,5,15,53,1
702,Alexander Djiku,46,32,27,19,0,21,29,72.4,8,14,8,6,55,82,4
703,Berat Djimsiti,42,23,17,23,2,22,39,56.4,17,21,14,7,49,92,0
704,Naïs Djouahra,0,0,0,0,0,0,0,,0,0,0,0,0,0,0
705,Marko Dmitrović,3,2,3,0,0,3,5,60.0,2,1,0,1,3,24,0
706,Matt Doherty,55,29,34,17,4,27,41,65.9,14,34,4,30,40,52,1
707,Kasper Dolberg,10,6,0,3,7,4,17,23.5,13,18,2,16,10,24,0
708,Keagan Dolly,6,3,1,3,2,2,5,40.0,3,1,0,1,1,0,0
709,Jaume Doménech,0,0,0,0,0,0,1,0.0,1,0,0,0,1,3,1
710,Nicolás Domínguez,21,14,15,5,1,7,18,38.9,11,12,2,10,12,7,0
711,Giulio Donati,32,21,22,8,2,15,28,53.6,13,19,10,9,25,42,0
712,Ji Dong-won,0,0,0,0,0,0,1,0.0,1,1,0,1,0,0,0
713,Anastasios Donis,3,2,2,1,0,1,9,11.1,8,2,0,2,1,3,0
714,Alfredo Donnarumma,17,9,3,9,5,6,18,33.3,12,7,0,7,5,1,0
715,Gianluigi Donnarumma,1,0,1,0,0,1,2,50.0,1,0,0,0,3,25,7
716,Mathieu Dossevi,32,20,7,17,8,15,30,50.0,15,17,0,17,14,7,0
717,Bas Dost,11,7,1,7,3,3,7,42.9,4,6,2,4,5,22,0
718,Abdoulaye Doucouré,64,30,29,29,6,16,57,28.1,41,46,8,38,31,32,0
719,Mamadou Doucouré,0,0,0,0,0,0,0,,0,0,0,0,0,0,0
720,Moussa Doumbia,16,8,5,6,5,7,24,29.2,17,14,1,13,9,5,0
721,Souleyman Doumbia,10,4,7,2,1,5,6,83.3,1,5,0,5,6,18,0
722,Souleyman Doumbia,1,1,1,0,0,1,1,100.0,0,2,2,0,0,3,0
723,Tommy Doyle,0,0,0,0,0,0,1,0.0,1,0,0,0,0,0,0
724,Mohamed Dräger,32,21,22,8,2,14,33,42.4,19,17,5,12,18,39,0
725,Aleksandar Dragović,18,11,11,6,1,10,21,47.6,11,9,3,6,15,39,0
726,Bartłomiej Drągowski,0,0,0,0,0,0,1,0.0,1,0,0,0,3,8,1
727,Julian Draxler,13,10,2,9,2,7,15,46.7,8,7,1,6,10,1,0
728,Dominick Drexler,34,25,12,19,3,8,32,25.0,24,11,5,6,26,11,0
729,Danny Drinkwater,5,3,3,2,0,2,18,11.1,16,5,0,5,5,5,1
730,Danny Drinkwater,2,1,1,1,0,0,1,0.0,1,0,0,0,1,0,0
731,Josip Drmić,3,2,1,2,0,0,8,0.0,8,6,0,6,1,5,1
732,Domingos Duarte,30,19,24,5,1,11,20,55.0,9,34,24,10,34,153,1
733,Léo Duarte,4,3,0,3,1,1,4,25.0,3,9,6,3,3,9,0
734,Óscar Duarte,12,3,11,1,0,3,4,75.0,1,7,6,1,6,29,0
735,Rubén Duarte,61,32,30,28,3,34,60,56.7,26,30,8,22,47,71,0
736,Edgaras Dubickas,0,0,0,0,0,0,0,,0,0,0,0,0,0,0
737,Leo Dubois,32,23,20,9,3,13,22,59.1,9,12,4,8,18,34,1
738,Martin Dúbravka,1,1,1,0,0,1,2,50.0,1,2,0,2,1,17,5
739,Ondrej Duda,18,11,9,6,3,7,16,43.8,9,10,2,8,6,8,0
740,Ondrej Duda,6,4,1,2,3,1,10,10.0,9,3,1,2,5,5,0
741,Shane Duffy,18,9,14,4,0,6,17,35.3,11,13,7,6,21,72,0
742,Haris Duljević,11,6,3,7,1,4,12,33.3,8,5,0,5,2,1,0
743,Paul Dummett,27,17,19,7,1,21,27,77.8,6,23,9,14,23,69,0
744,Alfred Duncan,12,9,11,1,0,2,19,10.5,17,4,0,4,5,12,0
745,Alfred Duncan,19,12,8,7,4,6,16,37.5,10,7,0,7,9,13,0
746,Lewis Dunk,40,24,23,17,0,15,34,44.1,19,55,33,22,55,125,2
747,Erik Durm,13,6,9,2,2,9,17,52.9,8,11,2,9,3,11,0
748,Riza Durmisi,1,1,1,0,0,0,0,,0,2,1,1,1,3,0
749,Hugo Duro,6,5,2,2,2,4,8,50.0,4,3,0,3,1,3,0
750,Jean-Kevin Duverne,12,8,5,6,1,2,6,33.3,4,23,8,15,20,50,0
751,Paulo Dybala,19,10,6,9,4,9,39,23.1,30,15,0,15,13,3,0
752,Edin Džeko,16,11,2,7,7,2,13,15.4,11,11,4,7,6,33,0
753,Blerim Džemaili,19,12,3,13,3,4,22,18.2,18,9,3,6,7,6,0
754,Bruno Ecuele Manga,22,15,17,5,0,9,20,45.0,11,34,23,11,37,112,2
755,Simone Edera,13,5,3,7,3,2,12,16.7,10,1,0,1,1,3,0
756,Ederson,2,2,2,0,0,2,5,40.0,3,0,0,0,3,16,6
757,John Egan,44,27,34,10,0,25,45,55.6,20,39,27,12,58,171,4
758,Johannes Eggestein,8,6,2,2,4,3,12,25.0,9,6,0,6,2,4,0
759,Maximilian Eggestein,40,28,20,18,2,15,43,34.9,28,37,8,29,36,57,0
760,Kingsley Ehizibue,79,53,44,30,5,33,53,62.3,20,28,8,20,39,79,1
761,Albin Ekdal,51,25,18,31,2,24,68,35.3,44,35,14,21,33,46,1
762,Harvey Elliott,0,0,0,0,0,0,0,,0,0,0,0,0,0,0
763,Elif Elmas,16,7,5,6,5,5,20,25.0,15,11,1,10,11,4,0
764,Ilay Elmkies,1,1,1,0,0,0,0,,0,0,0,0,0,0,0
765,Ahmed Elmohamady,19,9,10,7,2,10,21,47.6,11,11,5,6,13,25,1
766,Aritz Elustondo,28,17,19,8,1,13,23,56.5,10,21,8,13,15,67,0
767,Nico Elvedi,45,27,37,8,0,19,38,50.0,19,32,15,17,62,112,0
768,Rodrigo Ely,22,13,15,7,0,13,29,44.8,16,23,19,4,32,116,0
769,Adri Embarba,37,22,16,16,5,16,33,48.5,17,28,4,24,16,11,0
770,Breel Embolo,22,11,2,15,5,4,15,26.7,11,12,1,11,8,5,0
771,Emerson,74,46,49,19,6,36,79,45.6,43,30,9,21,31,57,1
772,Renaud Emond,3,1,0,2,1,1,5,20.0,4,0,0,0,0,7,0
773,Alan Empereur,16,8,11,4,1,6,10,60.0,4,19,12,7,22,36,0
774,Youssef En-Nesyri,9,7,1,2,6,3,17,17.6,14,15,2,13,5,22,0
775,Youssef En-Nesyri,7,5,1,6,0,3,10,30.0,7,9,3,6,5,7,0
776,Björn Engels,11,6,8,2,1,8,13,61.5,5,18,17,1,28,86,3
777,Sergi Enrich,17,6,4,8,5,4,21,19.0,17,16,2,14,9,12,0
778,Javier Eraso,11,5,4,5,2,5,15,33.3,10,5,0,5,7,5,0
779,Christian Eriksen,19,9,10,8,1,7,24,29.2,17,10,1,9,12,16,0
780,Christian Eriksen,11,6,2,8,1,5,20,25.0,15,3,0,3,0,0,0
781,Gonzalo Escalante,41,22,15,17,9,24,41,58.5,17,22,4,18,29,14,0
782,Aarón Escandell,1,1,1,0,0,1,1,100.0,0,0,0,0,0,0,0
783,Sergio Escudero,29,16,17,10,2,19,28,67.9,9,11,1,10,13,35,0
784,Bernardo Espinosa,24,16,18,4,2,16,28,57.1,12,19,11,8,24,108,2
785,Sebastiano Esposito,3,2,0,2,1,0,5,0.0,5,3,0,3,3,1,0
786,Vicente Esquerdo,1,0,1,0,0,0,0,,0,1,0,1,0,1,0
787,Alexander Esswein,6,4,4,2,0,3,8,37.5,5,8,1,7,7,7,1
788,Pervis Estupiñán,84,45,53,27,4,42,77,54.5,35,30,7,23,58,61,6
789,Oghenekaro Etebo,12,4,5,7,0,7,12,58.3,5,10,1,9,11,4,1
790,Beñat Etxebarria,6,1,2,3,1,2,13,15.4,11,6,1,5,4,6,0
791,Xabier Etxeita,20,11,11,9,0,12,23,52.2,11,9,5,4,17,68,0
792,Antony Evans,5,4,1,3,1,1,5,20.0,4,1,1,0,2,4,0
793,Jonny Evans,48,34,33,14,1,28,39,71.8,11,33,18,15,57,174,4
794,Edu Expósito,52,28,12,31,9,18,49,36.7,31,20,6,14,31,18,1
795,Valentin Eysseric,4,4,1,2,1,0,4,0.0,4,3,0,3,1,2,0
796,Valentin Eysseric,0,0,0,0,0,0,0,,0,1,0,1,0,0,0
797,Łukasz Fabiański,2,2,2,0,0,2,4,50.0,2,0,0,0,1,5,3
798,Fabinho,62,35,20,35,7,26,67,38.8,41,25,2,23,34,19,1
799,Fábio,38,22,18,20,0,25,35,71.4,10,10,5,5,18,19,0
800,Cesc Fàbregas,11,4,6,3,2,6,29,20.7,23,8,1,7,7,3,0
801,Fabricio,0,0,0,0,0,0,0,,0,0,0,0,0,0,1
802,Ralf Fährmann,0,0,0,0,0,0,0,,0,0,0,0,0,0,0
803,Fayçal Fajr,1,1,0,1,0,0,3,0.0,3,4,0,4,4,1,0
804,Luca Falbo,0,0,0,0,0,0,0,,0,0,0,0,0,0,0
805,Filippo Falco,13,7,4,5,4,5,18,27.8,13,11,1,10,2,1,0
806,Eliseo Falcon,0,0,0,0,0,0,0,,0,0,0,0,0,2,0
807,Wladimiro Falcone,0,0,0,0,0,0,0,,0,0,0,0,0,0,0
808,Simon Falette,0,0,0,0,0,0,1,0.0,1,3,3,0,3,5,0
809,Iago Falque,0,0,0,0,0,0,1,0.0,1,1,0,1,0,0,0
810,Iago Falque,7,3,1,4,2,4,8,50.0,4,7,0,7,1,4,0
811,Akin Famewo,0,0,0,0,0,0,0,,0,0,0,0,0,0,0
812,Andri Fannar Baldursson,1,0,0,1,0,0,1,0.0,1,2,0,2,1,3,0
813,Paolo Faragò,41,28,21,15,5,23,46,50.0,23,18,9,9,10,58,0
814,Davide Faraoni,67,37,43,19,5,30,67,44.8,37,50,15,35,36,115,0
815,Mohamed Fares,6,4,3,2,1,2,10,20.0,8,5,3,2,5,8,0
816,Diego Farias,9,6,3,5,1,5,18,27.8,13,7,0,7,4,4,0
817,Ansu Fati,16,8,4,7,5,5,15,33.3,10,14,1,13,8,3,0
818,Julien Faussurier,36,22,23,13,0,21,53,39.6,32,22,7,15,33,46,1
819,Andrea Favilli,8,7,2,3,3,4,11,36.4,7,5,1,4,0,7,0
820,Federico Fazio,19,11,12,6,1,6,11,54.5,5,8,6,2,19,52,0
821,Aleix Febas,36,24,13,19,4,12,36,33.3,24,15,0,15,17,6,0
822,Zouhair Feddal,20,13,14,5,1,10,14,71.4,4,15,9,6,23,74,0
823,Ljubomir Fejsa,19,13,8,10,1,6,23,26.1,17,8,1,7,6,13,0
824,Nabil Fekir,41,26,14,19,8,12,37,32.4,25,27,3,24,10,3,0
825,Felipe,27,19,21,6,0,14,24,58.3,10,18,13,5,40,130,0
826,Luiz Felipe,42,24,24,15,3,19,32,59.4,13,39,30,9,41,69,2
827,Lucas Felippe,1,1,1,0,0,1,1,100.0,0,0,0,0,0,0,0
828,João Félix,9,3,3,3,3,4,14,28.6,10,4,0,4,10,4,1
829,Ohis Felix Uduokhai,43,26,30,12,1,19,29,65.5,10,40,30,10,36,125,2
830,Kiko Femenía,68,38,49,17,2,43,80,53.8,37,16,2,14,36,49,0
831,Zinedine Ferhat,26,16,5,16,5,15,46,32.6,31,15,3,12,16,18,0
832,Bruno Fernandes,22,12,9,9,4,5,38,13.2,33,6,0,6,11,16,0
833,Edimilson Fernandes,33,20,12,15,6,15,33,45.5,18,17,9,8,32,47,1
834,Gedson Fernandes,2,0,2,0,0,0,2,0.0,2,2,0,2,1,0,0
835,Gelson Fernandes,30,18,13,17,0,7,21,33.3,14,11,3,8,16,9,2
836,Matheus Fernandes,6,2,2,2,2,3,5,60.0,2,4,0,4,2,2,0
837,Aitor Fernández,1,1,1,0,0,1,1,100.0,0,0,0,0,2,18,3
838,Andrés Fernández,0,0,0,0,0,0,0,,0,0,0,0,0,2,0
839,Carlos Fernández,24,15,7,11,6,3,32,9.4,29,25,2,23,11,30,0
840,Federico Fernández,42,25,30,10,2,23,46,50.0,23,41,28,13,24,190,2
841,Gabriel Fernández,1,0,0,1,0,1,3,33.3,2,5,1,4,2,2,0
842,Joaquín Fernández,30,24,17,10,3,9,30,30.0,21,14,10,4,32,57,0
843,Fernandinho,50,35,32,16,2,29,48,60.4,19,28,16,12,25,82,0
844,Fernando,62,33,37,24,1,34,58,58.6,24,38,15,23,67,73,1
845,Juan Ferney Otero,17,10,6,9,2,8,24,33.3,16,12,1,11,19,10,0
846,Alex Ferrari,18,13,13,5,0,7,12,58.3,5,13,8,5,12,31,0
847,Facundo Ferreyra,9,4,4,5,0,3,10,30.0,7,4,0,4,2,5,0
848,Jordan Ferri,22,13,7,12,3,13,44,29.5,31,9,0,9,10,10,0
849,Oliver Fink,21,12,7,11,3,5,16,31.3,11,12,1,11,15,7,0
850,Alfreð Finnbogason,11,6,1,9,1,2,7,28.6,5,8,2,6,3,8,0
851,Roberto Firmino,37,19,8,14,15,10,43,23.3,33,34,3,31,7,11,1
852,Junior Firpo,23,15,12,8,3,11,17,64.7,6,15,3,12,17,12,1
853,John Fleck,36,25,13,14,9,22,64,34.4,42,25,3,22,24,26,0
854,Mark Flekken,0,0,0,0,0,0,1,0.0,1,0,0,0,0,2,2
855,Sergio Floccari,8,3,3,1,4,0,13,0.0,13,9,1,8,5,1,0
856,Alessandro Florenzi,14,11,8,4,2,7,20,35.0,13,9,3,6,16,19,0
857,Alessandro Florenzi,13,9,9,4,0,8,18,44.4,10,11,1,10,14,21,0
858,Phil Foden,14,10,4,6,4,6,19,31.6,13,5,0,5,6,2,0
859,Mamadou Fofana,57,35,38,15,4,21,41,51.2,20,22,10,12,22,61,1
860,Seko Fofana,17,12,8,8,1,9,35,25.7,26,20,1,19,17,19,0
861,Wesley Fofana,25,15,16,9,0,12,18,66.7,6,10,5,5,36,55,4
862,Youssouf Fofana,25,17,10,12,3,13,30,43.3,17,11,0,11,14,7,0
863,Youssouf Fofana,16,9,6,10,0,8,15,53.3,7,12,2,10,8,9,0
864,Thomas Foket,61,36,31,23,7,30,48,62.5,18,15,4,11,39,59,1
865,Lamine Fomba,65,31,20,37,8,21,43,48.8,22,29,4,25,25,11,1
866,José Fonte,19,11,11,7,1,11,22,50.0,11,19,11,8,28,90,1
867,Pablo Fornals,46,28,21,18,7,19,64,29.7,45,35,1,34,25,15,0
868,Emil Forsberg,16,10,5,8,3,6,26,23.1,20,15,0,15,5,3,0
869,Hernâni Fortes,5,2,4,0,1,1,3,33.3,2,3,0,3,4,9,0
870,Ben Foster,1,0,1,0,0,1,3,33.3,2,1,0,1,0,16,2
871,Lyle Foster,0,0,0,0,0,0,1,0.0,1,0,0,0,0,1,0
872,Timothy Fosu-Mensah,1,1,0,1,0,1,4,25.0,3,0,0,0,4,1,0
873,Dimitri Foulquier,1,0,1,0,0,0,0,,0,1,0,1,2,2,0
874,Dimitri Foulquier,25,11,13,9,3,11,20,55.0,9,8,3,5,16,32,0
875,Juan Foyth,7,3,5,2,0,3,4,75.0,1,1,0,1,1,3,1
876,Gianluca Frabotta,3,1,0,2,1,2,2,100.0,0,2,0,2,1,2,0
877,Raphael Framberger,43,25,23,16,4,21,29,72.4,8,23,9,14,20,26,0
878,Simon Francis,13,9,11,2,0,11,21,52.4,10,17,12,5,20,71,0
879,Mike Frantz,4,2,1,3,0,2,9,22.2,7,5,3,2,1,4,0
880,Ryan Fraser,12,6,5,5,2,7,22,31.8,15,15,3,12,15,24,0
881,Fred,60,32,33,22,5,25,100,25.0,75,44,8,36,38,32,0
882,Ryan Fredericks,82,56,59,18,5,41,64,64.1,23,20,10,10,24,73,1
883,Kieron Freeman,0,0,0,0,0,0,0,,0,0,0,0,0,0,0
884,Luke Freeman,6,4,2,2,2,2,8,25.0,6,1,0,1,10,6,0
885,Remo Freuler,51,30,18,25,8,22,63,34.9,41,41,6,35,28,26,0
886,Marco Friedl,61,39,42,15,4,29,54,53.7,25,29,9,20,34,78,0
887,Marvin Friedrich,45,31,30,14,1,12,37,32.4,25,46,24,22,42,110,0
888,Samúel Friðjónsson,4,1,3,1,0,1,3,33.3,2,4,1,3,4,4,0
889,Jorge de Frutos,2,2,2,0,0,1,2,50.0,1,0,0,0,0,1,0
890,Christian Fuchs,14,9,8,6,0,8,19,42.1,11,8,3,5,17,33,1
891,Angelo Fulgini,28,18,8,15,5,12,23,52.2,11,6,1,5,19,10,0
892,Niclas Füllkrug,2,2,1,1,0,1,3,33.3,2,3,0,3,3,6,0
893,Ramiro Funes Mori,5,2,2,3,0,0,2,0.0,2,8,2,6,3,9,1
894,Daniel Fuzato,0,0,0,0,0,0,0,,0,0,0,0,0,0,0
895,Matteo Gabbia,7,5,5,2,0,5,8,62.5,3,6,6,0,9,21,0
896,Manolo Gabbiadini,9,7,2,3,4,1,7,14.3,6,12,0,12,10,11,0
897,Gabriel,2,1,2,0,0,2,3,66.7,1,0,0,0,0,11,10
898,Ruben Gabrielsen,3,2,3,0,0,2,4,50.0,2,5,3,2,8,41,0
899,Mijat Gaćinović,19,11,7,8,4,6,25,24.0,19,26,2,24,15,6,0
900,Luca Gagliano,0,0,0,0,0,0,0,,0,0,0,0,1,0,0
901,Roberto Gagliardini,38,19,12,18,8,14,41,34.1,27,28,8,20,30,20,1
902,Riccardo Gagliolo,57,32,37,12,8,30,60,50.0,30,35,18,17,53,100,0
903,Nicolás Gaitán,1,0,0,1,0,1,1,100.0,0,1,0,1,0,1,0
904,Marvin Gakpa,10,6,3,4,3,4,8,50.0,4,3,0,3,5,1,0
905,Enric Gallego,9,5,1,5,3,0,4,0.0,4,10,2,8,4,8,0
906,Enric Gallego,3,1,1,1,1,2,4,50.0,2,2,0,2,2,1,0
907,Kévin Gameiro,17,9,7,6,4,5,21,23.8,16,10,1,9,5,5,0
908,Fran Gámez,64,42,32,27,5,33,74,44.6,41,31,11,20,29,41,0
909,Idrissa Gana Gueye,65,34,30,25,10,18,43,41.9,25,29,4,25,33,15,0
910,Ignatius Ganago,10,6,4,3,3,3,18,16.7,15,8,1,7,4,13,0
911,Ezequiel Garay,12,8,9,2,1,7,11,63.6,4,19,17,2,14,71,0
912,Dani García,59,30,30,27,2,30,86,34.9,56,25,7,18,52,56,1
913,David García,28,16,15,12,1,14,31,45.2,17,20,16,4,48,123,2
914,Eric García,6,1,4,2,0,5,9,55.6,4,2,0,2,18,33,0
915,Javi García,2,2,2,0,0,2,3,66.7,1,1,0,1,4,15,0
916,Manu García,46,23,11,31,4,17,72,23.6,55,28,12,16,28,32,1
917,Raúl García,20,12,11,7,2,9,22,40.9,13,12,2,10,8,30,0
918,Raúl García,57,37,19,26,12,16,76,21.1,60,46,6,40,24,44,0
919,Raúl García,5,3,2,3,0,3,6,50.0,3,3,1,2,4,10,0
920,Rubén García,55,30,22,26,7,18,46,39.1,28,34,5,29,11,23,1
921,Unai García,9,6,4,4,1,5,9,55.6,4,13,9,4,8,31,0
922,Víctor García,0,0,0,0,0,0,1,0.0,1,1,0,1,0,1,0
923,James Garner,0,0,0,0,0,0,1,0.0,1,0,0,0,0,1,0
924,Manuel Garrido,0,0,0,0,0,0,6,0.0,6,3,1,2,1,0,0
925,Mario Gaspar,35,20,16,16,3,15,31,48.4,16,25,10,15,26,69,0
926,Daniele Gastaldello,8,5,5,3,0,2,3,66.7,1,6,3,3,5,29,1
927,Dwight Gayle,12,10,4,6,2,4,8,50.0,4,5,0,5,2,9,0
928,Paulo Gazzaniga,0,0,0,0,0,0,0,,0,0,0,0,1,4,1
929,Jean-Philippe Gbamin,4,3,1,1,2,1,2,50.0,1,1,0,1,1,4,0
930,Yann Gboho,2,2,1,0,1,0,2,0.0,2,1,0,1,1,0,0
931,David de Gea,0,0,0,0,0,0,0,,0,0,0,0,0,7,4
932,Theodor Gebre Selassie,36,27,23,10,3,17,35,48.6,18,26,9,17,63,81,0
933,Dennis Geiger,12,5,4,6,2,2,16,12.5,14,9,2,7,6,4,0
934,Jérémy Gélin,14,5,10,2,2,8,13,61.5,5,14,7,7,15,33,1
935,Christian Gentner,53,28,16,32,5,22,73,30.1,51,46,8,38,54,50,0
936,Yannick Gerhardt,28,18,7,15,6,8,21,38.1,13,11,3,8,12,9,0
937,Valère Germain,22,12,6,11,5,6,31,19.4,25,16,3,13,8,26,0
938,Gervinho,12,6,5,6,1,6,17,35.3,11,4,0,4,5,3,0
939,Anwar El Ghazi,20,11,12,5,3,8,26,30.8,18,10,1,9,13,16,1
940,Rachid Ghezzal,27,15,14,10,3,10,33,30.3,23,6,0,6,11,9,0
941,Andrea Ghezzi,2,0,0,1,1,1,1,100.0,0,0,0,0,0,0,0
942,Paolo Ghiglione,31,16,15,13,3,18,35,51.4,17,17,2,15,9,42,1
943,Andrea Ghion,3,1,1,2,0,1,1,100.0,0,0,0,0,0,0,0
944,Saman Ghoddos,2,2,0,1,1,1,2,50.0,1,5,0,5,2,3,0
945,Faouzi Ghoulam,6,4,1,4,1,2,5,40.0,3,3,2,1,4,8,0
946,Morgan Gibbs-White,0,0,0,0,0,0,0,,0,0,0,0,2,0,0
947,Niko Gießelmann,46,31,31,11,4,22,45,48.9,23,23,6,17,27,55,1
948,Rafał Gikiewicz,1,0,1,0,0,1,4,25.0,3,0,0,0,2,26,4
949,Bryan Gil,8,4,3,4,1,1,8,12.5,7,6,0,6,3,1,0
950,Bryan Gil,1,1,0,1,0,0,1,0.0,1,0,0,0,0,0,0
951,Billy Gilmour,5,2,3,2,0,2,4,50.0,2,2,0,2,3,3,1
952,Daniel Ginczek,4,3,3,1,0,1,11,9.1,10,3,1,2,1,3,0
953,Matthias Ginter,34,20,19,14,1,17,31,54.8,14,27,22,5,34,125,3
954,Andrei Girotto,76,53,45,29,2,39,71,54.9,32,32,17,15,34,111,1
955,Olivier Giroud,8,3,2,5,1,1,11,9.1,10,14,1,13,2,13,0
956,Klaus Gjasula,69,39,30,35,4,30,61,49.2,31,33,6,27,32,50,2
957,Kamil Glik,26,14,15,11,0,13,21,61.9,8,23,17,6,27,118,0
958,Serge Gnabry,36,16,4,19,13,9,29,31.0,20,17,0,17,16,2,1
959,Joris Gnagnon,16,13,14,2,0,10,11,90.9,1,21,17,4,18,61,0
960,Eddy Gnahoré,24,12,7,15,2,8,28,28.6,20,25,4,21,9,25,0
961,Ben Godfrey,22,14,18,3,1,10,18,55.6,8,41,37,4,25,152,3
962,Diego Godín,38,29,19,16,3,18,32,56.3,14,17,7,10,45,60,1
963,Akaki Gogia,2,1,0,0,2,0,2,0.0,2,2,2,0,0,0,0
964,Mauro Goicoechea,0,0,0,0,0,0,0,,0,0,0,0,0,1,2
965,Edoardo Goldaniga,4,3,3,1,0,2,5,40.0,3,11,6,5,18,25,1
966,Benjamin Goller,8,3,3,4,1,3,10,30.0,7,3,0,3,1,1,0
967,Pierluigi Gollini,0,0,0,0,0,0,2,0.0,2,0,0,0,0,13,2
968,Aleksandr Golovin,49,27,17,26,6,14,69,20.3,55,28,0,28,31,22,0
969,André Gomes,22,15,7,11,4,8,62,12.9,54,20,3,17,7,7,0
970,Angel Gomes,0,0,0,0,0,0,0,,0,1,0,1,0,0,0
971,Ibai Gómez,5,3,2,2,1,3,8,37.5,5,4,0,4,3,6,0
972,Joe Gomez,23,16,17,6,0,9,20,45.0,11,15,8,7,38,64,2
973,Maxi Gómez,9,7,1,6,2,4,8,50.0,4,8,1,7,5,14,0
974,Moi Gómez,30,22,9,14,7,11,33,33.3,22,22,2,20,25,23,0
975,Papu Gómez,27,13,5,13,9,13,45,28.9,32,24,0,24,17,6,1
976,Sergi Gómez,9,7,7,2,0,4,4,100.0,0,6,6,0,7,30,0
977,Victor Gomez,13,5,8,4,1,7,20,35.0,13,10,0,10,21,31,0
978,Alfred Gomis,1,0,1,0,0,1,2,50.0,1,2,0,2,0,14,2
979,Maxime Gonalons,62,38,25,35,2,22,54,40.7,32,27,3,24,20,20,1
980,Mathieu Goncalves,5,3,5,0,0,2,8,25.0,6,4,3,1,4,10,0
981,Jérôme Gondorf,9,6,7,1,1,3,6,50.0,3,3,2,1,0,2,0
982,Álvaro González,19,13,14,4,1,9,13,69.2,4,7,4,3,18,65,0
983,Bruno González,3,2,3,0,0,1,1,100.0,0,2,0,2,0,3,0
984,Bruno González,10,8,7,2,1,2,4,50.0,2,7,4,3,2,32,0
985,Édgar González,8,3,3,5,0,2,14,14.3,12,4,2,2,10,16,0
986,Gonzalo,1,0,0,1,0,0,0,,0,0,0,0,0,0,0
987,Anthony Gordon,11,7,5,6,0,5,15,33.3,10,6,2,4,8,4,0
988,Leon Goretzka,28,15,7,18,3,10,32,31.3,22,18,2,16,24,8,0
989,Andoni Gorosabel,14,8,9,3,2,10,20,50.0,10,13,1,12,13,21,0
990,Robin Gosens,53,27,19,26,8,23,51,45.1,28,38,10,28,39,40,0
991,Dan Gosling,26,10,14,9,3,6,27,22.2,21,31,11,20,20,26,0
992,Mario Götze,10,7,0,6,4,3,12,25.0,9,3,0,3,2,1,0
993,Prince-Désir Gouano,3,1,0,3,0,0,0,,0,6,3,3,2,15,0
994,Amine Gouiri,0,0,0,0,0,0,0,,0,0,0,0,0,0,0
995,Jeffrey Gouweleeuw,28,16,22,5,1,12,21,57.1,9,15,8,7,37,97,0
996,Max Gradel,36,20,17,14,5,12,47,25.5,35,11,1,10,11,23,0
997,Samuel Grandsir,34,22,13,16,5,11,30,36.7,19,9,0,9,14,5,0
998,Esteban Granero,10,4,5,3,2,5,11,45.5,6,3,2,1,2,5,0
999,Alberto Grassi,10,4,7,3,0,5,13,38.5,8,5,2,3,19,9,1
1000,Andre Gray,4,3,0,2,2,1,3,33.3,2,4,1,3,1,2,0
1001,Demarai Gray,12,6,6,6,0,6,12,50.0,6,7,0,7,5,4,0
1002,Jack Grealish,29,19,12,12,5,13,34,38.2,21,33,12,21,22,22,1
1003,Mason Greenwood,17,11,5,6,6,5,20,25.0,15,9,0,9,6,6,1
1004,Michael Gregoritsch,2,2,0,2,0,0,4,0.0,4,4,1,3,3,7,0
1005,Michael Gregoritsch,8,5,0,6,2,0,9,0.0,9,9,1,8,2,10,0
1006,Clément Grenier,21,12,6,15,0,11,40,27.5,29,7,2,5,7,16,0
1007,Antoine Griezmann,33,18,12,11,10,9,34,26.5,25,22,3,19,12,20,1
1008,Vincenzo Grifo,0,0,0,0,0,0,0,,0,0,0,0,0,0,0
1009,Vincenzo Grifo,15,10,9,3,3,6,25,24.0,19,13,1,12,14,18,1
1010,Florian Grillitsch,59,29,34,24,1,29,61,47.5,32,33,6,27,49,41,1
1011,Jérémy Grimm,0,0,0,0,0,0,0,,0,0,0,0,0,0,0
1012,Christian Groß,23,17,16,5,2,9,16,56.3,7,13,7,6,14,50,1
1013,Pascal Groß,36,13,8,21,7,14,39,35.9,25,25,3,22,9,7,0
1014,Carlos Gruezo,28,12,12,15,1,5,24,20.8,19,5,0,5,6,5,0
1015,Marko Grujić,56,34,21,30,5,19,63,30.2,44,43,9,34,22,69,0
1016,Vicente Guaita,1,1,1,0,0,1,2,50.0,1,0,0,0,0,18,3
1017,Andrés Guardado,30,14,15,11,4,15,41,36.6,26,15,4,11,18,22,1
1018,Sergi Guardiola,14,6,3,7,4,4,24,16.7,20,23,0,23,6,18,1
1019,Nemanja Gudelj,20,14,11,8,1,6,19,31.6,13,17,8,9,12,35,1
1020,Gonçalo Guedes,19,11,11,7,1,9,32,28.1,23,10,1,9,7,1,0
1021,Mattéo Guendouzi,31,16,14,13,4,14,43,32.6,29,21,7,14,29,38,2
1022,Raphaël Guerreiro,44,24,18,21,5,20,32,62.5,12,27,3,24,42,26,0
1023,Adrián Guerrero,2,2,1,1,0,2,3,66.7,1,0,0,0,2,1,0
1024,Ander Guevara,27,11,9,17,1,12,30,40.0,18,13,3,10,8,15,1
1025,Babacar Guèye,2,0,0,0,2,0,1,0.0,1,1,1,0,0,3,0
1026,John Guidetti,2,1,0,1,1,0,0,,0,1,0,1,0,0,0
1027,Josuha Guilavogui,41,26,17,23,1,10,30,33.3,20,35,9,26,45,64,2
1028,Frederic Guilbert,74,43,48,20,6,36,67,53.7,31,33,10,23,49,74,2
1029,Hugo Guillamón,8,3,5,2,1,5,10,50.0,5,3,2,1,5,29,0
1030,Bruno Guimarães,12,7,5,6,1,5,10,50.0,5,1,0,1,4,1,0
1031,Serhou Guirassy,7,3,1,4,2,2,7,28.6,5,13,6,7,4,21,0
1032,Rafik Guitane,0,0,0,0,0,0,0,,0,0,0,0,0,0,0
1033,Péter Gulácsi,0,0,0,0,0,0,0,,0,0,0,0,1,18,6
1034,Manuel Gulde,28,16,17,9,2,15,24,62.5,9,23,13,10,22,80,1
1035,Sinan Gümüş,0,0,0,0,0,0,4,0.0,4,0,0,0,0,1,0
1036,İlkay Gündoğan,27,16,9,11,7,9,41,22.0,32,17,5,12,31,13,0
1037,Angus Gunn,1,1,1,0,0,1,3,33.3,2,0,0,0,0,1,0
1038,Christian Günter,25,11,17,7,1,12,35,34.3,23,29,13,16,14,40,0
1039,Koray Günter,39,25,22,15,2,19,29,65.5,10,45,39,6,55,131,1
1040,Régis Gurtner,1,1,1,0,0,1,2,50.0,1,0,0,0,0,10,4
1041,Luiz Gustavo,6,3,3,3,0,3,5,60.0,2,5,2,3,5,6,0
1042,Jonathan de Guzmán,1,1,0,1,0,1,7,14.3,6,2,0,2,1,0,0
1043,Erling Haaland,4,2,1,0,3,0,4,0.0,4,7,4,3,4,4,0
1044,Janik Haberer,26,18,8,14,4,12,45,26.7,33,25,4,21,25,23,0
1045,Alexander Hack,26,10,19,6,1,16,27,59.3,11,20,9,11,23,60,1
1046,Munir El Haddadi,19,17,6,11,2,4,21,19.0,17,8,0,8,7,8,0
1047,André Hahn,15,9,7,5,3,5,21,23.8,16,23,5,18,13,14,0
1048,Amadou Haidara,26,16,7,17,2,10,24,41.7,14,14,2,12,8,10,1
1049,Achraf Hakimi,60,41,38,14,8,27,64,42.2,37,26,2,24,30,27,2
1050,Sébastien Haller,22,15,8,10,4,3,30,10.0,27,19,5,14,8,27,0
1051,Marcel Halstenberg,46,31,27,17,2,28,58,48.3,30,37,11,26,46,72,2
1052,Romain Hamouma,12,9,1,5,6,2,12,16.7,10,12,0,12,0,4,0
1053,Samir Handanović,1,1,1,0,0,0,1,0.0,1,0,0,0,0,8,3
1054,Grant Hanley,24,15,17,7,0,8,14,57.1,6,25,18,7,31,77,1
1055,Lukáš Haraslín,5,2,1,3,1,2,9,22.2,7,5,0,5,4,1,0
1056,Amine Harit,16,7,8,5,3,6,25,24.0,19,13,0,13,7,2,1
1057,Martin Harnik,0,0,0,0,0,0,0,,0,0,0,0,0,0,0
1058,Makoto Hasebe,28,20,16,9,3,18,39,46.2,21,38,10,28,26,38,0
1059,Hans Hateboer,36,23,20,9,7,18,38,47.4,20,22,7,15,10,32,1
1060,Kortney Hause,21,9,15,5,1,8,15,53.3,7,27,19,8,20,98,4
1061,Kai Havertz,21,15,5,10,6,6,39,15.4,33,22,0,22,2,22,0
1062,Isaac Hayden,55,27,33,17,5,20,50,40.0,30,24,7,17,38,38,0
1063,Eden Hazard,7,3,2,3,2,3,15,20.0,12,5,0,5,6,0,0
1064,Thorgan Hazard,40,27,17,14,9,12,50,24.0,38,29,0,29,13,2,1
1065,Tom Heaton,3,2,3,0,0,3,4,75.0,1,0,0,0,0,6,0
1066,Jonas Hector,76,49,37,34,5,24,75,32.0,51,44,10,34,46,38,1
1067,Dominique Heintz,47,30,40,6,1,17,43,39.5,26,38,25,13,41,131,1
1068,Dean Henderson,0,0,0,0,0,0,0,,0,0,0,0,1,13,1
1069,Jordan Henderson,63,41,18,33,12,22,55,40.0,33,22,4,18,30,21,2
1070,Liam Henderson,3,2,0,3,0,2,3,66.7,1,1,0,1,0,4,0
1071,Jeff Hendrick,18,10,7,8,3,7,27,25.9,20,21,8,13,20,20,0
1072,Wayne Hennessey,0,0,0,0,0,0,0,,0,0,0,0,1,3,1
1073,Rouwen Hennings,11,5,2,7,2,3,18,16.7,15,12,0,12,2,33,0
1074,Benjamin Henrichs,26,20,16,9,1,14,33,42.4,19,19,4,15,14,18,0
1075,Dalbert Henrique,52,25,35,12,5,18,51,35.3,33,34,4,30,19,65,0
1076,Christophe Hérelle,14,11,10,4,0,3,7,42.9,4,14,8,6,17,26,1
1077,Mario Hermoso,15,8,12,2,1,11,20,55.0,9,11,5,6,12,61,0
1078,Aridane Hernández,35,23,22,13,0,15,19,78.9,4,24,15,9,34,137,2
1079,Javier Hernández,0,0,0,0,0,0,1,0.0,1,0,0,0,1,0,0
1080,Javier Hernández,6,4,0,4,2,1,6,16.7,5,5,0,5,5,1,0
1081,Juan Hernández,0,0,0,0,0,0,0,,0,0,0,0,1,0,0
1082,Lucas Hernández,18,9,13,3,2,9,15,60.0,6,6,1,5,15,17,0
1083,Onel Hernández,27,19,13,11,3,9,31,29.0,22,12,1,11,19,10,0
1084,Theo Hernández,56,39,32,18,6,33,53,62.3,20,34,6,28,43,62,2
1085,Hernani,61,31,25,31,5,30,112,26.8,82,53,11,42,50,51,1
1086,Ander Herrera,19,11,9,9,1,5,14,35.7,9,10,2,8,6,4,0
1087,Héctor Herrera,31,21,9,18,4,13,32,40.6,19,16,7,9,17,13,2
1088,Sergio Herrera,1,1,1,0,0,1,4,25.0,3,0,0,0,1,13,3
1089,Yangel Herrera,88,49,25,53,10,36,80,45.0,44,38,9,29,34,28,0
1090,Iago Herrerín,0,0,0,0,0,0,0,,0,0,0,0,0,0,0
1091,Patrick Herrmann,24,11,8,10,6,5,16,31.3,11,21,4,17,11,8,0
1092,Pablo Hervías,24,20,8,14,2,12,22,54.5,10,8,0,8,5,0,0
1093,Son Heung-min,23,15,10,11,2,9,57,15.8,48,23,0,23,19,18,1
1094,Gonzalo Higuaín,13,7,2,6,5,4,31,12.9,27,12,0,12,6,14,0
1095,Vitorino Hilton,27,17,20,7,0,13,28,46.4,15,22,18,4,49,121,1
1096,Martin Hinteregger,66,51,33,30,3,28,57,49.1,29,41,21,20,36,96,0
1097,George Hirst,0,0,0,0,0,0,0,,0,0,0,0,0,0,0
1098,Marwin Hitz,0,0,0,0,0,0,0,,0,0,0,0,0,0,0
1099,André Hoffmann,48,22,30,18,0,16,50,32.0,34,22,9,13,56,90,0
1100,Nicolas Höfler,65,40,31,28,6,22,64,34.4,42,58,18,40,71,59,3
1101,Jonas Hofmann,43,27,22,12,9,22,76,28.9,54,28,3,25,18,14,0
1102,Jonas Hofmann,0,0,0,0,0,0,0,,0,0,0,0,0,2,0
1103,Marco Höger,10,6,4,5,1,6,16,37.5,10,14,4,10,6,15,0
1104,Rob Holding,4,2,3,1,0,1,3,33.3,2,10,6,4,5,45,1
1105,José Holebas,26,15,19,7,0,9,28,32.1,19,11,4,7,3,33,0
1106,Lucas Höler,35,15,11,16,8,11,46,23.9,35,30,9,21,12,38,0
1107,Mason Holgate,44,26,30,13,1,21,31,67.7,10,26,13,13,34,97,0
1108,Nathan Holland,3,1,2,1,0,0,0,,0,1,0,1,0,0,0
1109,Gerrit Holtmann,24,14,14,6,4,15,37,40.5,22,21,1,20,6,8,0
1110,Josué Homawoo,6,2,3,3,0,2,2,100.0,0,3,2,1,2,2,0
1111,Franck Honorat,16,11,7,8,1,8,23,34.8,15,12,1,11,5,13,1
1112,Luca Horn,0,0,0,0,0,0,0,,0,0,0,0,0,0,0
1113,Timo Horn,0,0,0,0,0,0,5,0.0,5,0,0,0,2,15,1
1114,Krisztofer Horváth,1,1,0,1,0,0,0,,0,0,0,0,0,0,0
1115,Conor Hourihane,16,10,4,8,4,10,25,40.0,15,19,4,15,9,31,0
1116,Lukáš Hrádecký,0,0,0,0,0,0,1,0.0,1,0,0,0,2,19,2
1117,Benjamin Hübner,42,26,33,9,0,23,45,51.1,22,18,13,5,30,98,2
1118,Florian Hübner,16,14,12,4,0,7,17,41.2,10,11,7,4,16,39,0
1119,Callum Hudson-Odoi,10,4,4,5,1,1,7,14.3,6,9,0,9,5,4,1
1120,Will Hughes,75,47,24,41,10,25,67,37.3,42,48,8,40,37,28,0
1121,Mats Hummels,57,30,30,26,1,20,38,52.6,18,41,18,23,59,110,1
1122,Uwe Hünemeier,20,15,9,11,0,10,20,50.0,10,22,12,10,24,63,0
1123,Adrien Hunou,21,18,5,11,5,4,21,19.0,17,16,1,15,5,5,0
1124,Jannik Huth,0,0,0,0,0,0,1,0.0,1,0,0,0,0,2,0
1125,Elseid Hysaj,18,9,13,4,1,12,26,46.2,14,16,3,13,24,26,0
1126,Suk Hyun-jun,3,3,1,1,1,1,2,50.0,1,1,0,1,1,2,0
1127,Pierre Højbjerg,80,49,34,38,8,39,91,42.9,52,44,5,39,46,54,2
1128,Simone Iacoponi,49,25,36,12,1,26,42,61.9,16,37,29,8,35,140,2
1129,Iago,19,12,12,7,0,9,18,50.0,9,6,2,4,14,27,0
1130,Robert Ibáñez,13,8,4,5,4,7,20,35.0,13,7,0,7,5,5,0
1131,Roger Ibanez,11,8,6,3,2,5,7,71.4,2,9,6,3,18,21,1
1132,Jordon Ibe,2,2,2,0,0,1,1,100.0,0,0,0,0,0,1,0
1133,Vedad Ibišević,4,3,0,1,3,0,3,0.0,3,4,0,4,1,15,0
1134,Vicente Iborra,61,42,31,25,5,30,67,44.8,37,35,16,19,40,63,1
1135,Didier Ibrahim Ndong,62,35,30,31,1,30,59,50.8,29,27,6,21,49,31,0
1136,Zlatan Ibrahimović,5,1,0,2,3,1,13,7.7,12,4,3,1,5,21,0
1137,Mauro Icardi,4,2,1,3,0,1,10,10.0,9,7,1,6,2,11,0
1138,Adam Idah,2,2,1,0,1,2,3,66.7,1,4,0,4,0,1,0
1139,Odion Ighalo,2,2,0,2,0,1,3,33.3,2,1,1,0,0,0,0
1140,Borja Iglesias,7,5,1,4,2,0,9,0.0,9,7,4,3,5,18,0
1141,Igor,24,16,13,10,1,14,20,70.0,6,17,9,8,24,37,1
1142,Igor,12,10,8,2,2,6,7,85.7,1,10,4,6,7,16,0
1143,Kelechi Iheanacho,3,1,1,2,0,1,9,11.1,8,8,1,7,3,8,0
1144,Luc Ihorst,1,1,0,0,1,0,0,,0,1,0,1,0,0,0
1145,Jonathan Ikone,15,7,3,7,5,6,24,25.0,18,26,2,24,5,3,0
1146,Yun Il-lok,1,1,0,1,0,0,4,0.0,4,0,0,0,0,0,0
1147,Josip Iličić,26,19,7,10,9,7,28,25.0,21,9,0,9,9,4,0
1148,Asier Illarramendi,2,2,1,0,1,2,6,33.3,4,2,1,1,5,6,0
1149,Stefan Ilsanker,3,1,3,0,0,3,6,50.0,3,6,3,3,7,21,0
1150,Stefan Ilsanker,23,15,16,7,0,10,23,43.5,13,8,1,7,19,26,0
1151,Giannelli Imbula,2,0,2,0,0,0,1,0.0,1,4,1,3,2,0,0
1152,Ciro Immobile,8,6,2,4,2,0,24,0.0,24,10,2,8,11,7,0
1153,Roberto Inglese,9,6,2,2,5,2,10,20.0,8,8,2,6,2,1,0
1154,Danny Ings,42,25,16,16,10,13,67,19.4,54,62,4,58,9,30,1
1155,Marcus Ingvartsen,20,14,5,7,8,9,28,32.1,19,16,1,15,16,16,0
1156,Lorenzo Insigne,21,15,6,8,7,6,35,17.1,29,13,0,13,30,4,1
1157,Takashi Inui,20,10,7,8,5,11,34,32.4,23,23,4,19,18,12,0
1158,Artur Ioniță,38,23,12,22,4,12,37,32.4,25,32,10,22,18,24,2
1159,Alexander Isak,7,2,0,3,4,1,8,12.5,7,8,0,8,3,6,0
1160,Isco,13,9,2,10,1,5,14,35.7,9,9,0,9,7,4,1
1161,Nicolas Isimat-Mirin,14,8,8,6,0,5,11,45.5,6,18,12,6,22,71,0
1162,Jakub Iskra,0,0,0,0,0,0,0,,0,0,0,0,1,2,0
1163,Ismael,2,1,1,1,0,1,2,50.0,1,2,1,1,2,2,0
1164,Gian-Luca Itter,1,1,1,0,0,1,1,100.0,0,0,0,0,1,4,0
1165,Ander Iturraspe,2,0,1,1,0,2,5,40.0,3,0,0,0,1,7,0
1166,Alex Iwobi,25,17,8,15,2,12,33,36.4,21,18,2,16,14,10,1
1167,Armando Izzo,42,24,24,14,4,17,35,48.6,18,44,29,15,71,121,1
1168,Jacobo,3,3,2,1,0,1,1,100.0,0,0,0,0,0,2,0
1169,Phil Jagielka,5,4,3,2,0,1,3,33.3,2,5,5,0,4,19,0
1170,Filip Jagiełło,7,2,0,3,4,3,7,42.9,4,4,0,4,5,4,0
1171,Alireza Jahanbakhsh,8,4,3,2,3,0,2,0.0,2,5,0,5,3,2,0
1172,Mato Jajalo,44,19,19,22,3,14,38,36.8,24,20,7,13,19,19,2
1173,Ismail Jakobs,34,23,18,9,7,10,23,43.5,13,25,3,22,24,30,0
1174,Christophe Jallet,24,16,14,8,2,14,37,37.8,23,8,2,6,18,29,0
1175,Daniel James,20,10,5,10,5,7,45,15.6,38,23,4,19,7,12,0
1176,Matty James,0,0,0,0,0,0,0,,0,0,0,0,0,0,0
1177,Reece James,36,23,18,14,4,11,29,37.9,18,19,8,11,22,28,0
1178,Marko Janković,2,1,0,0,2,1,2,50.0,1,2,1,1,0,0,0
1179,Jakub Jankto,27,13,14,10,3,10,42,23.8,32,30,3,27,22,22,0
1180,Daryl Janmaat,14,10,8,6,0,6,13,46.2,7,7,2,5,7,23,0
1181,Laurent Jans,42,25,30,8,4,22,48,45.8,26,25,10,15,19,49,1
1182,Tony Jantschke,33,21,23,10,0,15,24,62.5,9,20,11,9,27,48,0
1183,Adnan Januzaj,8,7,3,2,3,3,16,18.8,13,9,1,8,7,2,0
1184,Rune Jarstein,4,1,4,0,0,2,3,66.7,1,0,0,0,1,11,3
1185,Jason,29,20,8,16,5,15,33,45.5,18,18,3,15,18,9,0
1186,Dennis Jastrzembski,2,0,1,1,0,0,1,0.0,1,3,0,3,3,0,0
1187,Corentin Jean,0,0,0,0,0,0,0,,0,0,0,0,0,1,0
1188,Benjamin Jeannot,2,1,0,1,1,0,4,0.0,4,2,0,2,2,4,0
1189,Tin Jedvaj,44,26,25,19,0,23,47,48.9,24,36,18,18,60,123,1
1190,Jemerson,28,17,13,14,1,10,21,47.6,11,8,3,5,16,24,0
1191,Fredrik Jensen,3,1,2,1,0,2,7,28.6,5,7,1,6,1,3,0
1192,Jesé,0,0,0,0,0,0,0,,0,0,0,0,0,0,0
1193,Gabriel Jesus,17,10,4,5,8,7,25,28.0,18,26,1,25,11,6,0
1194,Juan Jesus,2,1,2,0,0,0,3,0.0,3,1,0,1,1,7,0
1195,Raúl Jiménez,20,12,6,10,4,3,31,9.7,28,26,0,26,16,34,1
1196,João Pedro,0,0,0,0,0,0,0,,0,0,0,0,0,0,0
1197,Joaquín,14,7,4,8,2,4,11,36.4,7,10,2,8,15,22,1
1198,Joelinton,34,20,7,22,5,9,32,28.1,23,32,6,26,11,30,0
1199,Ben Johnson,8,4,7,1,0,7,10,70.0,3,5,2,3,3,11,0
1200,Fabian Johnson,5,3,2,2,1,2,4,50.0,2,4,1,3,2,3,0
1201,Curtis Jones,4,4,0,1,3,3,4,75.0,1,2,0,2,2,1,0
1202,Phil Jones,2,2,1,1,0,1,1,100.0,0,2,0,2,2,9,1
1203,Frenkie de Jong,26,19,7,12,7,7,22,31.8,15,17,7,10,21,9,0
1204,Luuk de Jong,21,10,4,8,9,6,17,35.3,11,12,1,11,7,22,0
1205,Jony,13,9,7,4,2,5,23,21.7,18,11,2,9,14,17,0
1206,Joan Jordán,64,34,27,31,6,21,76,27.6,55,25,5,20,26,20,4
1207,Bruno Jordão,0,0,0,0,0,0,0,,0,1,0,1,0,0,0
1208,Jorginho,66,40,24,34,8,35,91,38.5,56,30,5,25,64,27,2
1209,Jesse Joronen,3,1,3,0,0,3,3,100.0,0,0,0,0,6,22,0
1210,Willian José,5,2,0,4,1,2,8,25.0,6,10,4,6,1,16,0
1211,Joselu,26,17,4,12,10,4,32,12.5,28,36,5,31,13,46,0
1212,Jota,3,1,2,0,1,2,5,40.0,3,1,0,1,3,6,0
1213,Diogo Jota,28,15,16,10,2,12,48,25.0,36,17,0,17,9,10,2
1214,Vukašin Jovanović,18,11,12,6,0,14,21,66.7,7,5,3,2,15,15,0
1215,Dejan Joveljić,2,2,1,1,0,0,1,0.0,1,0,0,0,0,1,0
1216,Stevan Jovetić,2,1,0,1,1,1,5,20.0,4,1,0,1,1,5,0
1217,Luka Jović,2,1,0,0,2,1,2,50.0,1,1,0,1,2,0,0
1218,Juanmi,4,1,1,2,1,1,4,25.0,3,1,0,1,0,0,0
1219,David Juncà,6,5,4,1,1,2,3,66.7,1,4,1,3,2,3,0
1220,Lago Junior,32,19,12,11,9,12,29,41.4,17,23,5,18,14,25,0
1221,Hamed Junior Traorè,31,15,10,15,6,14,39,35.9,25,22,1,21,11,7,0
1222,Vinicius Júnior,26,16,13,8,5,8,32,25.0,24,14,0,14,3,2,0
1223,James Justin,36,17,22,14,0,15,25,60.0,10,15,7,8,11,30,0
1224,Musa Juwara,4,2,1,1,2,1,5,20.0,4,2,1,1,0,1,0
1225,Mathias Jørgensen,4,3,3,1,0,2,4,50.0,2,7,3,4,13,33,0
1226,Ozan Kabak,37,23,28,9,0,14,21,66.7,7,33,19,14,37,97,0
1227,Christian Kabasele,37,24,26,11,0,17,32,53.1,15,31,23,8,36,127,0
1228,Abdoul Kader Bamba,19,15,5,9,5,9,30,30.0,21,8,2,6,16,8,0
1229,Pavel Kadeřábek,32,22,17,13,2,13,30,43.3,17,29,7,22,27,55,1
1230,Florian Kainz,21,13,12,6,3,15,33,45.5,18,26,2,24,13,11,0
1231,Gaël Kakuta,46,27,13,27,6,17,48,35.4,31,15,1,14,16,8,2
1232,Lovre Kalinić,0,0,0,0,0,0,1,0.0,1,0,0,0,0,0,0
1233,Nikola Kalinić,2,1,0,2,0,0,0,,0,2,0,2,1,1,0
1234,Salomon Kalou,1,0,1,0,0,0,2,0.0,2,2,0,2,0,1,0
1235,Samuel Kalu,33,17,19,12,2,16,36,44.4,20,13,1,12,24,10,0
1236,Daichi Kamada,29,20,7,17,5,8,42,19.0,34,16,1,15,10,6,0
1237,François Kamano,12,6,5,4,3,8,15,53.3,7,5,0,5,3,2,0
1238,Boubacar Kamara,67,34,37,27,3,27,57,47.4,30,27,14,13,34,53,1
1239,Hassane Kamara,58,47,40,14,4,24,35,68.6,11,17,2,15,58,58,0
1240,Kevin Kampl,17,11,7,10,0,7,23,30.4,16,7,2,5,16,6,0
1241,Harry Kane,18,12,3,12,3,4,17,23.5,13,17,7,10,6,30,0
1242,Lee Kang-in,3,1,0,2,1,3,6,50.0,3,5,0,5,3,0,0
1243,Wilfried Kanga,0,0,0,0,0,0,1,0.0,1,0,0,0,0,0,0
1244,N'Golo Kanté,44,20,22,14,8,17,36,47.2,19,29,5,24,44,32,2
1245,Stefanos Kapino,0,0,0,0,0,0,0,,0,0,0,0,1,0,0
1246,Wilfrid Kaptoum,5,2,3,2,0,3,3,100.0,0,4,1,3,1,3,0
1247,Kenan Karaman,11,5,2,5,4,4,9,44.4,5,9,4,5,2,7,0
1248,Yann Karamoh,10,7,5,4,1,3,9,33.3,6,5,0,5,2,3,0
1249,Mamoudou Karamoko,0,0,0,0,0,0,0,,0,0,0,0,0,0,0
1250,Florian Kastenmeier,1,1,1,0,0,0,0,,0,0,0,0,2,3,1
1251,Noah Katterbach,29,23,21,8,0,11,28,39.3,17,12,1,11,29,26,0
1252,Moise Kean,6,6,5,1,0,0,0,,0,4,0,4,5,1,1
1253,Michael Keane,31,16,18,12,1,14,24,58.3,10,35,28,7,44,152,0
1254,Thilo Kehrer,10,7,4,5,1,5,10,50.0,5,2,0,2,1,2,1
1255,Jules Keita,4,3,2,1,1,1,6,16.7,5,1,0,1,3,0,0
1256,Naby Keïta,30,14,8,16,6,11,26,42.3,15,18,0,18,10,4,0
1257,Yannik Keitel,2,1,1,1,0,0,6,0.0,6,3,1,2,4,4,0
1258,Lloyd Kelly,7,3,3,4,0,6,7,85.7,1,9,5,4,6,15,1
1259,Martin Kelly,23,18,19,4,0,14,31,45.2,17,18,10,8,16,86,1
1260,Kenedy,9,5,3,3,3,2,5,40.0,3,10,0,10,11,4,0
1261,Jonjoe Kenny,49,29,24,19,6,26,51,51.0,25,45,10,35,26,79,0
1262,Franck Kessié,54,29,28,18,8,16,52,30.8,36,34,5,29,34,32,2
1263,Saîf-Eddine Khaoui,3,1,0,3,0,2,5,40.0,3,2,0,2,1,4,0
1264,Wahbi Khazri,17,9,5,7,5,9,27,33.3,18,11,0,11,4,0,0
1265,Rani Khedira,60,36,21,35,4,18,45,40.0,27,47,12,35,48,62,0
1266,Sami Khedira,14,7,3,8,3,4,19,21.1,15,12,1,11,3,13,0
1267,Kiké,13,7,0,5,8,4,12,33.3,8,15,1,14,1,9,0
1268,Luca Kilian,33,24,27,6,0,22,41,53.7,19,20,9,11,12,67,0
1269,Max Kilman,4,2,1,3,0,2,2,100.0,0,1,1,0,4,7,0
1270,Joshua Kimmich,52,29,21,20,11,22,55,40.0,33,38,9,29,29,29,0
1271,Presnel Kimpembe,33,25,25,8,0,14,20,70.0,6,7,3,4,21,33,1
1272,Joshua King,16,6,4,8,4,4,16,25.0,12,20,3,17,8,9,0
1273,Simon Kjær,9,6,1,8,0,3,4,75.0,1,5,4,1,7,10,1
1274,Simon Kjær,22,13,17,5,0,10,18,55.6,8,20,16,4,15,52,0
1275,Davy Klaassen,55,43,19,23,13,19,57,33.3,38,46,18,28,38,45,2
1276,Felix Klaus,24,16,4,13,7,7,19,36.8,12,10,2,8,3,5,0
1277,Ragnar Klavan,29,16,20,9,0,14,28,50.0,14,29,19,10,25,118,1
1278,Timm Klose,8,2,5,2,1,7,11,63.6,4,6,6,0,7,29,0
1279,Lukas Klostermann,45,26,24,16,5,18,31,58.1,13,34,16,18,26,101,2
1280,Justin Kluivert,17,11,4,8,5,7,16,43.8,9,15,0,15,6,7,0
1281,Lukas Klünter,44,31,26,16,2,20,30,66.7,10,16,4,12,27,61,1
1282,Robin Knoche,29,14,24,5,0,17,30,56.7,13,19,11,8,27,77,1
1283,Robin Koch,34,20,20,13,1,11,26,42.3,15,30,22,8,45,94,4
1284,Giorgi Kochorashvili,0,0,0,0,0,0,0,,0,0,0,0,0,0,0
1285,Jonathan Kodjia,0,0,0,0,0,0,1,0.0,1,0,0,0,0,1,0
1286,Kenan Kodro,1,0,0,0,1,0,2,0.0,2,1,0,1,0,4,0
1287,Dominik Kohr,44,35,15,25,4,18,53,34.0,35,31,11,20,30,16,0
1288,Koke,70,42,27,30,13,29,89,32.6,60,33,8,25,29,28,2
1289,Aleksandar Kolarov,37,28,16,16,5,20,37,54.1,17,20,9,11,31,57,0
1290,Sead Kolašinac,29,16,18,6,5,12,23,52.2,11,14,4,10,25,34,1
1291,Timothée Kolodziejczak,17,10,13,4,0,9,21,42.9,12,8,3,5,30,44,2
1292,Ghislain Konan,43,26,28,14,1,19,28,67.9,9,13,3,10,24,34,0
1293,Ibrahima Konaté,11,6,10,1,0,2,7,28.6,5,9,4,5,5,35,1
1294,Moussa Konaté,3,0,0,3,0,0,2,0.0,2,2,0,2,1,1,0
1295,Geoffrey Kondogbia,63,40,40,18,5,19,51,37.3,32,25,6,19,57,36,2
1296,Lamine Koné,31,21,20,10,1,12,17,70.6,5,8,5,3,25,47,1
1297,Manu Koné,35,20,17,14,4,13,30,43.3,17,15,1,14,19,10,1
1298,Moussa Koné,2,0,1,1,0,1,3,33.3,2,1,0,1,1,0,0
1299,Youssouf Koné,22,14,17,3,2,12,20,60.0,8,2,1,1,8,15,0
1300,Ezri Konsa,18,9,12,6,0,7,16,43.8,9,34,24,10,25,70,2
1301,Pascal Köpke,0,0,0,0,0,0,0,,0,0,0,0,0,0,0
1302,Laurent Koscielny,28,13,24,4,0,10,20,50.0,10,23,19,4,26,104,0
1303,Filip Kostić,59,38,30,20,9,22,59,37.3,37,45,2,43,23,16,0
1304,Christian Kouamé,3,2,0,3,0,0,1,0.0,1,5,1,4,1,1,0
1305,Christian Kouamé,2,1,0,1,1,0,8,0.0,8,8,2,6,1,13,0
1306,Tomáš Koubek,3,2,3,0,0,3,11,27.3,8,1,0,1,1,23,3
1307,Kalidou Koulibaly,51,33,30,17,4,17,28,60.7,11,28,16,12,31,61,1
1308,Efthimis Koulouris,13,8,5,5,3,3,13,23.1,10,8,4,4,3,16,0
1309,Jules Koundé,23,12,14,5,4,10,18,55.6,8,16,12,4,23,91,2
1310,Leonardo Koutris,1,1,0,0,1,1,2,50.0,1,1,1,0,1,6,0
1311,Cheikhou Kouyaté,67,32,43,20,4,26,48,54.2,22,35,11,24,43,58,1
1312,Mateo Kovačić,63,38,29,32,2,26,65,40.0,39,15,1,14,22,16,1
1313,Dawid Kownacki,13,8,5,7,1,9,20,45.0,11,13,2,11,6,8,0
1314,İsmail Köybaşı,4,4,3,1,0,0,2,0.0,2,4,0,4,5,2,0
1315,Thomas Kraft,0,0,0,0,0,0,0,,0,0,0,0,1,0,0
1316,Emil Krafth,18,12,15,2,1,9,20,45.0,11,11,8,3,8,45,0
1317,Andrej Kramarić,2,1,1,0,1,1,7,14.3,6,6,0,6,3,4,0
1318,Christoph Kramer,45,29,19,21,5,19,49,38.8,30,22,3,19,14,19,0
1319,Tom Krauß,1,1,0,1,0,1,2,50.0,1,0,0,0,0,0,0
1320,Ladislav Krejčí,15,10,6,7,2,9,19,47.4,10,7,4,3,10,23,0
1321,Rene Krhin,4,3,1,3,0,2,2,100.0,0,1,0,1,6,17,0
1322,Felix Kroos,17,9,9,6,2,8,15,53.3,7,6,3,3,3,13,1
1323,Toni Kroos,56,28,18,29,9,18,70,25.7,52,27,0,27,23,15,0
1324,Tim Krul,0,0,0,0,0,0,1,0.0,1,2,0,2,1,13,1
1325,Rade Krunić,16,8,8,5,3,9,16,56.3,7,5,0,5,9,5,0
1326,Lukas Kübler,1,1,0,1,0,1,5,20.0,4,2,0,2,1,6,0
1327,Takefusa Kubo,34,22,16,12,6,15,44,34.1,29,19,1,18,23,10,0
1328,Juraj Kucka,43,22,21,16,6,14,61,23.0,47,21,4,17,29,36,0
1329,Dejan Kulusevski,41,21,10,24,7,19,64,29.7,45,25,1,24,23,17,0
1330,Marash Kumbulla,40,24,21,17,2,19,36,52.8,17,33,24,9,50,86,3
1331,Pierre Kunde,34,17,15,18,1,12,30,40.0,18,16,4,12,26,55,0
1332,Jasmin Kurtić,20,7,8,8,4,6,27,22.2,21,14,2,12,10,20,1
1333,Jasmin Kurtić,32,23,19,10,3,13,35,37.1,22,19,5,14,15,27,2
1334,Layvin Kurzawa,23,16,5,14,4,11,23,47.8,12,12,1,11,18,24,1
1335,Dereck Kutesa,6,5,3,2,1,3,9,33.3,6,5,0,5,1,1,0
1336,Ahmed Kutucu,11,7,3,6,2,4,15,26.7,11,5,0,5,2,5,0
1337,Enock Kwateng,36,22,17,17,2,22,47,46.8,25,16,6,10,22,41,0
1338,Giorgos Kyriakopoulos,35,18,22,7,6,18,32,56.3,14,19,6,13,18,41,0
1339,Antonino La Gumina,0,0,0,0,0,0,0,,0,0,0,0,0,1,0
1340,Andrea La Mantia,1,0,1,0,0,1,5,20.0,4,3,0,3,7,11,0
1341,Gaëtan Laborde,21,12,4,10,7,9,38,23.7,29,21,0,21,7,32,1
1342,Alexandre Lacazette,31,16,8,21,2,9,24,37.5,15,14,0,14,7,15,0
1343,Riccardo Ladinetti,2,2,0,2,0,1,1,100.0,0,0,0,0,4,0,1
1344,Alban Lafont,1,1,1,0,0,1,1,100.0,0,0,0,0,0,12,0
1345,Víctor Laguardia,21,15,15,6,0,16,30,53.3,14,24,18,6,37,131,1
1346,Jack Lahne,1,1,0,0,1,0,0,,0,0,0,0,0,0,0
1347,Konrad Laimer,91,45,30,46,15,43,102,42.2,59,51,8,43,34,14,0
1348,Stefan Lainer,51,30,25,19,7,24,54,44.4,30,38,7,31,29,71,0
1349,Diego Lainez,6,5,2,4,0,5,8,62.5,3,6,0,6,1,1,0
1350,Kenny Lala,29,16,17,11,1,11,27,40.7,16,14,5,9,20,40,1
1351,Adam Lallana,19,9,7,9,3,6,21,28.6,15,7,0,7,5,3,0
1352,Érik Lamela,24,20,9,13,2,2,21,9.5,19,12,3,9,8,10,0
1353,Tariq Lamptey,2,2,1,1,0,2,2,100.0,0,0,0,0,0,0,0
1354,Tariq Lamptey,7,6,6,1,0,2,9,22.2,7,6,0,6,16,17,0
1355,Loïck Landre,16,9,12,3,1,7,11,63.6,4,12,9,3,17,34,0
1356,Michael Lang,8,5,3,5,0,6,12,50.0,6,5,1,4,7,22,0
1357,Sebastian Langkamp,3,2,3,0,0,2,4,50.0,2,5,3,2,3,11,1
1358,Henri Lansbury,6,2,3,1,2,2,8,25.0,6,4,0,4,0,3,0
1359,Manuel Lanzini,14,9,6,6,2,7,39,17.9,32,9,1,8,10,3,0
1360,Gianluca Lapadula,15,8,6,8,1,5,16,31.3,11,2,0,2,1,14,0
1361,Aymeric Laporte,13,6,6,7,0,4,9,44.4,5,6,5,1,20,26,1
1362,Danilo Larangeira,34,17,19,15,0,16,28,57.1,12,54,39,15,30,99,0
1363,Larra,2,2,0,1,1,0,0,,0,1,0,1,0,0,0
1364,Gautier Larsonneur,2,1,2,0,0,2,4,50.0,2,1,0,1,4,14,3
1365,Kevin Lasagna,27,14,7,13,7,6,31,19.4,25,23,1,22,10,18,1
1366,Jamaal Lascelles,14,3,10,4,0,4,9,44.4,5,23,20,3,28,116,1
1367,Paul Lasne,25,13,13,11,1,6,20,30.0,14,7,2,5,7,5,0
1368,Toni Lato,22,15,11,8,3,9,10,90.0,1,9,1,8,8,13,1
1369,Danny Latza,33,19,15,17,1,16,49,32.7,33,22,5,17,17,24,0
1370,Vincent Laurini,26,22,11,11,4,14,18,77.8,4,10,3,7,11,29,0
1371,Wesley Lautoa,54,29,24,28,2,28,63,44.4,35,31,16,15,42,48,2
1372,Diego Laxalt,19,10,10,6,3,6,20,30.0,14,12,4,8,6,20,0
1373,Diego Laxalt,3,3,3,0,0,1,3,33.3,2,4,0,4,0,3,0
1374,Valentino Lazaro,13,9,11,2,0,11,18,61.1,7,2,0,2,3,4,0
1375,Valentino Lazaro,6,5,3,2,1,4,8,50.0,4,5,0,5,1,8,1
1376,Darko Lazović,26,16,14,8,4,14,27,51.9,13,15,4,11,23,53,0
1377,Manuel Lazzari,20,11,10,7,3,10,31,32.3,21,11,1,10,8,34,0
1378,Mickaël Le Bihan,0,0,0,0,0,0,2,0.0,2,0,0,0,0,2,0
1379,Robin Le Normand,48,27,33,15,0,26,35,74.3,9,20,7,13,20,99,0
1380,Damien Le Tallec,52,27,20,28,4,24,69,34.8,45,38,18,20,38,59,0
1381,James Lea Siliki,28,16,19,9,0,16,29,55.2,13,15,4,11,12,12,0
1382,Rafael Leão,7,4,2,5,0,3,9,33.3,6,4,0,4,0,5,0
1383,Adrien Lebeau,1,1,1,0,0,0,1,0.0,1,1,0,1,0,0,0
1384,Mathew Leckie,3,1,1,2,0,2,3,66.7,1,6,0,6,2,2,1
1385,Benjamin Lecomte,0,0,0,0,0,0,1,0.0,1,1,0,1,0,10,5
1386,Pierre Lees-Melou,63,27,34,21,8,31,88,35.2,57,38,12,26,32,43,0
1387,Jordan Lefort,3,2,2,1,0,3,5,60.0,2,4,1,3,9,29,0
1388,Wu Lei,13,8,5,6,2,4,38,10.5,34,32,1,31,15,19,1
1389,Toni Leistner,19,12,10,9,0,5,13,38.5,8,16,7,9,32,57,0
1390,Moritz Leitner,16,9,8,7,1,9,25,36.0,16,14,4,10,9,10,1
1391,Lucas Leiva,60,35,25,31,4,28,72,38.9,44,29,6,23,47,34,1
1392,Florian Lejeune,8,2,6,2,0,4,7,57.1,3,6,2,4,10,15,2
1393,Iñigo Lekue,22,12,14,6,2,11,14,78.6,3,7,0,7,3,11,0
1394,Nicolas Lemaître,0,0,0,0,0,0,1,0.0,1,0,0,0,1,1,1
1395,Thomas Lemar,12,8,4,5,3,2,11,18.2,9,14,1,13,6,6,0
1396,Tim Lemperle,0,0,0,0,0,0,0,,0,0,0,0,0,0,0
1397,Clément Lenglet,44,31,29,15,0,16,32,50.0,16,29,15,14,35,79,1
1398,Aaron Lennon,14,8,7,4,3,7,10,70.0,3,6,1,5,8,3,0
1399,Bernd Leno,0,0,0,0,0,0,2,0.0,2,0,0,0,0,9,2
1400,Christopher Lenz,63,37,37,20,6,26,49,53.1,23,46,11,35,43,65,0
1401,Donovan Léon,0,0,0,0,0,0,0,,0,1,0,1,0,0,0
1402,Pedro León,28,20,8,9,11,12,25,48.0,13,18,1,17,19,7,0
1403,Sergio León,3,3,0,3,0,2,4,50.0,2,3,0,3,1,2,0
1404,Lukas Lerager,29,19,13,12,4,10,34,29.4,24,20,5,15,8,15,1
1405,Mehdi Léris,13,11,4,2,7,7,19,36.8,12,12,4,8,6,6,0
1406,Jefferson Lerma,54,32,17,31,6,22,48,45.8,26,28,12,16,57,54,1
1407,Karlo Letica,0,0,0,0,0,0,2,0.0,2,0,0,0,0,4,3
1408,Robert Lewandowski,18,9,3,9,6,3,15,20.0,12,13,1,12,7,13,0
1409,Jamal Lewis,51,35,42,6,3,22,36,61.1,14,27,12,15,25,68,0
1410,Aaron Leya Iseka,2,0,0,2,0,0,3,0.0,3,5,0,5,1,7,0
1411,Stephan Lichtsteiner,23,14,16,5,2,10,22,45.5,12,15,7,8,16,35,0
1412,Dimitri Liénard,37,24,10,22,5,18,39,46.2,21,18,4,14,17,25,0
1413,Philipp Lienhart,11,4,10,1,0,6,13,46.2,7,24,17,7,28,86,0
1414,Matthijs de Ligt,25,15,14,10,1,13,23,56.5,10,30,23,7,25,101,2
1415,Isaac Lihadji,0,0,0,0,0,0,0,,0,0,0,0,0,0,0
1416,Lillo,4,2,2,2,0,1,1,100.0,0,2,1,1,2,8,0
1417,Anderson Lima,4,0,3,1,0,1,1,100.0,0,4,0,4,0,0,0
1418,Lucas Lima,7,2,4,3,0,2,5,40.0,3,2,0,2,1,3,0
1419,Anthony Limbombe,3,2,1,2,0,1,1,100.0,0,1,0,1,0,3,0
1420,Victor Lindelöf,29,15,16,12,1,17,20,85.0,3,25,16,9,26,129,0
1421,Karol Linetty,61,32,24,25,12,21,65,32.3,44,26,3,23,26,17,0
1422,Jesse Lingard,15,8,6,4,5,5,18,27.8,13,5,0,5,3,0,0
1423,Pol Lirola,34,20,18,10,6,21,38,55.3,17,16,4,12,26,52,0
1424,Diego Llorente,30,14,20,9,1,16,28,57.1,12,14,7,7,28,101,5
1425,Fernando Llorente,0,0,0,0,0,0,1,0.0,1,4,0,4,1,3,0
1426,Marcos Llorente,29,15,7,16,6,7,21,33.3,14,24,4,20,14,9,0
1427,Gautier Lloris,5,3,5,0,0,4,5,80.0,1,3,3,0,2,11,0
1428,Hugo Lloris,0,0,0,0,0,0,0,,0,0,0,0,1,3,2
1429,Giovani Lo Celso,51,29,12,33,6,12,59,20.3,47,20,4,16,9,19,0
1430,Stanislav Lobotka,11,9,3,5,3,5,12,41.7,7,3,1,2,9,2,0
1431,Stanislav Lobotka,19,11,13,5,1,4,19,21.1,15,8,2,6,8,7,0
1432,Jürgen Locadia,0,0,0,0,0,0,0,,0,0,0,0,0,0,0
1433,Jürgen Locadia,5,4,0,4,1,1,4,25.0,3,1,0,1,0,3,0
1434,Manuel Locatelli,76,50,35,37,4,33,69,47.8,36,42,14,28,33,36,0
1435,Renan Lodi,73,46,28,35,10,40,65,61.5,25,28,7,21,38,56,0
1436,Ruben Loftus-Cheek,0,0,0,0,0,0,2,0.0,2,1,1,0,2,2,0
1437,Enzo Loiodice,6,4,1,4,1,1,3,33.3,2,2,0,2,2,1,0
1438,Kevin Long,7,5,6,1,0,4,9,44.4,5,9,7,2,4,31,0
1439,Shane Long,19,10,5,8,6,7,19,36.8,12,12,0,12,4,16,0
1440,Matthew Longstaff,3,1,2,1,0,3,14,21.4,11,4,1,3,5,3,0
1441,Sean Longstaff,35,19,17,16,2,20,50,40.0,30,23,5,18,19,20,2
1442,Ademola Lookman,6,4,3,1,2,1,1,100.0,0,3,0,3,1,0,1
1443,Anthony Lopes,0,0,0,0,0,0,0,,0,0,0,0,1,11,0
1444,Rony Lopes,0,0,0,0,0,0,0,,0,0,0,0,2,0,0
1445,Rony Lopes,1,0,0,1,0,0,0,,0,0,0,0,0,0,0
1446,Adrián López,7,5,1,5,1,2,19,10.5,17,6,2,4,4,8,0
1447,David López,38,20,15,20,3,13,41,31.7,28,28,13,15,35,63,3
1448,Diego López,2,2,2,0,0,1,2,50.0,1,0,0,0,2,8,1
1449,Javi López,6,5,4,2,0,4,5,80.0,1,1,1,0,1,5,0
1450,Javi López,47,34,23,18,6,19,40,47.5,21,12,6,6,21,38,2
1451,Lluis López,4,2,3,1,0,2,2,100.0,0,4,0,4,1,6,1
1452,Maxime Lopez,16,10,5,8,3,4,26,15.4,22,8,2,6,8,1,0
1453,Pau López,1,0,1,0,0,1,5,20.0,4,0,0,0,1,10,3
1454,Roberto López,4,2,1,1,2,2,2,100.0,0,0,0,0,0,0,0
1455,Unai López,30,22,8,18,4,10,41,24.4,31,13,2,11,18,12,1
1456,Iker Losada,0,0,0,0,0,0,0,,0,0,0,0,0,0,0
1457,Albert Lottin,2,0,2,0,0,1,4,25.0,3,0,0,0,2,2,0
1458,Imran Louza,53,27,18,27,8,19,46,41.3,27,18,2,16,17,7,0
1459,Matteo Lovato,0,0,0,0,0,0,0,,0,0,0,0,0,1,0
1460,Dejan Lovren,13,8,10,3,0,7,12,58.3,5,9,6,3,10,42,0
1461,Eduard Löwen,10,8,6,2,2,6,18,33.3,12,11,2,9,5,7,0
1462,Eduard Löwen,9,6,3,6,0,5,11,45.5,6,2,1,1,7,2,0
1463,Matthew Lowton,41,22,20,18,3,22,33,66.7,11,20,6,14,27,57,1
1464,Hirving Lozano,6,4,1,5,0,2,15,13.3,13,13,0,13,5,5,0
1465,Pol Lozano,5,3,3,2,0,3,7,42.9,4,3,0,3,1,2,0
1466,Jan Luca Rumpf,0,0,0,0,0,0,0,,0,0,0,0,0,2,0
1467,Jean Lucas,16,7,8,5,3,2,9,22.2,7,2,2,0,2,0,0
1468,Fabio Lucioni,29,13,20,9,0,14,32,43.8,18,48,38,10,36,169,5
1469,José Luis Gayà,44,30,29,12,3,28,41,68.3,13,22,9,13,18,48,1
1470,José Luis Morales,17,8,5,9,3,6,34,17.6,28,14,1,13,6,5,1
1471,José Luis Palomino,81,44,46,33,2,28,54,51.9,26,39,14,25,61,74,2
1472,José Luis Rodríguez,0,0,0,0,0,0,2,0.0,2,0,0,0,0,0,0
1473,David Luiz,28,16,14,14,0,13,24,54.2,11,42,37,5,32,133,2
1474,Douglas Luiz,46,24,25,17,4,19,65,29.2,46,42,15,27,36,54,1
1475,Jordan Lukaku,4,2,1,1,2,2,4,50.0,2,2,1,1,0,9,0
1476,Romelu Lukaku,13,7,4,7,2,3,10,30.0,7,14,6,8,1,28,0
1477,Dodi Lukebakio,25,18,13,8,4,10,28,35.7,18,22,4,18,10,14,0
1478,Saša Lukić,29,17,8,19,2,10,35,28.6,25,21,7,14,29,15,0
1479,Senad Lulić,21,13,10,7,4,11,41,26.8,30,20,4,16,21,28,1
1480,John Lundstram,46,30,18,21,7,21,65,32.3,44,18,4,14,33,46,1
1481,Sebastiano Luperto,12,9,7,3,2,6,9,66.7,3,5,3,2,6,16,0
1482,Arnaud Lusamba,20,11,8,10,2,7,23,30.4,16,9,0,9,5,6,1
1483,Andreas Luthe,1,0,1,0,0,1,2,50.0,1,0,0,0,0,5,1
1484,Lyanco,23,13,9,12,2,7,13,53.8,6,29,19,10,23,54,2
1485,Charalambos Lykogiannis,14,9,9,3,2,7,18,38.9,11,25,9,16,23,71,0
1486,Yann M'Vila,29,14,12,16,1,12,43,27.9,31,14,4,10,40,47,1
1487,Alexis Mac Allister,9,5,4,3,2,5,9,55.6,4,12,0,12,1,2,0
1488,Darwin Machís,23,13,11,8,4,8,23,34.8,15,22,4,18,31,9,0
1489,Yvann Macon,0,0,0,0,0,0,1,0.0,1,2,0,2,3,4,0
1490,James Maddison,59,30,13,31,15,23,68,33.8,45,16,0,16,9,7,1
1491,Gabriel Magalhães,41,29,27,11,3,15,22,68.2,7,27,18,9,22,86,2
1492,Lisandro Magallán,22,15,10,12,0,8,14,57.1,6,17,6,11,16,43,1
1493,Francesco Magnanelli,25,13,9,12,4,11,35,31.4,24,12,6,6,19,23,1
1494,Giangiacomo Magnani,0,0,0,0,0,0,1,0.0,1,2,2,0,2,6,0
1495,Giangiacomo Magnani,0,0,0,0,0,0,0,,0,2,1,1,2,7,0
1496,Hugo Magnetti,16,10,7,7,2,5,9,55.6,4,4,0,4,7,4,0
1497,Harry Maguire,37,23,23,14,0,18,34,52.9,16,31,22,9,72,159,0
1498,Abdallahi Mahmoud,4,4,2,1,1,1,6,16.7,5,0,0,0,5,2,0
1499,Riyad Mahrez,28,14,11,9,8,11,38,28.9,27,31,1,30,18,8,2
1500,Thiago Maia,4,4,1,3,0,0,1,0.0,1,0,0,0,1,1,0
1501,Arne Maier,9,7,6,1,2,1,10,10.0,9,5,0,5,7,2,1
1502,Habib Maïga,84,50,36,38,10,24,64,37.5,40,39,4,35,34,39,2
1503,Mike Maignan,0,0,0,0,0,0,0,,0,0,0,0,2,5,0
1504,Ainsley Maitland-Niles,41,23,34,5,2,22,43,51.2,21,12,3,9,28,38,0
1505,Josh Maja,5,2,0,2,3,1,10,10.0,9,8,4,4,1,3,0
1506,Abdul Majeed Waris,6,4,4,2,0,3,8,37.5,5,2,0,2,4,0,0
1507,Žan Majer,39,18,19,12,8,17,56,30.4,39,27,6,21,26,18,1
1508,Jean-Victor Makengo,14,11,3,10,1,4,13,30.8,9,7,1,6,3,5,1
1509,Nemanja Maksimović,49,28,12,31,6,10,44,22.7,34,37,7,30,56,30,1
1510,Nikola Maksimović,35,24,21,14,0,10,21,47.6,11,19,11,8,30,64,1
1511,Kévin Malcuit,8,6,4,3,1,5,6,83.3,1,4,1,3,3,2,0
1512,Daniel Maldini,0,0,0,0,0,0,2,0.0,2,1,0,1,1,0,0
1513,Ruslan Malinovskyi,22,14,2,17,3,9,31,29.0,22,13,2,11,5,5,0
1514,Yunus Mallı,8,3,1,5,2,5,10,50.0,5,2,0,2,7,7,0
1515,Hugo Mallo,62,42,44,16,2,27,48,56.3,21,24,8,16,22,97,1
1516,Streli Mamba,15,9,0,9,6,1,13,7.7,12,12,2,10,6,2,0
1517,Hianga Mananga Mbock,1,1,1,0,0,0,0,,0,0,0,0,4,0,0
1518,Vincent Manceau,34,22,18,13,3,16,36,44.4,20,16,3,13,22,51,0
1519,Gianluca Mancini,49,26,26,18,5,22,44,50.0,22,32,15,17,60,98,1
1520,Marco Mancosu,32,18,11,16,5,10,46,21.7,36,34,9,25,16,15,1
1521,Steve Mandanda,3,1,3,0,0,3,4,75.0,1,0,0,0,1,2,4
1522,Reinildo Mandava,37,21,23,11,3,25,41,61.0,16,16,1,15,19,20,0
1523,Aïssa Mandi,33,15,22,8,3,18,28,64.3,10,29,15,14,38,93,0
1524,Rolando Mandragora,47,24,15,25,7,15,55,27.3,40,30,5,25,26,25,0
1525,Sadio Mané,44,32,9,20,15,13,40,32.5,27,19,0,19,13,11,2
1526,Eliaquim Mangala,4,4,3,1,0,1,2,50.0,1,7,6,1,7,40,0
1527,Thomas Mangani,33,23,15,16,2,14,47,29.8,33,17,2,15,12,20,1
1528,Massimiliano Mangraviti,8,6,1,6,1,3,6,50.0,3,11,6,5,8,43,0
1529,Kostas Manolas,23,15,13,10,0,10,17,58.8,7,19,14,5,25,76,1
1530,Javier Manquillo,39,26,27,8,4,24,38,63.2,14,14,2,12,18,56,0
1531,Giacomo Manzari,0,0,0,0,0,0,0,,0,0,0,0,0,0,0
1532,Myziane Maolida,14,10,5,6,3,5,12,41.7,7,8,0,8,3,3,0
1533,Faitout Maouassa,51,33,27,20,4,14,26,53.8,12,13,5,8,23,59,0
1534,Fernando Marçal,28,18,18,7,3,13,26,50.0,13,7,3,4,26,32,0
1535,Marcelo,19,11,8,8,3,9,28,32.1,19,19,2,17,18,21,0
1536,Marcelo,27,18,18,8,1,16,23,69.6,7,12,11,1,22,77,0
1537,Solly March,25,12,16,6,3,9,19,47.4,10,16,4,12,20,14,2
1538,Gian Marco Ferrari,9,5,6,3,0,4,8,50.0,4,25,22,3,26,41,1
1539,Óscar de Marcos,5,3,2,1,2,3,6,50.0,3,6,0,6,8,8,0
1540,Dario Maresic,0,0,0,0,0,0,0,,0,1,1,0,1,6,0
1541,Miguel Marí,0,0,0,0,0,0,0,,0,0,0,0,0,0,0
1542,Pablo Marí,2,1,2,0,0,0,0,,0,0,0,0,1,10,0
1543,José María Giménez,20,16,18,1,1,7,11,63.6,4,14,7,7,23,75,1
1544,Mariano,0,0,0,0,0,0,1,0.0,1,0,0,0,0,0,0
1545,Adrian Mariappa,20,14,15,4,1,11,30,36.7,19,22,7,15,11,73,0
1546,Jordan Marié,7,5,4,3,0,4,9,44.4,5,3,1,2,4,2,0
1547,Federico Marigosu,0,0,0,0,0,0,0,,0,0,0,0,0,1,0
1548,Adrián Marín,22,15,14,6,2,13,15,86.7,2,13,4,9,13,32,0
1549,Guillermo Maripán,1,1,1,0,0,1,2,50.0,1,0,0,0,2,10,0
1550,Guillermo Maripán,42,26,28,13,1,24,41,58.5,17,30,13,17,25,69,2
1551,Marlon,40,23,24,15,1,17,27,63.0,10,20,13,7,35,69,0
1552,Omar Marmoush,1,1,1,0,0,0,0,,0,1,0,1,1,0,0
1553,Gonzalo Maroni,3,1,1,1,1,3,7,42.9,4,1,0,1,3,0,0
1554,Marquinhos,39,20,17,18,4,11,26,42.3,15,25,8,17,25,31,1
1555,Bruno Martella,18,9,14,3,1,9,16,56.3,7,13,7,6,17,48,1
1556,Roger Martí,18,11,8,7,3,7,29,24.1,22,14,0,14,6,17,0
1557,Anthony Martial,15,12,1,4,10,1,16,6.3,15,18,1,17,5,17,0
1558,Aarón Martín,29,15,17,8,4,9,22,40.9,13,11,5,6,30,36,0
1559,Daniel Martín,0,0,0,0,0,0,0,,0,0,0,0,0,3,0
1560,David Martin,0,0,0,0,0,0,0,,0,0,0,0,0,1,1
1561,Jonas Martin,6,2,4,0,2,1,1,100.0,0,2,2,0,0,0,0
1562,Jonas Martin,5,3,4,0,1,1,3,33.3,2,3,0,3,1,3,0
1563,Josh Martin,1,0,0,0,1,0,0,,0,1,0,1,1,0,0
1564,Gabriel Martinelli,20,15,10,6,4,7,20,35.0,13,15,1,14,3,8,0
1565,Álex Martínez,0,0,0,0,0,0,0,,0,0,0,0,0,0,0
1566,Emiliano Martínez,0,0,0,0,0,0,0,,0,0,0,0,0,1,0
1567,Iñigo Martínez,48,30,33,13,2,27,47,57.4,20,28,13,15,39,140,0
1568,Javi Martínez,0,0,0,0,0,0,0,,0,0,0,0,0,1,0
1569,Javi Martínez,16,12,9,7,0,9,11,81.8,2,9,8,1,18,30,0
1570,José Martínez,21,16,12,8,1,14,25,56.0,11,6,4,2,18,46,0
1571,Lautaro Martínez,22,7,2,8,12,4,34,11.8,30,30,2,28,15,11,0
1572,Pablo Martínez,2,0,1,1,0,0,1,0.0,1,0,0,0,0,2,0
1573,Pablo Martinez,42,21,26,15,1,21,40,52.5,19,34,22,12,58,97,0
1574,Gelson Martins,30,22,11,15,4,17,42,40.5,25,9,2,7,19,10,1
1575,Adam Marušić,11,6,7,4,0,4,11,36.4,7,14,2,12,14,16,0
1576,Omar Mascarell,42,23,17,22,3,21,57,36.8,36,46,14,32,62,40,0
1577,Andrea Masiello,26,15,17,8,1,16,32,50.0,16,8,2,6,26,55,2
1578,Andrea Masiello,11,4,6,4,1,7,14,50.0,7,6,4,2,10,13,0
1579,Adam Masina,38,22,24,11,3,14,37,37.8,23,26,12,14,28,66,0
1580,Jordi Masip,1,1,1,0,0,0,2,0.0,2,0,0,0,1,7,3
1581,Arthur Masuaku,41,23,24,13,4,23,39,59.0,16,19,5,14,14,23,0
1582,Jaime Mata,21,13,3,11,7,3,20,15.0,17,16,1,15,7,15,0
1583,Juan Mata,7,3,1,5,1,2,7,28.6,5,5,1,4,0,2,0
1584,Aleš Matějů,48,27,33,9,6,23,45,51.1,22,41,24,17,37,109,3
1585,Jean-Philippe Mateta,2,2,0,2,0,0,6,0.0,6,3,2,1,1,11,0
1586,Nemanja Matić,46,24,23,19,4,20,43,46.5,23,21,8,13,22,28,1
1587,Joël Matip,13,9,4,7,2,4,11,36.4,7,8,4,4,12,38,0
1588,Rabbi Matondo,10,3,3,2,5,3,13,23.1,10,4,0,4,5,1,0
1589,Alessandro Matri,1,0,0,0,1,0,0,,0,1,0,1,0,1,0
1590,Federico Mattiello,30,21,19,7,4,11,27,40.7,16,20,7,13,18,22,0
1591,Blaise Matuidi,48,27,13,27,8,13,34,38.2,21,35,6,29,22,16,0
1592,Neal Maupay,20,12,1,13,6,9,29,31.0,20,24,0,24,4,10,0
1593,Stephy Mavididi,18,11,7,8,3,10,26,38.5,16,11,0,11,7,5,0
1594,Philipp Max,42,29,22,16,4,20,45,44.4,25,19,4,15,26,50,0
1595,Alexandru Maxim,4,2,1,2,1,1,3,33.3,2,0,0,0,1,1,0
1596,Eric Maxim Choupo-Moting,12,9,3,4,5,4,8,50.0,4,3,0,3,1,3,0
1597,Kévin Mayi,0,0,0,0,0,0,0,,0,0,0,0,0,0,0
1598,Borja Mayoral,12,3,4,6,2,2,13,15.4,11,11,0,11,4,6,0
1599,Luca Mazzitelli,1,1,0,1,0,1,1,100.0,0,0,0,0,0,0,0
1600,Kevin Mbabu,69,48,39,24,6,35,54,64.8,19,33,10,23,23,53,0
1601,Kylian Mbappé,7,2,1,5,1,3,10,30.0,7,4,0,4,3,0,0
1602,Ibrahima Mbaye,19,10,13,4,2,7,17,41.2,10,22,11,11,15,42,0
1603,Loïc Mbe Soh,2,2,2,0,0,2,2,100.0,0,0,0,0,1,0,0
1604,Isaac Mbenza,0,0,0,0,0,0,1,0.0,1,0,0,0,0,0,0
1605,Nathanael Mbuku,4,2,2,2,0,0,3,0.0,3,0,0,0,2,1,0
1606,James McArthur,88,51,43,34,11,37,106,34.9,69,69,19,50,60,56,0
1607,Oliver McBurnie,37,22,6,27,4,11,40,27.5,29,25,3,22,15,43,0
1608,Alex McCarthy,1,1,1,0,0,1,1,100.0,0,1,0,1,0,11,3
1609,James McCarthy,82,47,36,36,10,40,76,52.6,36,24,5,19,24,11,0
1610,John McGinn,53,35,19,23,11,18,62,29.0,44,25,1,24,25,18,0
1611,David McGoldrick,41,26,9,24,8,5,20,25.0,15,14,2,12,3,23,0
1612,Michael McGovern,0,0,0,0,0,0,0,,0,0,0,0,0,1,1
1613,Weston McKennie,38,20,17,16,5,13,40,32.5,27,38,12,26,46,39,0
1614,Kenny McLean,44,29,20,18,6,14,42,33.3,28,32,7,25,38,67,2
1615,Dwight McNeil,47,33,18,22,7,23,71,32.4,48,60,8,52,30,34,0
1616,Scott McTominay,43,22,14,25,4,17,32,53.1,15,25,5,20,31,34,2
1617,Biagio Meccariello,23,13,15,6,2,12,29,41.4,17,14,2,12,10,25,0
1618,Gary Medel,43,22,15,24,4,16,43,37.2,27,24,8,16,34,31,2
1619,Ben Mee,41,22,25,16,0,17,29,58.6,12,42,31,11,42,165,2
1620,Joshua Mees,8,5,3,4,1,4,12,33.3,8,3,0,3,2,4,0
1621,Admir Mehmedi,14,6,2,9,3,4,15,26.7,11,10,0,10,5,4,0
1622,Soualiho Meïté,32,18,14,13,5,12,35,34.3,23,31,6,25,24,36,0
1623,Farid El Melali,7,5,2,2,3,4,14,28.6,10,5,0,5,2,4,0
1624,Óscar Melendo,10,4,4,4,2,4,12,33.3,8,7,2,5,2,3,0
1625,Gonzalo Melero,20,13,9,9,2,7,27,25.9,20,12,3,9,9,15,1
1626,Arthur Melo,15,10,4,7,4,4,12,33.3,8,9,0,9,4,5,2
1627,Memphis,4,3,2,0,2,0,5,0.0,5,0,0,0,2,2,0
1628,Pedro Mendes,28,17,15,13,0,15,24,62.5,9,19,12,7,28,42,1
1629,Thiago Mendes,43,29,20,19,4,21,45,46.7,24,21,7,14,46,36,0
1630,Brais Méndez,26,11,14,9,3,12,39,30.8,27,20,0,20,12,23,1
1631,Édgar Méndez,11,7,4,6,1,5,13,38.5,8,10,2,8,5,7,0
1632,Stiven Mendoza,12,7,4,5,3,4,22,18.2,18,13,2,11,9,3,1
1633,Alexandre Mendy,5,1,1,0,4,1,4,25.0,3,4,1,3,0,10,0
1634,Benjamin Mendy,18,15,7,7,4,9,27,33.3,18,10,2,8,16,21,3
1635,Edouard Mendy,0,0,0,0,0,0,0,,0,0,0,0,0,5,1
1636,Ferland Mendy,32,26,20,9,3,14,18,77.8,4,19,5,14,22,30,1
1637,Nampalys Mendy,7,5,4,1,2,4,5,80.0,1,4,1,3,6,6,0
1638,Hamza Mendyl,49,32,31,14,4,29,46,63.0,17,16,4,12,23,47,0
1639,Chris Mepham,20,9,13,7,0,11,14,78.6,3,17,11,6,17,62,1
1640,Levent Mercan,0,0,0,0,0,0,0,,0,0,0,0,0,2,1
1641,Jorge Meré,6,5,2,4,0,1,2,50.0,1,13,11,2,14,30,0
1642,Alex Meret,0,0,0,0,0,0,2,0.0,2,1,0,1,1,7,2
1643,Fran Mérida,27,15,11,10,6,9,27,33.3,18,15,4,11,25,10,0
1644,Mikel Merino,79,52,20,44,15,28,86,32.6,58,46,8,38,51,52,0
1645,Sabin Merino,0,0,0,0,0,0,0,,0,0,0,0,0,0,0
1646,Yıldırım Mert Çetin,5,1,4,1,0,3,5,60.0,2,4,3,1,4,8,1
1647,Dries Mertens,13,9,1,8,4,2,27,7.4,25,10,1,9,7,4,0
1648,Roque Mesa,40,21,17,18,5,13,44,29.5,31,13,4,9,11,8,0
1649,Lionel Messi,21,10,4,7,10,3,21,14.3,18,9,0,9,7,1,0
1650,Thomas Meunier,27,21,9,12,6,16,26,61.5,10,17,5,12,18,19,1
1651,Mexer,16,11,14,1,1,10,30,33.3,20,14,13,1,15,47,0
1652,Max Meyer,19,11,10,9,0,8,18,44.4,10,6,1,5,7,4,0
1653,Kingsley Michael,2,1,0,2,0,0,0,,0,0,0,0,1,1,0
1654,Míchel,50,28,26,19,5,22,75,29.3,53,22,4,18,33,41,1
1655,Sven Michel,14,12,3,5,6,3,20,15.0,17,13,2,11,7,7,0
1656,Miguel,2,1,1,0,1,1,2,50.0,1,3,1,2,0,1,0
1657,Florian Miguel,51,25,27,20,4,31,52,59.6,21,19,4,15,33,32,0
1658,Georges Mikautadze,1,0,0,0,1,0,0,,0,0,0,0,0,0,0
1659,Nikola Milenković,46,25,30,16,0,11,31,35.5,20,39,21,18,29,129,1
1660,Arkadiusz Milik,12,5,4,1,7,3,11,27.3,8,11,1,10,2,12,0
1661,Sergej Milinković-Savić,60,35,25,24,11,15,79,19.0,64,67,16,51,37,60,1
1662,Éder Militão,25,15,15,9,1,10,17,58.8,7,12,6,6,20,42,0
1663,Luka Milivojević,61,32,32,25,4,35,84,41.7,49,30,7,23,42,39,4
1664,Vincenzo Millico,1,0,1,0,0,1,3,33.3,2,2,0,2,0,1,0
1665,James Milner,16,10,3,10,3,6,26,23.1,20,12,3,9,7,17,1
1666,Santi Mina,13,8,8,5,0,5,38,13.2,33,19,2,17,10,27,0
1667,Yerry Mina,39,22,25,12,2,18,24,75.0,6,20,14,6,28,102,1
1668,Takumi Minamino,3,3,0,2,1,2,10,20.0,8,3,0,3,0,3,0
1669,Tyrone Mings,15,11,11,3,1,10,13,76.9,3,56,48,8,30,190,4
1670,Jorge Miramón,52,27,35,13,4,26,45,57.8,19,30,8,22,46,61,1
1671,Juan Miranda,14,10,8,6,0,6,18,33.3,12,12,4,8,10,27,1
1672,Antonio Mirante,0,0,0,0,0,0,1,0.0,1,0,0,0,0,2,1
1673,Simone Missiroli,42,27,18,20,4,13,43,30.2,30,42,27,15,54,62,1
1674,Tyrick Mitchell,5,2,2,2,1,1,7,14.3,6,2,0,2,2,3,0
1675,Stefan Mitrović,15,9,10,5,0,6,14,42.9,8,14,9,5,23,90,3
1676,Maximilian Mittelstädt,61,38,31,25,5,26,54,48.1,28,38,6,32,53,64,0
1677,Henrikh Mkhitaryan,0,0,0,0,0,0,2,0.0,2,3,0,3,0,1,0
1678,Henrikh Mkhitaryan,32,22,10,17,5,19,45,42.2,26,27,3,24,11,6,0
1679,Anthony Modeste,10,5,1,5,4,1,10,10.0,9,5,3,2,0,19,0
1680,Luka Modrić,37,18,9,15,13,16,41,39.0,25,10,2,8,22,12,0
1681,Kevin Möhwald,2,1,1,1,0,1,2,50.0,1,0,0,0,0,1,0
1682,Niklas Moisander,27,15,19,6,2,11,26,42.3,15,37,19,18,49,85,0
1683,Jorge Molina,8,2,0,4,4,0,12,0.0,12,13,2,11,4,18,0
1684,Florent Mollet,13,11,3,8,2,7,28,25.0,21,9,1,8,9,2,0
1685,Jon Moncayola,52,30,26,22,4,27,54,50.0,27,29,5,24,16,23,1
1686,Gabriele Moncini,1,0,0,1,0,0,0,,0,2,1,1,1,0,0
1687,Thomas Monconduit,26,12,6,18,2,9,26,34.6,17,11,4,7,10,25,3
1688,Nacho Monreal,1,1,1,0,0,1,3,33.3,2,3,1,2,3,10,0
1689,Nacho Monreal,38,16,26,9,3,22,42,52.4,20,20,4,16,43,66,0
1690,Joan Monterde,0,0,0,0,0,0,0,,0,0,0,0,0,0,0
1691,Ilario Monterisi,0,0,0,0,0,0,0,,0,0,0,0,0,0,0
1692,Ángel Montoro,19,8,8,9,2,3,13,23.1,10,10,1,9,13,15,0
1693,Martín Montoya,57,29,31,20,6,30,56,53.6,26,19,5,14,24,40,0
1694,Simon Moore,1,0,1,0,0,1,1,100.0,0,0,0,0,0,0,1
1695,Aaron Mooy,37,24,9,18,10,6,40,15.0,34,36,7,29,23,32,1
1696,Wesley Moraes,15,8,3,8,4,0,5,0.0,5,10,2,8,4,23,0
1697,Alfredo Morales,31,15,11,16,4,11,35,31.4,24,17,6,11,18,37,0
1698,Álvaro Morata,17,8,4,9,4,1,13,7.7,12,12,2,10,5,23,0
1699,Jan Morávek,23,12,9,14,0,11,24,45.8,13,4,1,3,8,11,0
1700,Steven Moreira,37,25,21,15,1,19,31,61.3,12,16,3,13,16,29,0
1701,Jérémy Morel,15,9,13,1,1,9,20,45.0,11,21,17,4,17,59,1
1702,Alberto Moreno,27,16,15,11,1,9,25,36.0,16,15,3,12,25,36,0
1703,Álex Moreno,37,20,27,8,2,12,32,37.5,20,21,8,13,23,47,1
1704,Gerard Moreno,19,8,4,10,5,5,46,10.9,41,19,3,16,10,51,0
1705,Mateu Morey,7,3,2,4,1,4,10,40.0,6,4,0,4,5,3,0
1706,Wes Morgan,4,1,3,1,0,0,3,0.0,3,5,3,2,7,19,0
1707,Manu Morlanes,7,3,3,4,0,2,9,22.2,7,1,1,0,2,2,0
1708,Raúl Moro,0,0,0,0,0,0,0,,0,0,0,0,0,0,0
1709,Loren Morón,18,12,6,7,5,9,23,39.1,14,25,6,19,9,13,0
1710,Leonardo Morosini,1,1,1,0,0,0,0,,0,1,0,1,1,1,0
1711,Ravel Morrison,0,0,0,0,0,0,0,,0,0,0,0,0,0,0
1712,Victor Moses,4,3,1,2,1,2,8,25.0,6,4,0,4,0,4,0
1713,Lebo Mothiba,4,3,1,1,2,1,6,16.7,5,5,0,5,3,1,0
1714,Harold Moukoudi,28,19,20,7,1,11,14,78.6,3,16,10,6,16,42,2
1715,Jessy Moulin,0,0,0,0,0,0,0,,0,0,0,0,1,2,0
1716,Mason Mount,37,17,8,19,10,9,42,21.4,33,25,3,22,16,18,0
1717,Lucas Moura,57,33,25,22,10,16,58,27.6,42,29,2,27,15,27,0
1718,Lys Mousset,9,5,0,5,4,3,7,42.9,4,3,0,3,4,2,0
1719,Wesley Moustache,0,0,0,0,0,0,0,,0,1,0,1,0,2,0
1720,João Moutinho,93,50,43,41,9,46,139,33.1,93,43,13,30,50,18,1
1721,Samuel Moutoussamy,4,1,2,1,1,2,7,28.6,5,2,0,2,4,7,0
1722,Toni Moya,0,0,0,0,0,0,0,,0,0,0,0,0,0,0
1723,Javi Moyano,19,8,11,8,0,8,20,40.0,12,18,5,13,27,63,0
1724,Nordi Mukiele,61,39,39,12,10,25,38,65.8,13,26,4,22,47,57,0
1725,Mert Müldür,47,27,33,8,6,27,42,64.3,15,10,0,10,22,42,0
1726,Florian Müller,0,0,0,0,0,0,0,,0,0,0,0,2,3,1
1727,Thomas Müller,45,27,7,26,12,22,69,31.9,47,27,3,24,12,8,0
1728,Marshall Munetsi,27,19,12,12,3,6,12,50.0,6,13,7,6,12,20,1
1729,Iker Muniain,26,19,11,10,5,4,24,16.7,20,9,0,9,12,7,0
1730,Aihen Muñoz,28,18,13,12,3,18,27,66.7,9,13,2,11,2,19,0
1731,Javier Muñoz,0,0,0,0,0,0,0,,0,1,1,0,0,0,0
1732,Simone Muratore,2,0,0,1,1,1,3,33.3,2,1,0,1,3,0,0
1733,Alessandro Murgia,27,17,16,8,3,14,34,41.2,20,10,3,7,18,15,0
1734,Luis Muriel,15,9,3,8,4,3,14,21.4,11,12,0,12,4,0,0
1735,Jeison Murillo,18,6,14,4,0,10,19,52.6,9,8,4,4,10,28,0
1736,Jeison Murillo,37,20,30,6,1,18,27,66.7,9,13,9,4,20,74,2
1737,Glenn Murray,5,2,0,3,2,2,9,22.2,7,6,2,4,1,12,0
1738,Nicola Murru,40,22,24,8,8,21,41,51.2,20,22,4,18,27,58,0
1739,Mateo Musacchio,15,8,11,4,0,7,20,35.0,13,10,7,3,22,50,0
1740,Torben Müsel,0,0,0,0,0,0,0,,0,0,0,0,1,0,0
1741,Jamal Musiala,0,0,0,0,0,0,0,,0,0,0,0,0,0,0
1742,Juan Musso,0,0,0,0,0,0,1,0.0,1,0,0,0,1,18,2
1743,Shkodran Mustafi,17,10,11,5,1,6,12,50.0,6,10,6,4,18,72,0
1744,Yoshinori Mutō,3,2,1,2,0,1,2,50.0,1,0,0,0,0,0,0
1745,Yvon Mvogo,0,0,0,0,0,0,0,,0,0,0,0,0,0,1
1746,Phillipp Mwene,11,5,9,2,0,7,12,58.3,5,10,1,9,3,11,0
1747,Obite N'Dicka,27,13,13,11,3,15,28,53.6,13,28,6,22,29,57,0
1748,Kévin N'Doram,43,28,19,21,3,17,40,42.5,23,20,8,12,26,23,0
1749,Abdallah N'dour,5,4,2,3,0,5,10,50.0,5,4,1,3,4,5,1
1750,Ferris N'Goma,0,0,0,0,0,0,0,,0,1,0,1,0,0,0
1751,Nathan N'Goumou,0,0,0,0,0,0,0,,0,0,0,0,0,1,0
1752,Georges-Kévin N'Koudou,0,0,0,0,0,0,1,0.0,1,0,0,0,0,0,0
1753,Stanley N'Soki,40,29,24,16,0,23,42,54.8,19,14,6,8,32,37,0
1754,Nacho,43,22,24,15,4,17,48,35.4,31,36,8,28,25,61,0
1755,Nacho,11,6,6,3,2,6,10,60.0,4,5,3,2,12,18,1
1756,Radja Nainggolan,30,18,9,12,9,9,29,31.0,20,25,6,19,13,30,0
1757,Marvelous Nakamba,55,28,28,20,7,24,67,35.8,43,50,11,39,39,38,3
1758,Naldo,24,13,15,9,0,7,15,46.7,8,11,7,4,21,50,1
1759,Nahitan Nández,58,38,37,17,4,25,69,36.2,44,30,1,29,25,26,0
1760,Matija Nastasić,26,16,17,9,0,14,17,82.4,3,28,16,12,22,79,0
1761,Marc Navarro,3,3,2,1,0,1,1,100.0,0,2,1,1,0,3,0
1762,Ximo Navarro,34,19,17,15,2,16,28,57.1,12,20,7,13,52,76,2
1763,Jesús Navas,27,15,16,7,4,15,32,46.9,17,20,7,13,31,70,0
1764,Keylor Navas,0,0,0,0,0,0,0,,0,1,0,1,0,4,2
1765,Raúl Navas,10,5,4,6,0,4,13,30.8,9,10,4,6,18,30,0
1766,Michel Ndary Adopo,0,0,0,0,0,0,0,,0,1,1,0,0,0,0
1767,Papa Ndiaga Yade,0,0,0,0,0,0,0,,0,0,0,0,0,0,0
1768,Wilfred Ndidi,128,67,56,61,11,45,91,49.5,46,52,6,46,80,69,3
1769,Emanuele Ndoj,9,6,2,6,1,3,13,23.1,10,7,0,7,5,5,0
1770,Tanguy Ndombele,24,16,10,13,1,9,22,40.9,13,20,3,17,14,7,0
1771,Reiss Nelson,11,8,5,4,2,7,17,41.2,10,13,2,11,3,3,0
1772,Ilija Nestorovski,10,7,5,5,0,6,21,28.6,15,13,2,11,4,12,0
1773,Neto,0,0,0,0,0,0,0,,0,0,0,0,0,1,0
1774,Pedro Neto,9,4,3,6,0,4,15,26.7,11,2,0,2,6,4,0
1775,Manuel Neuer,2,1,1,0,1,2,4,50.0,2,0,0,0,0,15,4
1776,Florian Neuhaus,42,23,13,22,7,12,54,22.2,42,24,4,20,27,8,0
1777,Carlos Neva,16,11,12,3,1,9,21,42.9,12,15,2,13,28,60,0
1778,Rúben Neves,62,33,27,32,3,34,86,39.5,52,38,9,29,56,34,1
1779,Neymar,12,7,1,9,2,3,21,14.3,18,10,0,10,4,1,0
1780,Jeremy Ngakia,15,7,10,5,0,9,21,42.9,12,6,1,5,7,16,0
1781,Jessic Ngankam,2,2,1,1,0,2,2,100.0,0,2,0,2,0,1,0
1782,Muzinga Ngonda,15,6,10,3,2,7,10,70.0,3,5,4,1,11,23,0
1783,Ahmad Ngouyamsa,1,0,1,0,0,0,3,0.0,3,1,1,0,1,5,0
1784,Opa Nguette,44,28,23,15,6,11,39,28.2,28,17,3,14,12,12,0
1785,Moussa Niakhate,35,22,29,6,0,16,29,55.2,13,40,26,14,40,124,4
1786,Ibrahima Niane,8,7,2,5,1,5,16,31.3,11,5,1,4,10,11,1
1787,M'Baye Niang,17,10,3,11,3,6,21,28.6,15,10,1,9,5,20,0
1788,Tanguy Nianzou,2,1,0,1,1,1,3,33.3,2,4,2,2,3,6,0
1789,Cheikh Niasse,0,0,0,0,0,0,0,,0,0,0,0,0,0,0
1790,Oumar Niasse,4,0,0,2,2,0,0,,0,0,0,0,1,0,0
1791,Moritz Nicolas,0,0,0,0,0,0,0,,0,0,0,0,0,0,0
1792,Florian Niederlechner,21,13,7,9,5,4,21,19.0,17,21,5,16,8,38,0
1793,Saúl Ñíguez,95,59,44,42,9,39,88,44.3,49,58,13,45,55,68,1
1794,Casimir Ninga,5,5,4,0,1,1,5,20.0,4,5,0,5,3,2,0
1795,Fernando Niño,1,0,0,1,0,1,2,50.0,1,0,0,0,0,2,0
1796,Timothée Nkada,1,0,1,0,0,0,1,0.0,1,0,0,0,0,1,0
1797,Eddie Nketiah,7,5,3,4,0,2,6,33.3,4,9,0,9,2,5,0
1798,Nicolas Nkoulou,34,24,21,11,2,16,22,72.7,6,40,18,22,70,138,2
1799,Christopher Nkunku,21,13,4,11,6,9,33,27.3,24,25,2,23,20,8,0
1800,Lukas Nmecha,0,0,0,0,0,0,0,,0,0,0,0,0,0,0
1801,Mark Noble,52,30,19,28,5,22,64,34.4,42,20,6,14,20,10,1
1802,Nolito,21,12,5,11,5,7,20,35.0,13,7,0,7,1,1,0
1803,Nolito,7,5,5,2,0,3,8,37.5,5,4,1,3,1,4,0
1804,Arnaud Nordin,7,3,3,3,1,4,13,30.8,9,11,1,10,4,6,0
1805,Håvard Nordtveit,4,1,3,1,0,3,7,42.9,4,17,12,5,13,45,0
1806,Oliver Norwood,66,37,35,24,7,28,97,28.9,69,34,12,22,47,40,1
1807,Alexander Nübel,0,0,0,0,0,0,0,,0,0,0,0,2,9,6
1808,Kasim Nuhu,14,7,12,1,1,9,19,47.4,10,16,12,4,25,54,0
1809,Unai Núñez,13,10,10,2,1,6,16,37.5,10,25,17,8,23,71,0
1810,Bram Nuytinck,46,32,30,13,3,17,27,63.0,10,50,32,18,27,96,1
1811,Gerzino Nyamsi,1,0,1,0,0,0,0,,0,1,0,1,1,5,0
1812,Ørjan Nyland,0,0,0,0,0,0,0,,0,0,0,0,0,1,1
1813,Allan Nyom,45,25,26,15,4,20,37,54.1,17,24,5,19,14,50,1
1814,Steven Nzonzi,5,4,3,1,1,1,2,50.0,1,2,2,0,4,18,0
1815,Jack O'Connell,23,14,15,6,2,10,20,50.0,10,38,17,21,42,154,1
1816,Michael Obafemi,7,3,1,3,3,2,14,14.3,12,3,0,3,6,0,0
1817,Pedro Obiang,46,31,21,19,6,19,40,47.5,21,24,10,14,21,31,1
1818,Jan Oblak,0,0,0,0,0,0,0,,0,0,0,0,1,4,2
1819,Rafel Obrador,0,0,0,0,0,0,1,0.0,1,0,0,0,0,1,0
1820,Lucas Ocampos,54,31,30,19,5,30,72,41.7,42,33,2,31,22,27,0
1821,Bastian Oczipka,72,50,42,21,9,36,62,58.1,26,35,6,29,37,68,0
1822,Álvaro Odriozola,5,2,4,0,1,5,8,62.5,3,4,0,4,2,8,0
1823,Álvaro Odriozola,2,2,1,0,1,2,3,66.7,1,1,0,1,1,2,0
1824,Kelvin Ofori,0,0,0,0,0,0,0,,0,0,0,0,0,0,0
1825,Angelo Ogbonna,38,24,20,14,4,18,32,56.3,14,50,32,18,27,134,1
1826,Stefano Okaka,19,11,6,8,5,7,27,25.9,20,23,2,21,8,28,0
1827,Kwasi Okyere Wriedt,0,0,0,0,0,0,0,,0,0,0,0,0,0,0
1828,Lucas Olaza,56,39,36,17,3,39,59,66.1,20,37,10,27,31,60,1
1829,Oier Olazábal,0,0,0,0,0,0,0,,0,1,0,1,0,0,0
1830,Christian Oliva,13,7,9,4,0,5,15,33.3,10,5,0,5,7,14,0
1831,Kiko Olivas,33,16,25,7,1,13,35,37.1,22,30,16,14,61,112,2
1832,Paulo Oliveira,31,19,22,8,1,18,30,60.0,12,23,13,10,42,107,1
1833,Cauly Oliveira Souza,11,7,5,5,1,3,11,27.3,8,9,0,9,6,1,0
1834,Mathías Olivera,64,40,34,16,14,27,45,60.0,18,32,3,29,23,44,0
1835,Maximiliano Olivera,1,0,1,0,0,0,0,,0,0,0,0,0,0,0
1836,Marco Olivieri,1,1,1,0,0,1,2,50.0,1,0,0,0,0,0,0
1837,Dani Olmo,20,14,5,10,5,1,13,7.7,12,7,1,6,4,6,0
1838,Robin Olsen,0,0,0,0,0,0,1,0.0,1,0,0,0,0,8,0
1839,Kenneth Omeruo,28,17,25,3,0,11,18,61.1,7,21,12,9,36,112,2
1840,Jean Onana,0,0,0,0,0,0,2,0.0,2,1,0,1,1,0,0
1841,Karim Onisiwo,27,19,6,10,11,5,13,38.5,8,20,3,17,7,11,0
1842,Javier Ontiveros,29,14,13,14,2,8,35,22.9,27,13,1,12,5,7,0
1843,Henry Onyekuru,1,1,1,0,0,0,0,,0,1,0,1,1,0,0
1844,Nicholas Opoku,13,8,8,3,2,6,11,54.5,5,6,4,2,4,19,0
1845,Nicholas Opoku,7,5,6,1,0,7,14,50.0,7,6,2,4,7,32,0
1846,Willi Orban,20,12,13,7,0,12,20,60.0,8,14,3,11,16,52,1
1847,Fabián Orellana,29,18,10,6,13,14,52,26.9,38,9,0,9,20,2,0
1848,Divock Origi,12,9,2,5,5,4,9,44.4,5,2,0,2,4,5,0
1849,Aimar Oroz,0,0,0,0,0,0,0,,0,1,0,1,0,0,0
1850,Riccardo Orsolini,36,22,21,10,5,12,47,25.5,35,23,1,22,16,20,0
1851,Yuya Osako,29,16,5,19,5,3,29,10.3,26,10,1,9,6,13,1
1852,Ben Osborn,15,10,11,3,1,3,16,18.8,13,6,1,5,6,7,0
1853,Victor Osimhen,8,4,1,0,7,1,11,9.1,10,8,0,8,11,32,0
1854,David Ospina,0,0,0,0,0,0,0,,0,0,0,0,0,2,1
1855,Nicolás Otamendi,28,14,21,6,1,16,33,48.5,17,15,9,6,21,76,2
1856,Otávio,80,45,23,52,5,35,82,42.7,47,26,9,17,41,40,6
1857,Paulo Otávio,21,16,11,9,1,10,13,76.9,3,12,2,10,9,11,0
1858,Abou Ouattara,0,0,0,0,0,0,0,,0,0,0,0,0,1,0
1859,Remi Oudin,9,6,4,4,1,4,14,28.6,10,7,1,6,9,5,0
1860,Remi Oudin,15,7,8,5,2,6,19,31.6,13,16,1,15,18,18,1
1861,Alexandre Oukidja,0,0,0,0,0,0,1,0.0,1,1,0,1,0,15,1
1862,Zinédine Ould Khaled,2,1,0,2,0,2,4,50.0,2,0,0,0,4,0,0
1863,Adam Ounas,10,5,2,6,2,5,13,38.5,8,9,1,8,11,8,1
1864,Reece Oxford,7,4,2,4,1,2,8,25.0,6,8,5,3,5,10,1
1865,Alex Oxlade-Chamberlain,18,9,4,6,8,5,21,23.8,16,26,1,25,22,10,0
1866,Mikel Oyarzabal,36,15,13,15,8,16,46,34.8,30,32,2,30,13,19,1
1867,Ambroise Oyongo,25,10,16,6,3,16,28,57.1,12,8,0,8,17,35,0
1868,Mesut Özil,17,8,9,7,1,4,23,17.4,19,4,0,4,5,1,0
1869,Levin Öztunalı,28,19,13,12,3,12,35,34.3,23,27,1,26,9,14,2
1870,Pablo,27,15,22,5,0,16,31,51.6,15,25,14,11,40,130,2
1871,Fernando Pacheco,1,0,1,0,0,1,3,33.3,2,0,0,0,0,10,0
1872,Jon Pacheco,0,0,0,0,0,0,0,,0,1,0,1,0,2,0
1873,Gonçalo Paciência,9,5,1,4,4,3,13,23.1,10,9,1,8,1,11,0
1874,Daniele Padelli,0,0,0,0,0,0,0,,0,0,0,0,0,1,1
1875,Marko Pajač,8,4,4,3,1,7,16,43.8,9,6,0,6,8,9,0
1876,Vincent Pajot,2,2,1,1,0,1,1,100.0,0,3,0,3,5,0,0
1877,Vincent Pajot,16,11,8,7,1,2,4,50.0,2,5,1,4,9,13,0
1878,Rodrigo Palacio,19,11,0,9,10,4,27,14.8,23,17,3,14,5,38,2
1879,Exequiel Palacios,8,7,4,4,0,2,5,40.0,3,2,0,2,1,0,0
1880,Sergi Palencia,16,10,6,10,0,5,7,71.4,2,6,1,5,8,4,0
1881,Nicolas Pallois,47,36,28,17,2,31,55,56.4,24,18,13,5,40,77,1
1882,Emerson Palmieri,23,12,8,11,4,10,15,66.7,5,13,1,12,18,19,0
1883,Alberto Paloschi,3,0,3,0,0,2,8,25.0,6,3,0,3,0,2,0
1884,Alberto Paloschi,0,0,0,0,0,0,1,0.0,1,1,0,1,1,3,0
1885,Martin Palumbo,0,0,0,0,0,0,0,,0,0,0,0,0,0,0
1886,Goran Pandev,12,8,2,7,3,3,25,12.0,22,4,1,3,0,5,1
1887,Jonathan Panzo,2,2,2,0,0,1,1,100.0,0,3,1,2,3,7,0
1888,Sokratis Papastathopoulos,25,16,17,7,1,10,21,47.6,11,30,24,6,17,68,1
1889,Andrea Papetti,9,7,8,1,0,4,14,28.6,10,15,11,4,15,39,0
1890,Lucas Paquetá,33,19,12,17,4,14,37,37.8,23,17,2,15,8,9,0
1891,Gaëtan Paquiez,36,25,14,13,9,17,47,36.2,30,18,5,13,33,43,0
1892,Rubén Pardo,3,2,2,1,0,2,3,66.7,1,0,0,0,1,2,1
1893,Leandro Paredes,22,14,7,14,1,13,29,44.8,16,7,1,6,15,7,0
1894,Daniel Parejo,67,41,29,32,6,32,101,31.7,69,38,11,27,22,20,2
1895,Michael Parensen,11,6,5,6,0,5,10,50.0,5,14,8,6,12,17,0
1896,Miquel Parera,0,0,0,0,0,0,0,,0,0,0,0,0,0,0
1897,Marco Parolo,54,26,19,27,8,18,46,39.1,28,44,15,29,26,49,0
1898,Troy Parrott,0,0,0,0,0,0,0,,0,0,0,0,0,0,0
1899,Thomas Partey,70,41,34,30,6,26,58,44.8,32,32,8,24,48,41,7
1900,Mario Pašalić,47,21,17,18,12,16,52,30.8,36,27,7,20,27,22,2
1901,Javier Pastore,14,10,3,5,6,5,12,41.7,7,4,0,4,5,5,0
1902,Patric,34,20,24,7,3,18,25,72.0,7,19,9,10,15,45,0
1903,Rui Patrício,0,0,0,0,0,0,2,0.0,2,2,0,2,2,5,2
1904,Paulinho,4,3,3,1,0,1,2,50.0,1,5,1,4,1,0,0
1905,Paulino,0,0,0,0,0,0,1,0.0,1,1,0,1,1,0,0
1906,Gabriel Paulista,22,14,17,2,3,15,25,60.0,10,36,29,7,48,151,3
1907,Benjamin Pavard,34,22,15,10,9,16,28,57.1,12,28,10,18,52,60,0
1908,Jiří Pavlenka,1,0,1,0,0,1,2,50.0,1,1,0,1,5,11,3
1909,Mateo Pavlović,8,2,6,2,0,5,7,71.4,2,4,2,2,5,38,1
1910,Leonardo Pavoletti,0,0,0,0,0,0,0,,0,0,0,0,1,3,0
1911,Dimitri Payet,22,12,8,8,6,10,26,38.5,16,8,1,7,8,12,0
1912,Nehuén Paz,1,1,0,1,0,0,2,0.0,2,3,3,0,5,12,0
1913,Nehuén Paz,14,5,11,3,0,10,12,83.3,2,12,6,6,20,38,1
1914,Giampaolo Pazzini,1,0,0,1,0,0,4,0.0,4,2,0,2,1,4,0
1915,Mads Pedersen,4,2,3,0,1,2,6,33.3,4,3,1,2,2,0,0
1916,Alfonso Pedraza,30,19,16,11,3,19,33,57.6,14,18,6,12,16,26,1
1917,Marc Pedraza,1,1,1,0,0,1,5,20.0,4,0,0,0,4,1,0
1918,Pedro,15,7,5,9,1,3,15,20.0,12,9,0,9,9,1,0
1919,Pedro,1,1,0,0,1,0,0,,0,1,0,1,0,0,0
1920,João Pedro,17,11,5,7,5,4,24,16.7,20,35,8,27,9,39,0
1921,Adrià Pedrosa,19,13,8,9,2,7,25,28.0,18,12,1,11,11,32,0
1922,Daouda Peeters,1,0,0,1,0,1,1,100.0,0,0,0,0,0,0,0
1923,Jordan Pefok,7,6,1,4,2,0,2,0.0,2,3,0,3,1,2,0
1924,Gianluca Pegolo,0,0,0,0,0,0,0,,0,0,0,0,0,4,0
1925,Peter Pekarík,14,7,7,3,4,8,20,40.0,12,11,4,7,7,31,0
1926,Yohann Pelé,0,0,0,0,0,0,0,,0,0,0,0,0,0,0
1927,Lorenzo Pellegrini,30,13,9,13,8,12,33,36.4,21,28,0,28,15,18,0
1928,Luca Pellegrini,31,15,20,7,4,15,38,39.5,23,19,2,17,21,45,2
1929,Théo Pellenard,11,8,6,3,2,6,13,46.2,7,4,0,4,5,8,0
1930,Andy Pelmard,22,14,13,9,0,9,11,81.8,2,12,4,8,15,28,1
1931,Federico Peluso,19,16,8,8,3,8,9,88.9,1,14,9,5,22,58,1
1932,Rubén Peña,42,24,23,19,0,17,50,34.0,33,25,8,17,35,58,2
1933,Philipp Pentke,0,0,0,0,0,0,0,,0,0,0,0,0,2,0
1934,Nicolas Pépé,32,17,15,13,4,8,16,50.0,8,15,2,13,8,5,0
1935,Luis Perea,0,0,0,0,0,0,0,,0,0,0,0,0,1,0
1936,Andreas Pereira,24,13,8,9,7,10,39,25.6,29,13,0,13,7,7,0
1937,Mathias Pereira Lage,30,18,16,13,1,12,37,32.4,25,19,0,19,17,9,0
1938,Ricardo Pereira,119,68,65,36,18,53,106,50.0,53,38,6,32,49,86,0
1939,Gastón Pereiro,2,2,2,0,0,1,4,25.0,3,1,0,1,0,1,1
1940,Bruno Peres,14,10,10,3,1,8,21,38.1,13,12,3,9,15,19,2
1941,Roberto Pereyra,20,8,11,7,2,9,28,32.1,19,21,0,21,14,12,1
1942,Ayoze Pérez,45,28,14,26,5,8,54,14.8,46,33,1,32,14,9,1
1943,Carles Pérez,12,8,4,6,2,3,10,30.0,7,6,1,5,3,1,0
1944,Carles Pérez,7,4,2,2,3,3,15,20.0,12,5,2,3,1,1,0
1945,Iñigo Pérez,15,11,3,7,5,8,22,36.4,14,7,1,6,12,6,0
1946,Juan Pérez,1,1,1,0,0,1,2,50.0,1,0,0,0,0,0,0
1947,Kike Pérez,6,1,1,3,2,3,7,42.9,4,1,0,1,10,4,0
1948,Lucas Pérez,12,6,2,8,2,3,13,23.1,10,13,2,11,2,0,0
1949,Rubén Pérez,50,27,21,23,6,16,47,34.0,31,21,4,17,38,33,0
1950,Samu Pérez,0,0,0,0,0,0,0,,0,0,0,0,0,0,0
1951,Mattia Perin,1,1,1,0,0,1,1,100.0,0,1,0,1,0,5,1
1952,Ivan Perišić,16,12,5,6,5,8,33,24.2,25,14,3,11,4,8,0
1953,Diego Perotti,16,13,5,8,3,5,20,25.0,15,14,0,14,3,6,0
1954,Romain Perraud,29,14,18,9,2,14,28,50.0,14,24,9,15,27,50,0
1955,Loïc Perrin,27,20,16,11,0,11,14,78.6,3,23,17,6,39,59,0
1956,Lucas Perrin,5,2,3,2,0,2,7,28.6,5,3,2,1,10,17,0
1957,Pavao Pervan,0,0,0,0,0,0,1,0.0,1,0,0,0,0,4,0
1958,Matteo Pessina,35,21,9,20,6,12,33,36.4,21,28,8,20,25,40,2
1959,Andrea Petagna,9,4,2,7,0,3,17,17.6,14,11,5,6,1,27,0
1960,Nils Petersen,19,14,7,9,3,10,28,35.7,18,32,6,26,10,67,0
1961,Danijel Petković,0,0,0,0,0,0,0,,0,0,0,0,0,2,0
1962,Denis Petrić,1,1,1,0,0,1,1,100.0,0,0,0,0,0,0,0
1963,Jacopo Petriccione,38,20,29,9,0,15,57,26.3,42,20,7,13,28,25,2
1964,Germán Pezzella,36,18,26,9,1,14,32,43.8,18,31,20,11,55,134,1
1965,Giuseppe Pezzella,0,0,0,0,0,0,0,,0,0,0,0,1,4,0
1966,Giuseppe Pezzella,20,12,17,3,0,11,19,57.9,8,13,9,4,6,30,0
1967,Rayan Philippe,0,0,0,0,0,0,1,0.0,1,0,0,0,1,1,1
1968,Romain Philippoteaux,23,12,11,11,1,9,43,20.9,34,22,1,21,13,10,0
1969,Krzysztof Piątek,9,4,0,7,2,3,11,27.3,8,5,2,3,3,10,0
1970,Krzysztof Piątek,5,4,1,1,3,0,11,0.0,11,7,0,7,5,3,0
1971,Pablo Piatti,2,2,1,1,0,1,2,50.0,1,1,0,1,0,1,0
1972,Cristiano Piccini,5,4,1,0,4,4,4,100.0,0,0,0,0,2,1,0
1973,Stefano Piccinini,0,0,0,0,0,0,0,,0,0,0,0,0,0,0
1974,Roberto Piccoli,0,0,0,0,0,0,0,,0,1,0,1,0,0,0
1975,Jordan Pickford,0,0,0,0,0,0,4,0.0,4,0,0,0,3,12,6
1976,Jérémy Pied,18,10,6,11,1,11,16,68.8,5,8,0,8,7,10,0
1977,Ronaël Pierre-Gabriel,16,10,9,6,1,7,13,53.8,6,7,0,7,8,31,1
1978,Brandon Pierrick,0,0,0,0,0,0,0,,0,0,0,0,0,1,0
1979,Erik Pieters,54,32,18,29,7,28,69,40.6,41,30,4,26,28,60,1
1980,Tomás Pina Isla,37,22,13,21,3,12,24,50.0,12,15,5,10,16,31,0
1981,Andrea Pinamonti,19,12,1,7,11,5,25,20.0,20,19,2,17,9,25,0
1982,Simone Pinna,1,1,0,1,0,0,0,,0,3,1,2,5,4,1
1983,Carlo Pinsoglio,0,0,0,0,0,0,0,,0,0,0,0,0,0,0
1984,Pipa,9,8,5,4,0,4,6,66.7,2,8,0,8,6,17,0
1985,Gerard Piqué,32,23,20,11,1,16,26,61.5,10,39,24,15,36,157,0
1986,Lorenzo Pirola,0,0,0,0,0,0,0,,0,0,0,0,1,0,0
1987,Fabio Pisacane,32,21,22,10,0,21,37,56.8,16,36,28,8,27,110,2
1988,Łukasz Piszczek,45,32,27,16,2,28,50,56.0,22,27,11,16,26,47,1
1989,Claudio Pizarro,2,1,0,1,1,0,1,0.0,1,2,0,2,2,2,0
1990,Miralem Pjanić,46,21,16,23,7,21,63,33.3,42,29,12,17,32,30,0
1991,Óscar Plano,48,30,25,19,4,20,61,32.8,41,36,3,33,35,29,0
1992,Marvin Plattenhardt,18,12,13,4,1,12,17,70.6,5,18,7,11,11,47,0
1993,Alassane Pléa,16,7,5,6,5,8,28,28.6,20,21,2,19,9,7,0
1994,Thomas Pledl,4,2,2,2,0,0,1,0.0,1,0,0,0,0,1,0
1995,Daniel Podence,3,3,2,0,1,0,2,0.0,2,4,1,3,2,1,0
1996,Paul Pogba,20,9,8,8,4,8,16,50.0,8,12,4,8,7,10,2
1997,Joel Pohjanpalo,0,0,0,0,0,0,0,,0,0,0,0,0,0,0
1998,Andrea Poli,44,24,19,21,4,16,52,30.8,36,19,3,16,40,11,0
1999,Matteo Politano,12,6,8,2,2,5,14,35.7,9,6,0,6,5,3,0
2000,Matteo Politano,0,0,0,0,0,0,2,0.0,2,1,0,1,0,1,0
2001,Sebastian Polter,2,2,0,1,1,1,3,33.3,2,2,0,2,1,1,0
2002,Marin Pongračić,14,9,11,2,1,9,10,90.0,1,11,7,4,19,21,1
2003,Pere Pons,28,16,14,12,2,12,26,46.2,14,16,3,13,12,8,1
2004,Nick Pope,1,1,1,0,0,1,2,50.0,1,0,0,0,3,15,3
2005,Pedro Porro,18,10,11,7,0,10,18,55.6,8,3,0,3,7,19,1
2006,Francisco Portillo,11,6,3,6,2,4,12,33.3,8,2,0,2,2,3,0
2007,Portu,32,21,10,15,7,13,33,39.4,20,28,3,25,13,5,0
2008,Stefan Posch,63,34,35,27,1,35,63,55.6,28,57,25,32,40,101,1
2009,Sergio Postigo,32,15,23,7,2,11,18,61.1,7,24,15,9,34,132,1
2010,Florent Poulolo,0,0,0,0,0,0,0,,0,0,0,0,0,1,0
2011,Yussuf Poulsen,14,10,2,10,2,4,21,19.0,17,12,0,12,4,15,0
2012,Maxime Poundjé,0,0,0,0,0,0,0,,0,0,0,0,0,0,0
2013,Darío Poveda,1,0,0,1,0,0,0,,0,0,0,0,0,0,0
2014,Alejandro Pozo Pozo,38,24,30,6,2,19,38,50.0,19,23,2,21,23,29,1
2015,Alejandro Pozo Pozo,1,1,1,0,0,1,1,100.0,0,0,0,0,0,1,0
2016,Percy Prado,6,5,3,2,1,5,9,55.6,4,1,0,1,1,5,0
2017,Dennis Praet,33,18,8,21,4,9,29,31.0,20,19,1,18,17,12,0
2018,Abdón Prats,1,1,0,0,1,0,1,0.0,1,1,0,1,0,1,0
2019,Sanjin Prcić,1,0,0,0,1,1,2,50.0,1,1,1,0,1,0,0
2020,Nicolas de Préville,35,21,9,22,4,18,56,32.1,38,15,3,12,6,19,0
2021,Sebastian Prödl,0,0,0,0,0,0,0,,0,0,0,0,0,4,0
2022,Kai Pröger,43,22,21,17,5,17,58,29.3,41,34,6,28,14,20,1
2023,Grischa Prömel,14,11,6,6,2,7,19,36.8,12,10,2,8,14,9,0
2024,Davy Pröpper,64,35,28,28,8,23,74,31.1,51,27,8,19,38,36,4
2025,Antonio Puertas,37,24,8,18,11,16,53,30.2,37,21,3,18,12,21,0
2026,Riqui Puig,11,7,1,9,1,5,17,29.4,12,2,0,2,5,1,0
2027,Teemu Pukki,12,6,3,5,4,1,23,4.3,22,13,0,13,6,7,0
2028,Erick Pulgar,73,46,25,41,7,22,96,22.9,74,45,15,30,49,53,1
2029,Christian Pulisic,23,11,13,4,6,7,24,29.2,17,15,0,15,6,11,0
2030,Ignacio Pussetto,7,4,4,2,1,3,8,37.5,5,2,1,1,3,4,0
2031,Ignacio Pussetto,8,4,4,3,1,1,4,25.0,3,3,0,3,4,7,0
2032,Fabio Quagliarella,9,5,0,6,3,2,30,6.7,28,13,0,13,8,15,0
2033,Robin Quaison,25,17,15,7,3,11,32,34.4,21,27,5,22,11,8,0
2034,Domingos Quina,2,0,1,1,0,1,2,50.0,1,3,0,3,0,0,0
2035,Quini,25,14,16,7,2,13,22,59.1,9,5,1,4,10,14,0
2036,Xavi Quintillà,22,12,14,4,4,10,20,50.0,10,11,4,7,12,35,0
2037,Quique,2,1,1,0,1,0,0,,0,3,0,3,0,3,0
2038,Adrien Rabiot,47,31,16,19,12,15,41,36.6,26,36,6,30,32,19,0
2039,Nemanja Radoja,43,19,27,16,0,15,46,32.6,31,21,4,17,23,24,0
2040,Nemanja Radonjić,10,3,4,3,3,6,17,35.3,11,7,0,7,2,7,0
2041,Ivan Radovanović,27,14,18,9,0,10,26,38.5,16,17,3,14,8,39,0
2042,Ionuț Radu,0,0,0,0,0,0,2,0.0,2,0,0,0,1,7,1
2043,Ștefan Radu,43,25,24,15,4,28,43,65.1,15,19,9,10,34,85,0
2044,Boris Radunović,0,0,0,0,0,0,0,,0,0,0,0,0,1,0
2045,Rafael,0,0,0,0,0,0,0,,0,0,0,0,0,3,0
2046,Rafael,24,16,12,8,4,10,18,55.6,8,6,3,3,10,14,0
2047,Raffael,0,0,0,0,0,0,2,0.0,2,2,0,2,0,0,0
2048,Rafinha,3,2,1,1,1,1,2,50.0,1,0,0,0,1,0,0
2049,Rafinha,71,37,29,37,5,20,62,32.3,42,37,4,33,33,25,0
2050,Daniele Ragatzu,3,2,0,2,1,1,3,33.3,2,1,0,1,1,5,0
2051,Baba Rahman,3,2,2,0,1,0,0,,0,2,1,1,1,2,0
2052,Antonio Raillo,31,21,24,7,0,13,19,68.4,6,31,26,5,22,112,1
2053,Predrag Rajković,1,1,1,0,0,1,1,100.0,0,0,0,0,1,9,0
2054,Ivan Rakitić,27,14,8,15,4,10,28,35.7,18,19,6,13,15,18,1
2055,Benito Raman,18,9,4,9,5,7,24,29.2,17,11,1,10,7,1,0
2056,Gastón Ramírez,32,21,7,16,9,8,30,26.7,22,28,2,26,11,10,0
2057,Sandro Ramírez,12,10,2,6,4,2,20,10.0,18,11,1,10,7,2,0
2058,Iván Ramis,3,2,2,1,0,1,4,25.0,3,2,0,2,4,23,2
2059,Adrián Ramos,6,2,0,2,4,2,3,66.7,1,2,0,2,1,1,0
2060,Sergio Ramos,46,31,26,17,3,20,42,47.6,22,22,9,13,49,102,4
2061,Aaron Ramsdale,4,3,4,0,0,3,3,100.0,0,0,0,0,0,25,1
2062,Aaron Ramsey,20,15,6,8,6,6,24,25.0,18,18,3,15,11,12,0
2063,Darren Randolph,0,0,0,0,0,0,0,,0,0,0,0,0,2,0
2064,Luca Ranieri,2,2,2,0,0,2,3,66.7,1,1,0,1,2,7,0
2065,Andrea Ranocchia,17,10,10,7,0,5,8,62.5,3,11,6,5,8,18,0
2066,Raphinha,22,18,5,12,5,10,32,31.3,22,23,1,22,17,14,1
2067,Tobias Raschl,0,0,0,0,0,0,1,0.0,1,1,0,1,0,0,0
2068,Marcus Rashford,13,9,1,6,6,9,23,39.1,14,23,0,23,10,19,0
2069,Milot Rashica,21,14,13,6,2,9,33,27.3,24,15,2,13,6,16,1
2070,Giacomo Raspadori,8,6,5,2,1,3,4,75.0,1,5,0,5,1,0,0
2071,Raúl,0,0,0,0,0,0,2,0.0,2,0,0,0,0,0,0
2072,Ante Rebić,16,11,4,9,3,7,34,20.6,27,14,1,13,3,12,0
2073,Ante Rebić,1,0,0,1,0,0,0,,0,0,0,0,0,1,0
2074,Arkadiusz Reca,38,23,22,10,6,13,39,33.3,26,15,2,13,32,48,1
2075,Recio,30,19,13,12,5,10,40,25.0,30,14,3,11,22,9,0
2076,Daishawn Redan,0,0,0,0,0,0,1,0.0,1,0,0,0,0,0,0
2077,Nathan Redmond,49,29,17,23,9,21,57,36.8,36,39,2,37,16,16,0
2078,Fabian Reese,1,1,1,0,0,0,0,,0,1,1,0,0,1,0
2079,Vasco Regini,4,2,3,1,0,0,0,,0,4,2,2,1,6,0
2080,Vasco Regini,0,0,0,0,0,0,0,,0,0,0,0,0,3,0
2081,Sergio Reguilón,57,30,28,25,4,27,64,42.2,37,25,5,20,33,53,0
2082,Ken Reichel,6,3,2,3,1,3,13,23.1,10,8,1,7,9,12,0
2083,Manolo Reina,0,0,0,0,0,0,1,0.0,1,2,0,2,5,9,1
2084,Pepe Reina,0,0,0,0,0,0,2,0.0,2,0,0,0,0,9,1
2085,Pepe Reina,0,0,0,0,0,0,0,,0,0,0,0,0,0,1
2086,Jeff Reine-Adélaïde,3,1,1,2,0,1,1,100.0,0,1,0,1,0,1,0
2087,Jeff Reine-Adélaïde,10,8,3,3,4,5,13,38.5,8,3,1,2,7,4,0
2088,Karim Rekik,16,10,10,6,0,3,6,50.0,3,23,15,8,18,44,0
2089,Álex Remiro,0,0,0,0,0,0,1,0.0,1,0,0,0,0,25,1
2090,Loïc Rémy,4,1,0,3,1,0,4,0.0,4,1,1,0,0,7,0
2091,Panagiotis Retsos,6,3,4,2,0,1,4,25.0,3,2,0,2,2,2,0
2092,Marco Reus,26,16,5,11,10,3,19,15.8,16,17,2,15,9,11,0
2093,Elvis Rexhbeçaj,16,12,9,5,2,5,13,38.5,8,7,0,7,3,4,0
2094,Gio Reyna,6,2,1,5,0,1,4,25.0,3,3,0,3,0,2,0
2095,Baptiste Reynet,1,1,1,0,0,1,3,33.3,2,0,0,0,0,12,0
2096,Nico Ribaudo,3,1,1,0,2,2,6,33.3,4,1,0,1,1,0,0
2097,Lucas Ribeiro,1,0,1,0,0,0,3,0.0,3,1,0,1,1,1,0
2098,Franck Ribéry,20,14,7,10,3,4,20,20.0,16,9,0,9,3,3,0
2099,Davide Riccardi,0,0,0,0,0,0,1,0.0,1,0,0,0,0,1,0
2100,Declan Rice,116,60,64,48,4,47,98,48.0,51,41,9,32,77,55,0
2101,Chris Richards,0,0,0,0,0,0,0,,0,0,0,0,0,1,0
2102,Richarlison,70,47,28,28,14,27,56,48.2,29,34,4,30,12,42,0
2103,Marco Richter,21,16,7,9,5,14,51,27.5,37,15,0,15,24,17,0
2104,Diego Rico,61,39,32,24,5,29,59,49.2,30,31,7,24,84,91,0
2105,Sergio Rico,0,0,0,0,0,0,0,,0,0,0,0,0,1,2
2106,Jaïro Riedewald,14,10,4,10,0,7,11,63.6,4,7,2,5,17,23,1
2107,Emiliano Rigoni,5,4,2,1,2,3,10,30.0,7,5,1,4,3,1,0
2108,Tomás Rincón,56,25,23,25,8,23,65,35.4,42,20,3,17,36,62,0
2109,Luis Rioja,18,12,11,6,1,8,25,32.0,17,21,0,21,16,6,0
2110,Renaud Ripart,39,23,17,20,2,18,46,39.1,28,17,2,15,12,37,0
2111,Rodrigo Riquelme,0,0,0,0,0,0,0,,0,0,0,0,0,0,0
2112,Andrea Rispoli,24,18,14,9,1,15,30,50.0,15,28,7,21,32,62,1
2113,Marcel Risse,3,2,3,0,0,1,1,100.0,0,1,0,1,1,1,0
2114,Mihailo Ristić,18,14,7,11,0,9,20,45.0,11,7,2,5,7,18,0
2115,Matt Ritchie,22,15,9,10,3,3,15,20.0,12,20,5,15,14,31,1
2116,Marlon Ritter,7,5,5,2,0,4,9,44.4,5,7,0,7,8,3,0
2117,Cristian Rivera,6,4,3,2,1,2,4,50.0,2,4,3,1,4,7,0
2118,Maxence Rivera,0,0,0,0,0,0,1,0.0,1,1,0,1,0,0,0
2119,Rober,3,1,2,0,1,2,2,100.0,0,0,0,0,3,2,0
2120,Roberto,0,0,0,0,0,0,0,,0,0,0,0,0,2,2
2121,Roberto,1,1,1,0,0,1,1,100.0,0,0,0,0,0,2,0
2122,Sergi Roberto,35,22,16,11,8,15,25,60.0,10,12,3,9,33,36,0
2123,Patrick Roberts,0,0,0,0,0,0,0,,0,0,0,0,0,0,0
2124,Andrew Robertson,54,31,17,25,12,27,61,44.3,34,29,7,22,38,72,1
2125,Callum Robinson,6,3,2,2,2,2,7,28.6,5,3,0,3,7,3,0
2126,Jack Robinson,10,5,5,5,0,1,6,16.7,5,12,5,7,8,24,0
2127,Joel Robles,0,0,0,0,0,0,2,0.0,2,0,0,0,0,13,2
2128,Marc Roca,82,52,29,44,9,29,82,35.4,53,28,10,18,31,53,2
2129,Rubén Rochina,41,26,22,9,10,19,52,36.5,33,16,0,16,12,19,1
2130,Sebastian Rode,58,33,27,27,4,17,59,28.8,42,32,5,27,34,13,0
2131,Rodri,50,30,17,25,8,23,63,36.5,40,19,5,14,26,35,0
2132,Rodrigo,10,6,4,5,1,2,23,8.7,21,9,1,8,9,13,0
2133,Kévin Rodrigues,56,31,31,17,8,25,46,54.3,21,30,3,27,31,26,1
2134,Kévin Rodrigues,1,0,1,0,0,1,1,100.0,0,0,0,0,0,0,0
2135,Ángel Rodríguez,14,8,2,8,4,2,18,11.1,16,10,1,9,3,10,0
2136,Óscar Rodríguez Arnaiz,23,10,11,7,5,13,41,31.7,28,19,0,19,14,13,0
2137,Dani Rodríguez,59,32,24,28,7,18,61,29.5,43,35,3,32,38,27,1
2138,Guido Rodríguez,24,16,11,11,2,15,25,60.0,10,13,4,9,10,21,0
2139,James Rodríguez,17,13,6,8,3,6,12,50.0,6,3,0,3,3,1,0
2140,Jay Rodriguez,29,19,4,13,12,8,33,24.2,25,33,6,27,5,12,0
2141,Mario Rodriguez,0,0,0,0,0,0,0,,0,0,0,0,0,0,0
2142,Ricardo Rodríguez,6,1,2,2,2,2,6,33.3,4,3,2,1,5,17,0
2143,Rodrygo,6,1,2,3,1,2,21,9.5,19,13,0,13,10,5,0
2144,Jack Rodwell,0,0,0,0,0,0,0,,0,0,0,0,0,1,0
2145,Marko Rog,69,47,31,29,9,22,84,26.2,62,40,12,28,22,23,0
2146,Agustín Rogel,15,8,12,3,0,7,13,53.8,6,13,10,3,11,35,2
2147,Rogério,22,14,12,8,2,16,23,69.6,7,13,3,10,9,34,0
2148,Marcos Rojo,3,1,2,1,0,1,2,50.0,1,2,1,1,0,6,0
2149,Filippo Romagna,7,6,2,5,0,5,6,83.3,1,24,17,7,10,69,0
2150,Alessio Romagnoli,46,25,28,15,3,16,27,59.3,11,32,18,14,56,157,1
2151,Alaixys Romao,46,29,31,14,1,17,57,29.8,40,12,3,9,26,38,3
2152,Cristian Romero,52,35,36,12,4,12,41,29.3,29,59,33,26,75,116,2
2153,Luka Romero,0,0,0,0,0,0,0,,0,0,0,0,0,0,0
2154,Oriol Romeu,55,35,23,30,2,27,75,36.0,48,35,13,22,34,32,0
2155,Rômulo,30,19,12,14,4,12,34,35.3,22,18,1,17,8,12,1
2156,Rômulo,2,1,1,1,0,0,0,,0,0,0,0,0,1,0
2157,Cristiano Ronaldo,14,10,3,3,8,4,20,20.0,16,10,3,7,6,21,1
2158,Facundo Roncaglia,24,20,12,10,2,11,20,55.0,9,18,3,15,22,46,0
2159,Valentin Rongier,76,51,25,41,10,22,63,34.9,41,30,4,26,36,16,2
2160,Valentin Rongier,5,4,0,2,3,3,5,60.0,2,4,0,4,2,0,0
2161,Marten de Roon,77,43,36,29,12,34,75,45.3,41,32,8,24,46,45,0
2162,Roberto Rosales,42,23,23,17,2,19,43,44.2,24,17,4,13,30,48,0
2163,Antonio Rosati,0,0,0,0,0,0,0,,0,0,0,0,0,0,1
2164,Danny Rose,18,11,6,10,2,9,20,45.0,11,14,6,8,8,34,2
2165,Danny Rose,21,12,11,8,2,12,21,57.1,9,11,4,7,10,14,1
2166,Luca Rossettini,25,14,18,7,0,17,34,50.0,17,31,22,9,35,126,1
2167,Francesco Rossi,0,0,0,0,0,0,0,,0,0,0,0,0,0,0
2168,Jérôme Roussillon,48,29,26,18,4,15,29,51.7,14,33,5,28,30,58,0
2169,Nolan Roux,5,2,1,3,1,1,3,33.3,2,2,0,2,4,5,0
2170,Nicolò Rovella,0,0,0,0,0,0,1,0.0,1,0,0,0,4,0,0
2171,Amir Rrahmani,50,31,26,19,5,26,46,56.5,20,50,31,19,30,151,1
2172,Rubén,1,1,1,0,0,1,1,100.0,0,0,0,0,0,9,1
2173,Waldo Rubio,13,8,10,3,0,5,31,16.1,26,12,0,12,7,7,0
2174,Antonio Rüdiger,28,18,19,7,2,16,25,64.0,9,15,9,6,16,59,1
2175,Sebastian Rudy,73,49,31,29,13,28,75,37.3,47,26,5,21,27,38,0
2176,Stéphane Ruffier,0,0,0,0,0,0,0,,0,0,0,0,0,5,3
2177,Dion Ruffo Luci,0,0,0,0,0,0,0,,0,0,0,0,0,0,0
2178,Daniele Rugani,8,6,4,4,0,4,5,80.0,1,4,4,0,11,18,0
2179,Mário Rui,31,17,12,12,7,11,29,37.9,18,24,5,19,21,43,0
2180,Aitor Ruibal,27,17,14,11,2,16,39,41.0,23,18,1,17,8,11,0
2181,Fabián Ruiz Peña,43,26,19,18,6,24,65,36.9,41,32,4,28,32,18,2
2182,Gerónimo Rulli,3,1,3,0,0,3,4,75.0,1,1,0,1,2,9,1
2183,Lukas Rupp,15,9,7,5,3,5,17,29.4,12,11,0,11,15,4,0
2184,Lukas Rupp,9,4,3,5,1,3,6,50.0,3,5,0,5,5,3,0
2185,Mathew Ryan,1,1,1,0,0,1,4,25.0,3,0,0,0,2,13,2
2186,Julian Ryerson,7,5,2,1,4,3,6,50.0,3,5,3,2,5,9,0
2187,Frederik Rønnow,0,0,0,0,0,0,1,0.0,1,0,0,0,0,1,0
2188,João Victor Santos Sá,35,22,12,17,6,10,38,26.3,28,31,1,30,9,9,0
2189,Roli Pereira de Sa,0,0,0,0,0,0,0,,0,0,0,0,0,0,0
2190,Youssouf Sabaly,18,11,9,4,5,6,22,27.3,16,8,1,7,18,23,0
2191,Stefano Sabelli,83,44,51,28,4,50,106,47.2,56,40,13,27,58,107,0
2192,Abdelhamid Sabiri,20,16,6,11,3,9,27,33.3,18,9,2,7,8,18,1
2193,Marcel Sabitzer,39,25,15,18,6,19,56,33.9,37,27,4,23,23,25,0
2194,Ihsan Sacko,1,1,1,0,0,0,1,0.0,1,0,0,0,0,0,0
2195,Alexis Saelemaekers,14,8,5,7,2,6,20,30.0,14,13,1,12,8,1,0
2196,Jorge Sáenz,6,1,4,2,0,3,5,60.0,2,5,2,3,10,15,0
2197,Nuri Şahin,27,16,10,14,3,11,35,31.4,24,15,7,8,37,38,0
2198,Wesley Saïd,20,9,8,10,2,2,13,15.4,11,6,0,6,9,8,0
2199,Allan Saint-Maximin,13,8,7,4,2,4,18,22.2,14,5,2,3,9,6,0
2200,Théo Sainte-Luce,0,0,0,0,0,0,0,,0,0,0,0,0,0,0
2201,Borja Sainz,16,9,4,9,3,8,26,30.8,18,14,0,14,3,0,0
2202,Romain Saïss,55,38,37,15,3,32,46,69.6,14,31,16,15,55,127,3
2203,Bukayo Saka,36,21,21,8,7,19,37,51.4,18,12,3,9,12,19,0
2204,Hiroki Sakai,57,36,26,24,7,25,40,62.5,15,20,5,15,23,34,1
2205,Mamadou Sakho,7,5,5,1,1,2,5,40.0,3,12,5,7,20,46,2
2206,Jacopo Sala,29,24,17,11,1,17,31,54.8,14,4,0,4,13,15,1
2207,Mohamed Salah,16,6,1,4,11,5,22,22.7,17,3,1,2,8,2,1
2208,Bartosz Salamon,2,1,2,0,0,1,2,50.0,1,4,4,0,6,14,0
2209,Eddie Salcedo,3,1,2,0,1,0,5,0.0,5,4,0,4,1,2,0
2210,William Saliba,19,9,15,3,1,5,10,50.0,5,13,4,9,21,36,1
2211,Yannis Salibur,0,0,0,0,0,0,4,0.0,4,0,0,0,1,1,0
2212,Romain Salin,0,0,0,0,0,0,1,0.0,1,0,0,0,0,3,0
2213,Mohammed Salisu,41,24,28,13,0,21,34,61.8,13,32,26,6,35,158,3
2214,Roland Sallai,17,10,4,9,4,7,20,35.0,13,12,2,10,7,4,0
2215,Lazar Samardzic,4,4,2,2,0,1,4,25.0,3,2,1,1,0,0,0
2216,Diadie Samassékou,37,18,14,17,6,12,34,35.3,22,25,8,17,40,27,1
2217,Mbwana Samatta,6,4,0,3,3,1,8,12.5,7,7,0,7,1,6,0
2218,Mama Samba Baldé,24,13,9,8,7,7,30,23.3,23,17,0,17,7,24,0
2219,Junior Sambia,8,6,4,2,2,3,13,23.1,10,4,0,4,8,6,0
2220,Frédéric Sammaritano,9,7,4,4,1,4,11,36.4,7,6,1,5,2,3,1
2221,Fede San Emeterio,26,13,18,6,2,7,29,24.1,22,20,8,12,28,13,1
2222,Mikel San José,9,4,2,4,3,2,10,20.0,8,3,1,2,9,12,0
2223,Antonio Sanabria,14,11,2,7,5,3,14,21.4,11,13,1,12,5,12,1
2224,Oihan Sancet,11,7,5,4,2,4,11,36.4,7,6,0,6,2,2,0
2225,Renato Sanches,28,15,9,15,4,8,33,24.2,25,19,1,18,15,10,1
2226,Renato Sanches,0,0,0,0,0,0,0,,0,0,0,0,0,0,0
2227,Alexis Sánchez,9,7,1,4,4,5,13,38.5,8,7,0,7,3,1,0
2228,Carlos Sánchez,1,0,0,1,0,1,1,100.0,0,1,0,1,2,1,0
2229,Davinson Sánchez,44,27,32,12,0,22,44,50.0,22,40,28,12,34,128,5
2230,Germán Sánchez,16,10,12,4,0,6,16,37.5,10,29,23,6,33,115,2
2231,Javi Sánchez,5,4,3,2,0,1,3,33.3,2,4,2,2,4,24,0
2232,Manu Sánchez,13,7,2,7,4,8,15,53.3,7,3,0,3,7,1,0
2233,Víctor Sánchez,66,36,36,23,7,30,71,42.3,41,31,8,23,27,23,1
2234,Jadon Sancho,14,11,6,6,2,8,24,33.3,16,8,0,8,14,6,0
2235,Alex Sandro,44,26,23,14,7,12,33,36.4,21,26,6,20,47,46,3
2236,Leroy Sané,0,0,0,0,0,0,0,,0,0,0,0,0,0,0
2237,Salif Sané,16,9,12,4,0,11,19,57.9,8,19,7,12,21,50,0
2238,Luca Sangalli,1,0,0,1,0,1,8,12.5,7,3,0,3,1,0,0
2239,Ibrahim Sangaré,84,54,37,42,5,33,74,44.6,41,28,10,18,39,49,4
2240,Oier Sanjurjo,65,34,21,34,10,28,64,43.8,36,33,8,25,35,39,1
2241,Yaya Sanogo,6,3,2,3,1,1,2,50.0,1,4,1,3,7,14,0
2242,Morgan Sanson,60,28,20,29,11,13,52,25.0,39,39,5,34,23,9,0
2243,Nicola Sansone,34,20,12,18,4,15,59,25.4,44,21,0,21,11,9,0
2244,Baptiste Santamaria,91,53,39,43,9,35,79,44.3,44,27,5,22,43,36,0
2245,Federico Santander,13,8,3,0,10,1,4,25.0,3,3,0,3,7,12,0
2246,Davide Santon,11,6,6,5,0,6,17,35.3,11,2,1,1,11,13,0
2247,Samir Santos,35,27,24,8,3,12,23,52.2,11,16,6,10,33,64,1
2248,Riccardo Saponara,4,3,2,2,0,0,2,0.0,2,2,1,1,0,2,0
2249,Riccardo Saponara,12,8,4,8,0,6,13,46.2,7,2,0,2,5,7,0
2250,Ivan Šaponjić,0,0,0,0,0,0,0,,0,0,0,0,0,0,0
2251,Pablo Sarabia,12,7,3,6,3,4,25,16.0,21,19,1,18,10,5,0
2252,Marcelo Saracchi,8,6,2,5,1,5,6,83.3,1,3,1,2,1,5,0
2253,Josh Sargent,11,6,5,4,2,2,12,16.7,10,17,1,16,14,21,0
2254,Bouna Sarr,60,37,30,19,11,30,53,56.6,23,17,1,16,32,38,0
2255,Ismaila Sarr,11,10,5,2,4,5,23,21.7,18,9,1,8,18,10,0
2256,Malang Sarr,19,11,13,6,0,9,22,40.9,13,10,4,6,38,31,4
2257,Sidy Sarr,35,18,15,16,4,11,34,32.4,23,13,3,10,15,18,0
2258,Joan Sastre Vanrell,30,17,26,3,1,17,39,43.6,22,8,2,6,23,27,1
2259,Téji Savanier,52,39,16,30,6,25,77,32.5,52,10,0,10,35,21,1
2260,Stefan Savić,22,17,11,10,1,11,18,61.1,7,16,9,7,24,91,1
2261,Fabian Schär,39,21,25,14,0,19,40,47.5,21,35,18,17,47,74,2
2262,Louis Schaub,15,12,2,9,4,5,14,35.7,9,10,1,9,3,2,0
2263,Ezequiel Schelotto,4,3,1,2,1,2,8,25.0,6,3,0,3,7,14,0
2264,Patrik Schick,7,3,1,3,3,2,9,22.2,7,8,2,6,2,17,0
2265,Julian Schieber,1,1,0,1,0,0,0,,0,0,0,0,0,0,0
2266,Kingsley Schindler,8,5,3,5,0,4,12,33.3,8,6,1,5,6,17,0
2267,Xaver Schlager,47,29,13,30,4,14,44,31.8,30,16,2,14,17,12,0
2268,Keven Schlotterbeck,52,27,36,15,1,17,29,58.6,12,40,21,19,40,113,1
2269,Nico Schlotterbeck,6,3,4,2,0,2,5,40.0,3,7,5,2,3,20,1
2270,Jeffrey Schlupp,18,9,10,7,1,6,16,37.5,10,11,3,8,13,15,0
2271,Kasper Schmeichel,1,1,1,0,0,1,2,50.0,1,0,0,0,1,4,2
2272,Marcel Schmelzer,2,1,1,1,0,1,1,100.0,0,0,0,0,1,2,0
2273,Jonathan Schmid,42,27,19,19,4,19,37,51.4,18,23,8,15,35,84,0
2274,Manuel Schmiedebach,4,1,0,3,1,1,7,14.3,6,1,1,0,3,3,0
2275,Benno Schmitz,28,17,13,11,4,16,36,44.4,20,11,1,10,16,27,0
2276,Morgan Schneiderlin,31,22,13,16,2,8,24,33.3,16,13,3,10,21,20,1
2277,Lasse Schöne,42,26,16,22,4,15,48,31.3,33,22,6,16,37,25,2
2278,Sebastian Schonlau,64,43,50,14,0,41,66,62.1,25,36,15,21,40,138,1
2279,Alessandro Schöpf,29,16,11,10,8,12,33,36.4,21,17,1,16,26,8,0
2280,Jerdy Schouten,26,16,13,11,2,10,26,38.5,16,19,7,12,26,22,0
2281,Markus Schubert,0,0,0,0,0,0,1,0.0,1,0,0,0,0,9,4
2282,Nico Schulz,11,7,3,6,2,8,13,61.5,5,14,4,10,9,9,0
2283,Alexander Schwolow,0,0,0,0,0,0,0,,0,2,0,2,1,8,3
2284,Matteo Scozzarella,23,15,8,13,2,14,29,48.3,15,19,14,5,27,28,0
2285,Aleksandar Sedlar,13,6,10,2,1,7,11,63.6,4,17,11,6,16,31,0
2286,Davie Selke,6,3,2,2,2,4,7,57.1,3,7,1,6,1,11,0
2287,Davie Selke,2,0,1,1,0,0,2,0.0,2,1,0,1,0,2,0
2288,Matz Sels,0,0,0,0,0,0,1,0.0,1,0,0,0,1,6,0
2289,Ken Sema,59,41,43,15,1,36,68,52.9,32,26,6,20,17,41,1
2290,Nélson Semedo,51,30,27,18,6,21,36,58.3,15,18,3,15,22,30,0
2291,Alessandro Semprini,10,4,7,3,0,7,9,77.8,2,10,3,7,9,16,0
2292,Josep Señé,2,1,2,0,0,2,5,40.0,3,2,1,1,0,2,0
2293,Stefano Sensi,18,10,10,7,1,6,22,27.3,16,15,1,14,9,4,0
2294,Luigi Sepe,1,0,1,0,0,1,2,50.0,1,0,0,0,0,6,2
2295,Suat Serdar,56,37,16,33,7,18,61,29.5,43,39,7,32,24,7,0
2296,Ryan Sessegnon,6,4,2,4,0,3,6,50.0,3,0,0,0,3,12,0
2297,Salva Sevilla,27,21,11,16,0,9,30,30.0,21,17,5,12,29,17,1
2298,Yevhen Shakhov,28,16,12,13,3,8,27,29.6,19,11,3,8,14,9,1
2299,Xherdan Shaqiri,1,0,0,1,0,0,1,0.0,1,0,0,0,0,0,0
2300,Billy Sharp,6,5,2,1,3,1,6,16.7,5,2,0,2,1,2,0
2301,Luke Shaw,34,18,19,11,4,19,33,57.6,14,26,6,20,24,56,1
2302,Khiry Shelton,1,1,1,0,0,0,0,,0,0,0,0,0,0,0
2303,Jonjo Shelvey,29,19,17,12,0,11,42,26.2,31,14,5,9,23,38,0
2304,Gen Shoji,2,2,2,0,0,1,1,100.0,0,0,0,0,0,2,0
2305,Djibril Sidibé,83,44,48,25,10,43,72,59.7,29,19,3,16,40,41,0
2306,Kalidou Sidibé,3,3,0,3,0,2,5,40.0,3,0,0,0,1,0,0
2307,Sidnei,23,19,17,6,0,9,14,64.3,5,15,12,3,21,57,0
2308,Kaj Sierhuis,0,0,0,0,0,0,0,,0,0,0,0,0,0,0
2309,Gylfi Sigurðsson,50,26,15,24,11,19,70,27.1,51,30,4,26,37,17,1
2310,Luca Siligardi,6,2,3,2,1,4,8,50.0,4,3,0,3,3,5,0
2311,Adrien Silva,37,22,14,19,4,10,37,27.0,27,19,6,13,12,14,2
2312,André Silva,2,1,0,0,2,0,1,0.0,1,0,0,0,0,0,0
2313,André Silva,7,2,0,5,2,2,14,14.3,12,9,0,9,8,4,0
2314,Bernardo Silva,36,18,8,21,7,13,44,29.5,31,25,1,24,24,13,0
2315,David Silva,26,14,3,15,8,10,28,35.7,18,18,3,15,13,5,0
2316,Gabriel Silva,4,1,1,2,1,2,3,66.7,1,2,0,2,4,8,0
2317,Jonathan Silva,60,34,32,22,6,27,52,51.9,25,12,4,8,34,46,0
2318,Matheus Pereira da Silva,10,6,1,6,3,4,10,40.0,6,11,0,11,6,5,0
2319,Rui Silva,2,1,2,0,0,2,2,100.0,0,0,0,0,2,22,3
2320,Thiago Silva,28,16,15,13,0,13,16,81.3,3,18,15,3,26,54,0
2321,Marco Silvestri,1,0,1,0,0,1,2,50.0,1,0,0,0,4,11,1
2322,Mohamed Simakan,54,32,35,16,3,22,34,64.7,12,14,3,11,31,25,0
2323,Giovanni Simeone,24,13,9,10,5,5,32,15.6,27,24,7,17,11,16,1
2324,Moses Simon,15,7,5,4,6,6,21,28.6,15,6,0,6,8,6,0
2325,Unai Simón,0,0,0,0,0,0,1,0.0,1,1,0,1,1,10,1
2326,Jack Simpson,5,2,4,1,0,2,8,25.0,6,1,0,1,2,12,1
2327,Sarpreet Singh,1,0,0,1,0,0,1,0.0,1,0,0,0,0,0,0
2328,Wilfried Singo,1,0,0,1,0,0,0,,0,0,0,0,1,2,0
2329,Daley Sinkgraven,20,16,11,6,3,8,24,33.3,16,12,3,9,10,16,0
2330,Dimitris Siovas,42,31,24,15,3,19,28,67.9,9,14,1,13,46,69,0
2331,Salvatore Sirigu,0,0,0,0,0,0,0,,0,0,0,0,2,12,0
2332,Ibrahima Sissoko,46,27,21,21,4,16,48,33.3,32,14,5,9,20,25,0
2333,Moussa Sissoko,39,25,25,12,2,20,48,41.7,28,19,4,15,27,43,2
2334,Sambou Sissoko,0,0,0,0,0,0,0,,0,0,0,0,1,2,0
2335,Pione Sisto,17,8,5,6,6,4,19,21.1,15,18,0,18,6,4,1
2336,Antonio Sivera,0,0,0,0,0,0,0,,0,0,0,0,0,2,0
2337,Ellyes Skhiri,74,52,30,37,7,29,77,37.7,48,47,9,38,67,33,0
2338,Oliver Skipp,2,2,0,2,0,1,4,25.0,3,3,2,1,0,0,0
2339,Łukasz Skorupski,1,0,1,0,0,0,1,0.0,1,0,0,0,2,15,5
2340,Andreas Skov Olsen,11,8,5,5,1,4,12,33.3,8,10,1,9,8,5,0
2341,Robert Skov,41,28,30,9,2,26,50,52.0,24,26,6,20,20,40,0
2342,Simon Skrabb,7,6,2,4,1,6,12,50.0,6,4,1,3,0,3,0
2343,Milan Škriniar,39,20,24,14,1,14,33,42.4,19,19,11,8,28,85,1
2344,Steven Skrzybski,4,4,2,1,1,0,16,0.0,16,10,0,10,10,4,0
2345,Petar Škuletić,6,4,2,2,2,2,4,50.0,2,0,0,0,0,1,0
2346,Islam Slimani,8,4,0,2,6,4,15,26.7,11,5,0,5,1,11,1
2347,William Smallbone,10,5,2,8,0,5,10,50.0,5,7,1,6,1,2,0
2348,Chris Smalling,25,16,15,9,1,10,13,76.9,3,44,35,9,56,126,2
2349,Dennis Smarsch,0,0,0,0,0,0,0,,0,0,0,0,0,1,0
2350,Adam Smith,47,32,29,16,2,23,50,46.0,27,27,6,21,25,64,1
2351,Emile Smith Rowe,1,1,1,0,0,1,3,33.3,2,0,0,0,1,2,0
2352,Fyodor Smolov,2,1,0,2,0,1,9,11.1,8,6,0,6,7,9,0
2353,Robert Snodgrass,29,16,17,10,2,13,44,29.5,31,12,1,11,4,11,0
2354,Cédric Soares,8,6,2,6,0,1,3,33.3,2,3,0,3,3,4,0
2355,Cédric Soares,45,26,19,24,2,25,41,61.0,16,18,4,14,19,51,0
2356,Rafa Soares,6,5,5,0,1,5,11,45.5,6,1,0,1,2,6,0
2357,Lasse Sobiech,1,0,0,0,1,0,0,,0,0,0,0,4,6,0
2358,Marcel Sobottka,15,10,6,8,1,4,13,30.8,9,9,1,8,9,12,0
2359,Rubén Sobrino,7,5,3,2,2,2,3,66.7,1,1,0,1,0,1,0
2360,Dominic Solanke,8,4,2,5,1,5,33,15.2,28,9,1,8,8,18,1
2361,Roberto Soldado,16,9,2,7,7,7,24,29.2,17,16,4,12,4,16,0
2362,Carlos Soler,21,10,10,10,1,9,39,23.1,30,16,6,10,9,14,0
2363,Oumar Solet,0,0,0,0,0,0,0,,0,1,1,0,0,1,0
2364,Yann Sommer,0,0,0,0,0,0,1,0.0,1,0,0,0,1,11,6
2365,Kévin Soni,0,0,0,0,0,0,0,,0,0,0,0,0,0,0
2366,David Soria,2,1,2,0,0,2,4,50.0,2,0,0,0,3,17,5
2367,Bruno Soriano,4,0,1,2,1,1,1,100.0,0,4,0,4,1,7,0
2368,Juan Soriano,0,0,0,0,0,0,0,,0,0,0,0,0,1,1
2369,Roberto Soriano,43,25,15,21,7,10,46,21.7,36,19,0,19,17,23,1
2370,Riccardo Sottil,6,4,4,2,0,3,10,30.0,7,4,0,4,0,0,0
2371,Tomáš Souček,29,15,13,15,1,10,23,43.5,13,7,1,6,22,35,0
2372,Adama Soumaoro,3,2,3,0,0,1,3,33.3,2,12,12,0,11,32,0
2373,Adama Soumaoro,1,1,0,1,0,0,0,,0,6,5,1,4,17,0
2374,Boubakary Soumaré,19,12,6,13,0,9,19,47.4,10,6,0,6,16,9,0
2375,Bryan Soumaré,12,1,6,5,1,6,9,66.7,3,1,0,1,2,1,0
2376,Arnaud Souquet,62,40,45,13,4,30,67,44.8,37,20,6,14,17,44,0
2377,Djibril Sow,56,33,26,17,13,16,47,34.0,31,15,3,12,30,9,0
2378,Çağlar Söyüncü,60,40,41,18,1,27,46,58.7,19,35,19,16,43,156,1
2379,Nikolas Špalek,24,10,6,11,7,7,31,22.6,24,15,1,14,6,10,0
2380,Leonardo Spinazzola,24,12,11,8,5,12,21,57.1,9,13,5,8,20,41,0
2381,Marco Sportiello,0,0,0,0,0,0,0,,0,0,0,0,0,3,0
2382,Mattia Sprocati,4,2,3,1,0,0,1,0.0,1,5,1,4,2,2,0
2383,Bassem Srarfi,0,0,0,0,0,0,2,0.0,2,0,0,0,2,0,0
2384,Dennis Srbeny,5,5,3,2,0,1,3,33.3,2,1,0,1,0,1,0
2385,Dennis Srbeny,11,6,4,4,3,5,18,27.8,13,11,1,10,3,9,0
2386,Jerry St. Juste,46,25,34,10,2,14,34,41.2,20,35,19,16,52,86,1
2387,Jack Stacey,21,11,9,11,1,8,22,36.4,14,27,11,16,18,64,1
2388,Kostas Stafylidis,10,3,7,2,1,4,10,40.0,6,10,3,7,2,17,0
2389,Benjamin Stambouli,31,19,14,15,2,11,21,52.4,10,16,6,10,12,28,1
2390,Junior Stanislas,10,7,2,3,5,3,8,37.5,5,6,0,6,4,6,0
2391,Niklas Stark,36,20,24,10,2,9,21,42.9,12,27,12,15,21,97,2
2392,Jed Steer,0,0,0,0,0,0,0,,0,0,0,0,0,0,0
2393,Renato Steffen,25,18,4,14,7,14,39,35.9,25,25,2,23,23,10,0
2394,Zack Steffen,0,0,0,0,0,0,0,,0,0,0,0,0,5,4
2395,Dale Stephens,73,44,30,37,6,25,75,33.3,50,31,11,20,58,42,2
2396,Jack Stephens,44,27,30,13,1,24,46,52.2,22,38,22,16,31,120,2
2397,Mariusz Stępiński,5,3,2,1,2,1,2,50.0,1,3,1,2,1,7,0
2398,Raheem Sterling,27,15,8,10,9,6,28,21.4,22,16,2,14,15,4,0
2399,Enda Stevens,81,46,48,26,7,42,96,43.8,54,27,8,19,35,71,3
2400,Marco Stiepermann,20,8,8,9,3,5,21,23.8,16,11,3,8,5,16,0
2401,Lars Stindl,27,16,4,15,8,10,28,35.7,18,18,2,16,10,7,0
2402,Kevin Stöger,21,15,10,7,4,6,24,25.0,18,24,2,22,26,7,1
2403,Vlatko Stojanovski,3,3,0,3,0,1,1,100.0,0,0,0,0,0,1,0
2404,John Stones,16,10,8,7,1,3,5,60.0,2,5,3,2,9,32,2
2405,Thomas Strakosha,0,0,0,0,0,0,1,0.0,1,0,0,0,0,7,2
2406,Gabriel Strefezza,64,40,28,26,10,22,54,40.7,32,29,3,26,21,17,0
2407,Tobias Strobl,9,6,5,4,0,3,8,37.5,5,8,4,4,11,5,0
2408,Christian Strohdiek,26,22,21,5,0,20,42,47.6,22,16,10,6,25,92,0
2409,Kevin Strootman,39,27,13,23,3,20,49,40.8,29,16,1,15,17,24,0
2410,Jens Stryger Larsen,27,19,15,9,3,17,30,56.7,13,20,5,15,20,52,0
2411,Stefano Sturaro,38,22,14,19,5,15,39,38.5,24,16,4,12,10,26,1
2412,Damián Suárez,62,32,32,21,9,38,72,52.8,34,25,2,23,27,41,0
2413,Denis Suárez,22,15,14,7,1,10,37,27.0,27,9,1,8,14,12,1
2414,Luis Suárez,4,0,0,1,3,2,12,16.7,10,6,1,5,1,11,0
2415,Mathías Suárez,2,2,2,0,0,2,3,66.7,1,0,0,0,1,3,0
2416,Neven Subotić,30,18,12,16,2,8,32,25.0,24,21,8,13,34,89,0
2417,Isaac Success,0,0,0,0,0,0,0,,0,0,0,0,1,0,0
2418,Marek Suchý,7,5,7,0,0,4,6,66.7,2,4,1,3,6,15,0
2419,Niklas Süle,10,6,8,2,0,4,5,80.0,1,8,6,2,8,22,1
2420,Ki Sung-yueng,1,1,0,1,0,1,3,33.3,2,1,0,1,3,2,0
2421,Ki Sung-yueng,0,0,0,0,0,0,1,0.0,1,0,0,0,0,0,0
2422,Stoppila Sunzu,16,8,12,4,0,10,15,66.7,5,22,15,7,24,63,0
2423,Andrew Surman,4,2,2,2,0,1,3,33.3,2,1,0,1,1,5,1
2424,Sam Surridge,0,0,0,0,0,0,0,,0,1,0,1,1,0,0
2425,Suso,7,3,2,3,2,2,10,20.0,8,5,0,5,8,3,0
2426,Suso,9,4,4,4,1,7,16,43.8,9,6,0,6,2,0,0
2427,Bosko Sutalo,3,2,2,1,0,0,2,0.0,2,4,0,4,6,6,1
2428,Markus Suttner,21,16,11,9,1,11,24,45.8,13,22,7,15,13,33,0
2429,Mattias Svanberg,13,8,9,4,0,6,31,19.4,25,15,4,11,13,10,0
2430,Issiaga Sylla,73,49,44,21,8,40,69,58.0,29,31,7,24,67,90,2
2431,Moussa Sylla,0,0,0,0,0,0,0,,0,0,0,0,0,0,0
2432,Eddy Sylvestre,0,0,0,0,0,0,1,0.0,1,0,0,0,0,0,0
2433,Ádám Szalai,8,4,0,6,2,1,11,9.1,10,9,0,9,2,14,0
2434,Wojciech Szczęsny,0,0,0,0,0,0,0,,0,0,0,0,1,10,1
2435,Andrea Tabanelli,22,13,10,9,3,8,28,28.6,20,13,2,11,11,19,0
2436,Tachi,2,1,2,0,0,1,4,25.0,3,5,4,1,4,12,0
2437,Panagiotis Tachtsidis,52,27,26,20,6,20,56,35.7,36,27,11,16,35,32,2
2438,Jonathan Tah,36,26,23,11,2,18,29,62.1,11,25,13,12,27,98,2
2439,Flavien Tait,20,13,12,6,2,9,28,32.1,19,7,0,7,9,5,1
2440,Mahdi Talal,0,0,0,0,0,0,1,0.0,1,1,0,1,0,2,0
2441,Adrien Tameze,4,3,1,1,2,1,2,50.0,1,3,1,2,3,4,1
2442,Adrien Tameze,6,2,2,3,1,4,16,25.0,12,7,2,5,7,1,1
2443,Japhet Tanganga,17,9,10,6,1,10,17,58.8,7,7,6,1,11,31,2
2444,Adil Taoui,2,2,0,2,0,0,2,0.0,2,0,0,0,2,0,0
2445,Edmond Tapsoba,24,15,17,5,2,15,25,60.0,10,9,5,4,9,44,0
2446,Matt Targett,52,29,37,11,4,22,53,41.5,31,28,8,20,56,82,0
2447,Rodrigo Tarín,10,7,8,2,0,9,14,64.3,5,7,3,4,9,51,0
2448,James Tarkowski,66,43,47,19,0,31,54,57.4,23,63,47,16,63,204,4
2449,Ciprian Tătărușanu,0,0,0,0,0,0,0,,0,0,0,0,0,0,1
2450,Júlio Tavares,12,8,1,6,5,4,17,23.5,13,9,2,7,8,29,0
2451,Charlie Taylor,39,24,26,9,4,19,39,48.7,20,29,9,20,29,78,1
2452,Neil Taylor,16,11,12,4,0,11,20,55.0,9,15,5,10,20,43,0
2453,Aurélien Tchouaméni,30,14,15,13,2,11,27,40.7,16,11,3,8,13,19,1
2454,Aurélien Tchouaméni,0,0,0,0,0,0,2,0.0,2,0,0,0,0,2,1
2455,Georg Teigl,3,1,1,2,0,2,4,50.0,2,0,0,0,3,1,0
2456,Álvaro Tejero,30,18,17,10,3,14,23,60.9,9,17,4,13,28,38,0
2457,Bernard Tekpetey,4,4,1,2,1,0,2,0.0,2,5,0,5,2,0,0
2458,Nathan Tella,0,0,0,0,0,0,0,,0,0,0,0,0,0,0
2459,Cristian Tello,8,5,2,2,4,4,8,50.0,4,5,0,5,4,0,0
2460,Lino Tempelmann,1,0,1,0,0,1,1,100.0,0,1,1,0,0,0,0
2461,Łukasz Teodorczyk,7,5,1,5,1,3,7,42.9,4,2,0,2,0,1,0
2462,Hidde ter Avest,18,9,13,3,2,14,17,82.4,3,6,1,5,9,27,0
2463,Marc-André ter Stegen,2,2,2,0,0,2,3,66.7,1,0,0,0,2,17,6
2464,Simon Terodde,8,5,4,3,1,3,13,23.1,10,14,3,11,2,14,0
2465,Pietro Terracciano,0,0,0,0,0,0,0,,0,0,0,0,0,4,0
2466,Martin Terrier,20,15,7,10,3,3,14,21.4,11,14,1,13,10,11,0
2467,Aleksa Terzić,0,0,0,0,0,0,0,,0,0,0,0,0,0,0
2468,Kenny Tete,33,21,12,16,5,15,23,65.2,8,12,3,9,19,34,0
2469,Alexander Tettey,23,18,7,16,0,11,39,28.2,28,20,9,11,43,72,1
2470,Florian Thauvin,1,0,0,1,0,0,1,0.0,1,0,0,0,0,0,0
2471,Demba Thiam,0,0,0,0,0,0,0,,0,0,0,0,1,0,0
2472,Malick Thiaw,2,0,1,1,0,1,2,50.0,1,2,2,0,2,4,1
2473,Niclas Thiede,0,0,0,0,0,0,0,,0,0,0,0,0,1,0
2474,Jan Thielmann,9,6,2,6,1,5,12,41.7,7,8,0,8,8,6,0
2475,Sada Thioub,20,12,8,9,3,5,18,27.8,13,9,1,8,4,5,0
2476,Jordan Thomas,0,0,0,0,0,0,0,,0,0,0,0,0,0,0
2477,Luke Thomas,1,0,0,1,0,0,3,0.0,3,2,0,2,3,7,0
2478,Romain Thomas,24,17,16,7,1,8,18,44.4,10,35,18,17,39,118,1
2479,Adrien Thomasson,36,21,11,16,9,15,47,31.9,32,21,1,20,9,9,0
2480,Erik Thommy,40,23,16,16,8,15,39,38.5,24,23,2,21,16,20,1
2481,Max Thompson,0,0,0,0,0,0,0,,0,0,0,0,0,0,0
2482,Morten Thorsby,53,34,17,23,13,27,52,51.9,25,24,6,18,17,34,0
2483,Khéphren Thuram,22,7,14,8,0,6,17,35.3,11,12,2,10,7,13,0
2484,Marcus Thuram,26,18,7,8,11,11,29,37.9,18,20,1,19,12,18,0
2485,Youri Tielemans,52,29,17,30,5,24,74,32.4,50,43,4,39,22,18,0
2486,Kieran Tierney,20,16,13,6,1,11,15,73.3,4,10,4,6,9,37,1
2487,Cheick Timite,1,0,0,1,0,0,1,0.0,1,0,0,0,2,1,0
2488,David Timor,9,6,4,5,0,5,16,31.3,11,8,3,5,18,23,0
2489,Marcel Tisserand,21,10,14,5,2,7,12,58.3,5,13,4,9,32,49,2
2490,Jean-Clair Todibo,1,0,1,0,0,0,1,0.0,1,0,0,0,0,6,0
2491,Jean-Clair Todibo,15,10,10,5,0,8,9,88.9,1,2,0,2,15,24,0
2492,Karl Toko Ekambi,5,3,0,3,2,1,4,25.0,3,2,0,2,3,2,0
2493,Karl Toko Ekambi,5,2,0,1,4,3,5,60.0,2,2,0,2,5,1,0
2494,Corentin Tolisso,9,4,4,3,2,1,9,11.1,8,9,3,6,4,2,1
2495,Jeremy Toljan,37,21,24,10,3,18,35,51.4,17,23,12,11,18,58,1
2496,Rafael Tolói,56,29,28,23,5,33,76,43.4,43,31,17,14,45,80,0
2497,Raúl de Tomás,9,7,3,4,2,4,13,30.8,9,8,1,7,10,4,0
2498,Takehiro Tomiyasu,42,24,25,13,4,22,41,53.7,19,34,9,25,49,78,1
2499,James Tomkins,29,17,21,8,0,18,25,72.0,7,17,15,2,21,103,0
2500,Fikayo Tomori,29,16,21,8,0,10,15,66.7,5,13,7,6,22,48,2
2501,Nenad Tomović,26,19,18,6,2,10,21,47.6,11,32,23,9,30,65,1
2502,Sandro Tonali,39,25,16,20,3,16,55,29.1,39,36,14,22,41,42,0
2503,Lorenzo Tonelli,13,9,13,0,0,4,10,40.0,6,10,7,3,4,23,0
2504,Toño,26,19,18,7,1,15,28,53.6,13,11,3,8,13,34,1
2505,Ömer Toprak,7,2,4,2,1,3,6,50.0,3,6,4,2,12,41,0
2506,Ernesto Torregrossa,17,7,5,10,2,6,22,27.3,16,10,2,8,5,22,0
2507,Lucas Torreira,31,16,11,15,5,16,39,41.0,23,24,8,16,34,24,0
2508,Ferrán Torres,23,15,6,16,1,8,30,26.7,22,20,3,17,14,12,0
2509,Óliver Torres,45,27,12,26,7,23,60,38.3,37,23,1,22,13,9,1
2510,Pau Torres,34,21,24,10,0,16,24,66.7,8,39,23,16,27,153,1
2511,Roberto Torres,33,16,12,18,3,21,49,42.9,28,41,2,39,31,37,0
2512,Lucas Torró,12,7,6,6,0,8,16,50.0,8,2,1,1,8,3,0
2513,Jordan Torunarigha,32,19,21,11,0,18,27,66.7,9,33,18,15,31,75,0
2514,Cenk Tosun,2,2,2,0,0,0,2,0.0,2,0,0,0,0,1,0
2515,Cenk Tosun,2,0,0,0,2,0,1,0.0,1,1,0,1,0,1,0
2516,Abdoulaye Touré,32,21,10,21,1,10,30,33.3,20,31,11,20,29,18,1
2517,Almamy Touré,32,19,18,11,3,11,22,50.0,11,18,7,11,23,54,1
2518,Lucas Tousart,58,32,19,34,5,17,56,30.4,39,19,7,12,31,27,1
2519,Andros Townsend,34,21,12,17,5,15,37,40.5,22,18,0,18,15,10,1
2520,Aleksandar Trajkovski,2,0,1,1,0,1,7,14.3,6,2,0,2,3,1,0
2521,Adama Traoré,33,21,6,14,13,8,23,34.8,15,19,3,16,13,14,2
2522,Adama Traoré,3,1,1,2,0,3,12,25.0,9,7,2,5,3,5,0
2523,Adama Traoré,0,0,0,0,0,0,0,,0,0,0,0,1,0,0
2524,Bertrand Traoré,27,14,8,12,7,8,19,42.1,11,17,2,15,21,16,0
2525,Charles Traore,48,35,27,19,2,36,61,59.0,25,21,4,17,39,64,0
2526,Hamari Traoré,55,26,34,18,3,32,64,50.0,32,22,5,17,48,59,1
2527,Ibrahima Traoré,4,3,1,1,2,1,7,14.3,6,1,0,1,1,3,0
2528,Ismaël Traoré,23,12,14,7,2,10,17,58.8,7,23,13,10,27,85,1
2529,Kevin Trapp,0,0,0,0,0,0,1,0.0,1,0,0,0,3,5,0
2530,Miguel Trauco,32,20,16,12,4,19,44,43.2,25,8,1,7,23,25,0
2531,Mark Travers,0,0,0,0,0,0,0,,0,0,0,0,0,1,1
2532,Luca Tremolada,0,0,0,0,0,0,0,,0,0,0,0,0,0,0
2533,Trézéguet,38,16,18,15,5,9,44,20.5,35,23,2,21,25,18,0
2534,Manu Trigueros,34,21,10,17,7,12,45,26.7,33,23,12,11,4,21,0
2535,Christopher Trimmel,71,41,35,32,4,32,54,59.3,22,31,10,21,51,88,1
2536,Alessandro Tripaldelli,4,4,1,3,0,1,3,33.3,2,1,0,1,3,3,0
2537,Kieran Trippier,52,34,24,21,7,34,53,64.2,19,33,7,26,24,46,0
2538,William Troost-Ekong,37,19,25,12,0,10,18,55.6,8,41,29,12,31,135,2
2539,Leandro Trossard,22,17,7,12,3,6,38,15.8,32,16,1,15,9,8,0
2540,Tom Trybull,39,25,15,18,6,16,60,26.7,44,20,5,15,16,35,0
2541,Axel Tuanzebe,2,2,0,2,0,1,2,50.0,1,1,0,1,5,5,1
2542,Georgi Tunjov,4,4,3,1,0,1,11,9.1,10,3,1,2,1,0,0
2543,Stefano Turati,0,0,0,0,0,0,0,,0,0,0,0,0,1,0
2544,Gennaro Tutino,0,0,0,0,0,0,0,,0,0,0,0,2,1,0
2545,Matthieu Udol,29,19,19,8,2,13,24,54.2,11,21,4,17,23,43,0
2546,Hwang Ui-jo,9,7,2,5,2,4,20,20.0,16,7,0,7,5,5,0
2547,Anthony Ujah,8,6,4,2,2,1,6,16.7,5,0,0,0,3,10,0
2548,Samir Ujkani,0,0,0,0,0,0,0,,0,0,0,0,0,1,0
2549,Sven Ulreich,0,0,0,0,0,0,0,,0,0,0,0,0,0,0
2550,Samuel Umtiti,11,5,5,5,1,5,8,62.5,3,4,2,2,22,32,0
2551,Enes Ünal,20,12,6,11,3,6,28,21.4,22,17,5,12,6,13,0
2552,Cengiz Ünder,10,6,4,4,2,2,9,22.2,7,7,2,5,8,7,0
2553,Dayot Upamecano,52,31,37,15,0,23,43,53.5,20,31,17,14,43,88,1
2554,Mark Uth,19,12,4,10,5,9,32,28.1,23,15,0,15,7,3,0
2555,Mark Uth,3,2,1,1,1,0,3,0.0,3,4,0,4,1,0,0
2556,Tomáš Vaclík,0,0,0,0,0,0,1,0.0,1,0,0,0,0,7,0
2557,Álvaro Vadillo,16,11,6,8,2,9,16,56.3,7,12,0,12,7,2,0
2558,William Vainqueur,68,36,30,32,6,22,60,36.7,38,21,5,16,29,23,0
2559,Mirko Valdifiori,31,15,14,17,0,16,33,48.5,17,8,3,5,4,25,0
2560,Pierrick Valdivia,1,1,0,0,1,0,1,0.0,1,0,0,0,0,0,0
2561,Germán Valera,0,0,0,0,0,0,0,,0,1,0,1,0,0,0
2562,Antoine Valerio,1,1,0,1,0,0,2,0.0,2,2,0,2,3,1,0
2563,Borja Valero,18,7,9,3,6,6,24,25.0,18,12,3,9,8,9,0
2564,Yan Valery,20,7,9,7,4,11,19,57.9,8,9,1,8,13,32,2
2565,Martin Valjent,25,17,14,10,1,13,25,52.0,12,39,27,12,37,146,1
2566,Jesús Vallejo,1,1,1,0,0,1,2,50.0,1,4,3,1,2,8,1
2567,Jesús Vallejo,6,5,4,2,0,3,4,75.0,1,7,4,3,5,28,0
2568,Manu Vallejo,7,3,0,3,4,5,9,55.6,4,4,0,4,2,2,0
2569,Luca Valls,1,0,1,0,0,1,1,100.0,0,1,0,1,0,0,0
2570,Theo Valls,39,16,12,26,1,16,50,32.0,34,17,0,17,13,6,0
2571,Mattia Valoti,48,30,21,25,2,16,43,37.2,27,27,6,21,16,18,0
2572,Federico Valverde,38,19,9,19,10,12,36,33.3,24,38,4,34,21,12,2
2573,Virgil van Dijk,23,12,18,5,0,6,13,46.2,7,20,15,5,40,166,2
2574,Raphaël Varane,30,17,15,14,1,12,23,52.2,11,32,16,16,31,124,0
2575,Jamie Vardy,15,12,0,9,6,2,4,50.0,2,22,4,18,2,22,0
2576,Matías Vargas,13,5,7,3,3,4,23,17.4,19,12,2,10,3,5,0
2577,Ruben Vargas,32,16,18,7,7,8,36,22.2,28,26,1,25,26,35,0
2578,Thibaut Vargas,3,1,3,0,0,2,5,40.0,3,1,1,0,0,3,0
2579,Sebastian Vasiliadis,73,45,34,31,8,28,81,34.6,53,47,6,41,34,50,0
2580,Indiana Vassilev,0,0,0,0,0,0,0,,0,0,0,0,0,0,0
2581,Denis Vavro,3,3,2,1,0,1,3,33.3,2,8,6,2,5,10,0
2582,Franco Vázquez,25,17,9,14,2,6,36,16.7,30,13,0,13,10,10,0
2583,Kevin Vázquez,26,15,16,6,4,15,28,53.6,13,18,1,17,26,28,0
2584,Lucas Vázquez,23,17,10,13,0,11,26,42.3,15,10,0,10,10,8,1
2585,Matías Vecino,31,20,14,11,6,9,36,25.0,27,20,3,17,15,26,0
2586,Koke Vegas,0,0,0,0,0,0,1,0.0,1,0,0,0,0,3,0
2587,Miloš Veljković,55,33,36,18,1,33,53,62.3,20,25,11,14,26,92,1
2588,Miguel Veloso,52,29,20,28,4,18,60,30.0,42,36,12,24,32,46,1
2589,Unai Vencedor Paris,0,0,0,0,0,0,0,,0,0,0,0,0,0,0
2590,Lorenzo Venuti,20,10,12,6,2,13,19,68.4,6,5,1,4,11,15,0
2591,Brayan Vera,4,1,2,1,1,3,7,42.9,4,1,0,1,1,4,0
2592,Simone Verdi,19,10,4,12,3,9,38,23.7,29,14,0,14,7,1,0
2593,Jordan Veretout,36,18,13,16,7,14,43,32.6,29,35,5,30,18,31,1
2594,Marco Verratti,54,32,22,22,10,20,56,35.7,36,23,3,20,19,9,0
2595,Valerio Verre,25,15,4,11,10,9,23,39.1,14,5,0,5,13,9,0
2596,Birger Verstraete,20,11,9,10,1,11,21,52.4,10,8,1,7,4,10,1
2597,Jan Vertonghen,40,24,25,14,1,20,31,64.5,11,18,10,8,33,68,0
2598,Mikel Vesga,25,17,7,12,6,9,45,20.0,36,18,7,11,31,24,1
2599,Jannik Vestergaard,19,12,14,5,0,11,28,39.3,17,15,9,6,26,99,2
2600,Rúben Vezo,41,24,28,13,0,19,35,54.3,16,37,29,8,42,144,2
2601,Francesco Vicari,27,13,20,6,1,12,25,48.0,13,48,37,11,38,145,1
2602,Fede Vico,5,1,2,3,0,2,11,18.2,9,12,1,11,5,2,0
2603,Aleix Vidal,21,14,8,11,2,8,37,21.6,29,14,1,13,23,18,0
2604,Arturo Vidal,63,38,22,30,11,24,58,41.4,34,31,7,24,17,16,1
2605,Clément Vidal,0,0,0,0,0,0,2,0.0,2,1,1,0,0,6,0
2606,Nacho Vidal,45,29,26,13,6,21,38,55.3,17,24,6,18,44,70,1
2607,Ronaldo Vieira,33,19,13,17,3,6,28,21.4,22,14,2,12,21,31,0
2608,Mauro Vigorito,0,0,0,0,0,0,0,,0,0,0,0,0,3,1
2609,Dídac Vilà,73,42,44,23,6,25,61,41.0,36,31,5,26,40,63,0
2610,Toni Villa,31,16,13,14,4,13,50,26.0,37,16,1,15,8,11,0
2611,Asier Villalibre,0,0,0,0,0,0,3,0.0,3,3,0,3,1,4,0
2612,Gonzalo Villar,5,3,4,0,1,2,4,50.0,2,2,0,2,2,3,0
2613,Iván Villar,0,0,0,0,0,0,0,,0,0,0,0,0,5,0
2614,Juan Villar,1,0,0,1,0,0,2,0.0,2,4,1,3,1,0,0
2615,Rúben Vinagre,23,13,15,6,2,12,15,80.0,3,7,2,5,11,22,0
2616,Luigi Vitale,1,0,0,1,0,0,0,,0,1,0,1,0,0,0
2617,Vitolo,15,12,7,7,1,5,17,29.4,12,9,0,9,10,9,0
2618,Mattia Viviani,3,1,0,3,0,1,8,12.5,7,3,3,0,9,2,1
2619,Dušan Vlahović,6,2,1,4,1,4,13,30.8,9,5,2,3,7,6,0
2620,Kevin Vogt,7,5,4,3,0,3,9,33.3,6,12,6,6,8,52,1
2621,Kevin Vogt,14,10,8,6,0,8,16,50.0,8,15,12,3,25,37,1
2622,Jake Vokins,2,2,0,0,2,1,1,100.0,0,0,0,0,0,1,0
2623,Kevin Volland,16,6,5,6,5,5,16,31.3,11,14,2,12,5,7,0
2624,Mario Vrančić,27,16,14,11,2,16,27,59.3,11,9,0,9,10,4,2
2625,Stefan de Vrij,33,18,20,12,1,14,27,51.9,13,34,24,10,52,121,1
2626,Giacomo Vrioni,0,0,0,0,0,0,0,,0,0,0,0,0,0,0
2627,Šime Vrsaljko,6,5,6,0,0,5,6,83.3,1,5,3,2,8,11,0
2628,Nikola Vukčević,41,26,17,17,7,15,40,37.5,25,19,7,12,12,16,0
2629,Matěj Vydra,4,3,0,3,1,3,6,50.0,3,7,3,4,1,6,0
2630,Molla Wagué,15,12,11,4,0,7,7,100.0,0,10,8,2,15,42,0
2631,Moussa Wagué,2,1,1,0,1,1,1,100.0,0,0,0,0,1,0,0
2632,Moussa Wagué,6,4,3,3,0,2,3,66.7,1,2,1,1,2,2,0
2633,Wakaso,54,31,25,24,5,16,33,48.5,17,23,5,18,17,17,1
2634,Walace,28,9,19,6,3,13,42,31.0,29,14,6,8,33,19,0
2635,Theo Walcott,13,8,6,5,2,3,15,20.0,12,13,0,13,8,1,0
2636,Luca Waldschmidt,10,7,3,5,2,2,18,11.1,16,11,2,9,4,4,0
2637,Kyle Walker,28,18,12,15,1,12,29,41.4,17,15,6,9,28,42,1
2638,Kyle Walker-Peters,13,8,5,6,2,6,16,37.5,10,10,3,7,14,21,1
2639,Kyle Walker-Peters,8,5,8,0,0,5,9,55.6,4,4,2,2,3,5,1
2640,Rémi Walter,1,1,0,1,0,1,1,100.0,0,0,0,0,0,0,0
2641,Sebastian Walukiewicz,25,11,17,8,0,14,22,63.6,8,21,14,7,14,41,0
2642,Aaron Wan-Bissaka,129,80,71,50,8,64,86,74.4,22,46,13,33,66,83,0
2643,Victor Wanyama,0,0,0,0,0,0,0,,0,0,0,0,0,0,0
2644,Joel Ward,69,42,48,16,5,39,56,69.6,17,13,6,7,48,93,1
2645,James Ward-Prowse,92,48,39,39,14,39,94,41.5,55,48,14,34,60,75,1
2646,Daniel Wass,44,25,25,13,6,25,57,43.9,32,22,5,17,31,91,1
2647,Kelland Watts,1,0,1,0,0,1,1,100.0,0,0,0,0,0,0,0
2648,Timothy Weah,0,0,0,0,0,0,1,0.0,1,0,0,0,0,1,0
2649,Adam Webster,30,17,21,8,1,14,32,43.8,18,43,26,17,45,110,2
2650,Wout Weghorst,15,8,4,5,6,1,17,5.9,16,17,4,13,2,30,0
2651,Julian Weigl,16,9,12,3,1,9,16,56.3,7,10,0,10,8,21,0
2652,Mitchell Weiser,41,29,20,17,4,18,30,60.0,12,19,2,17,24,22,1
2653,Danny Welbeck,14,6,6,5,3,3,11,27.3,8,12,1,11,5,7,0
2654,Wendell,64,42,26,26,12,41,66,62.1,25,30,4,26,36,36,0
2655,Oscar Wendt,26,14,16,8,2,12,31,38.7,19,27,6,21,20,45,0
2656,Timo Werner,20,9,6,7,7,3,16,18.8,13,16,0,16,5,2,0
2657,Ashley Westwood,54,33,15,32,7,17,48,35.4,31,23,11,12,32,32,3
2658,Connor Wickham,1,1,1,0,0,0,0,,0,1,0,1,1,0,0
2659,Felix Wiedwald,0,0,0,0,0,0,0,,0,0,0,0,0,2,1
2660,Georginio Wijnaldum,38,20,12,21,5,10,40,25.0,30,18,4,14,17,34,3
2661,Jetro Willems,37,19,29,6,2,18,39,46.2,21,20,5,15,17,42,1
2662,William,55,26,34,14,7,27,59,45.8,32,10,3,7,24,38,1
2663,Brandon Williams,21,15,11,6,4,9,29,31.0,20,9,4,5,16,27,0
2664,Iñaki Williams,15,5,0,7,8,5,18,27.8,13,18,2,16,5,29,0
2665,Neco Williams,5,3,1,3,1,4,5,80.0,1,3,1,2,9,6,0
2666,Willian,45,27,14,24,7,14,43,32.6,29,15,0,15,20,7,0
2667,Joe Willock,25,16,9,12,4,8,21,38.1,13,16,2,14,4,11,2
2668,Jack Wilshere,1,0,1,0,0,0,4,0.0,4,3,0,3,1,0,0
2669,Callum Wilson,12,9,3,6,3,2,17,11.8,15,16,2,14,4,16,0
2670,Harry Wilson,23,13,8,10,5,11,34,32.4,23,26,2,24,11,15,1
2671,Harry Winks,40,24,18,20,2,17,54,31.5,37,27,8,19,36,32,1
2672,Florian Wirtz,4,2,0,4,0,2,4,50.0,2,4,0,4,2,1,0
2673,Axel Witsel,28,20,10,17,1,14,33,42.4,19,26,7,19,31,19,1
2674,Hannes Wolf,3,0,0,1,2,1,4,25.0,3,0,0,0,0,0,0
2675,Marius Wolf,19,11,9,7,3,10,27,37.0,17,14,1,13,17,13,0
2676,Nick Woltemade,2,1,0,2,0,0,1,0.0,1,1,0,1,0,2,0
2677,Chris Wood,7,4,2,4,1,5,15,33.3,10,15,2,13,4,18,0
2678,Xeka,18,10,3,13,2,9,29,31.0,20,11,1,10,4,7,1
2679,Granit Xhaka,45,25,20,19,6,25,55,45.5,30,32,16,16,21,59,3
2680,Jawad El Yamiq,3,2,3,0,0,1,4,25.0,3,3,2,1,1,3,0
2681,Andriy Yarmolenko,13,8,5,6,2,5,20,25.0,15,3,1,2,6,4,0
2682,Yusuf Yazıcı,17,8,2,11,4,5,13,38.5,8,6,1,5,5,1,1
2683,DeAndre Yedlin,18,13,10,6,2,8,16,50.0,8,13,7,6,10,20,0
2684,Yoel,0,0,0,0,0,0,0,,0,0,0,0,1,1,0
2685,Okay Yokuşlu,41,27,18,21,2,20,42,47.6,22,12,5,7,28,71,1
2686,Maya Yoshida,8,5,4,1,3,3,7,42.9,4,6,2,4,4,27,1
2687,Maya Yoshida,4,3,2,2,0,2,6,33.3,4,15,12,3,27,72,0
2688,Elie Youan,0,0,0,0,0,0,7,0.0,7,2,0,2,0,3,0
2689,Amin Younes,3,2,1,2,0,2,4,50.0,2,2,0,2,0,1,0
2690,Ashley Young,14,7,7,4,3,5,17,29.4,12,8,2,6,11,29,0
2691,Ashley Young,11,5,3,5,3,6,19,31.6,13,11,3,8,14,24,0
2692,Zaydou Youssouf,40,22,12,26,2,15,35,42.9,20,7,1,6,16,13,0
2693,Pablo Zabaleta,18,10,12,5,1,6,13,46.2,7,5,3,2,14,21,0
2694,Mattia Zaccagni,20,11,10,5,5,3,15,20.0,12,14,3,11,20,21,0
2695,Dan-Axel Zagadou,16,10,12,4,0,6,8,75.0,2,12,8,4,15,38,0
2696,Arthur Zagre,1,0,1,0,0,0,0,,0,1,0,1,1,0,0
2697,Wilfried Zaha,43,19,18,12,13,12,49,24.5,37,22,2,20,18,4,0
2698,Denis Zakaria,49,30,23,23,3,20,39,51.3,19,39,12,27,37,31,1
2699,Joseba Zaldúa,62,43,39,18,5,31,59,52.5,28,31,7,24,37,71,0
2700,Andre-Frank Zambo Anguissa,76,49,29,40,7,26,78,33.3,52,42,6,36,44,30,0
2701,Luca Zanimacchia,5,1,1,2,2,1,2,50.0,1,1,0,1,0,0,0
2702,Nicolò Zaniolo,15,11,4,7,4,3,24,12.5,21,14,0,14,5,5,0
2703,Cristián Zapata,23,17,16,7,0,8,16,50.0,8,29,17,12,24,75,0
2704,Duván Zapata,7,3,1,2,4,1,6,16.7,5,18,7,11,2,11,0
2705,Davide Zappacosta,7,3,2,3,2,4,8,50.0,4,3,1,2,6,8,1
2706,Simone Zaza,15,10,6,4,5,3,10,30.0,7,11,0,11,9,13,1
2707,Marvin Zeegelaar,15,9,8,4,3,6,11,54.5,5,9,2,7,5,10,0
2708,Mootaz Zemzemi,0,0,0,0,0,0,0,,0,0,0,0,1,0,0
2709,Arber Zeneli,0,0,0,0,0,0,0,,0,0,0,0,0,0,0
2710,Robin Zentner,1,1,1,0,0,1,1,100.0,0,0,0,0,0,11,0
2711,Piotr Zieliński,26,16,10,11,5,12,30,40.0,18,28,5,23,21,15,0
2712,Jean Zimmer,11,6,5,5,1,5,10,50.0,5,3,1,2,3,0,0
2713,Christoph Zimmermann,32,21,26,6,0,21,30,70.0,9,22,18,4,19,87,2
2714,Matthias Zimmermann,62,47,26,27,9,31,64,48.4,33,41,15,26,43,59,0
2715,Oleksandr Zinchenko,31,19,16,11,4,17,32,53.1,15,9,0,9,17,21,1
2716,Leopold Zingerle,3,1,3,0,0,2,4,50.0,2,0,0,0,0,7,2
2717,Joshua Zirkzee,5,2,0,2,3,2,4,50.0,2,2,0,2,1,0,0
2718,Richairo Živković,2,2,0,2,0,1,2,50.0,1,1,0,1,0,0,0
2719,Jaromír Zmrhal,10,4,2,5,3,5,18,27.8,13,8,1,7,4,11,0
2720,Kévin Zohi,8,6,3,3,2,3,6,50.0,3,1,0,1,4,2,0
2721,Ben Zolinski,17,9,7,9,1,7,27,25.9,20,12,0,12,8,4,0
2722,Kurt Zouma,23,14,17,6,0,9,16,56.3,7,22,14,8,58,116,2
2723,Igor Zubeldia,42,21,18,19,5,17,35,48.6,18,38,21,17,26,82,2
2724,Steven Zuber,11,10,7,2,2,9,19,47.4,10,4,1,3,9,12,0
2725,Martín Zubimendi,16,12,9,7,0,6,12,50.0,6,7,0,7,9,2,0
2726,Ervin Zukanović,1,0,0,0,1,1,1,100.0,0,3,1,2,3,15,0
2727,Bongani Zungu,27,11,10,13,4,18,31,58.1,13,8,2,6,16,21,0
2728,Szymon Żurkowski,1,0,0,0,1,0,2,0.0,2,0,0,0,0,1,0
2729,David Zurutuza,4,3,0,3,1,1,2,50.0,1,1,0,1,4,3,0
2730,Martin Ødegaard,27,19,5,14,8,7,34,20.6,27,13,0,13,17,5,0
2731,Filip Đuričić,23,14,2,10,11,3,19,15.8,16,20,3,17,8,14,0
