,Player,Tkl,TklW,Def 3rd,Mid 3rd,Att 3rd,TklDribblers,Att,Tkl%,Lost,Blocks,Sh,Pass,Int,Clr,Err
0,Max Aarons,64,44,49,15,0,37,55,67.3,18,39,19,20,28,96,1
1,Yunis Abdelhamid,48,27,34,14,0,16,32,50.0,16,50,25,25,68,104,0
2,Salis Abdul Samed,43,23,25,16,2,20,57,35.1,37,18,1,17,42,15,0
3,Laurent Abergel,110,60,44,53,13,71,166,42.8,95,58,1,57,55,13,0
4,Charles Abi,0,0,0,0,0,0,1,0.0,1,2,0,2,0,0,0
5,Dickson Abiama,11,7,4,5,2,2,10,20.0,8,12,1,11,4,8,0
6,Matthis Abline,0,0,0,0,0,0,0,,0,2,0,2,0,1,0
7,Tammy Abraham,27,13,7,14,6,9,22,40.9,13,17,3,14,5,27,0
8,Luis Abram,6,3,3,3,0,2,4,50.0,2,6,5,1,5,37,1
9,Francesco Acerbi,25,12,15,9,1,12,19,63.2,7,37,28,9,34,92,0
10,Ragnar Ache,2,0,0,1,1,1,4,25.0,3,3,0,3,0,1,0
11,Mohamed Achi,0,0,0,0,0,0,0,,0,0,0,0,0,0,0
12,Marcos Acuña,50,29,27,14,9,30,46,65.2,16,22,5,17,14,25,1
13,Che Adams,13,6,5,5,3,2,16,12.5,14,18,2,16,8,18,0
14,Tyler Adams,23,7,5,16,2,7,25,28.0,18,24,1,23,16,19,2
15,Sargis Adamyan,8,6,3,4,1,3,11,27.3,8,4,0,4,1,2,0
16,Martin Adeline,15,11,5,8,2,8,16,50.0,8,0,0,0,11,6,0
17,Amine Adli,27,14,10,14,3,8,15,53.3,7,26,2,24,11,12,0
18,Yacine Adli,43,27,22,14,7,19,68,27.9,49,33,3,30,37,11,2
19,Michel Aebischer,14,5,5,8,1,6,11,54.5,5,4,1,3,6,3,0
20,Felix Afena-Gyan,10,3,1,6,3,4,7,57.1,3,4,0,4,3,0,0
21,Martin Agirregabiria,34,22,17,11,6,18,37,48.6,19,20,3,17,25,38,0
22,Julen Agirrezabala,0,0,0,0,0,0,0,,0,0,0,0,0,2,0
23,Lucien Agoume,51,31,24,20,7,23,45,51.1,22,30,9,21,52,27,1
24,Kevin Agudelo,44,26,13,26,5,7,20,35.0,13,22,0,22,8,6,0
25,Nayef Aguerd,27,18,16,11,0,14,24,58.3,10,24,14,10,24,127,1
26,Sergio Agüero,1,1,0,0,1,0,2,0.0,2,0,0,0,0,0,0
27,Ruben Aguilar,78,53,39,32,7,43,68,63.2,25,19,4,15,44,57,0
28,Álvaro Aguirre,0,0,0,0,0,0,0,,0,0,0,0,0,0,0
29,Naouirou Ahamada,1,0,1,0,0,1,3,33.3,2,0,0,0,0,0,0
30,Anel Ahmedhodžić,38,26,27,9,2,20,31,64.5,11,16,8,8,22,44,0
31,Jean-Eudes Aholou,16,9,4,9,3,5,19,26.3,14,8,1,7,19,7,0
32,Joseph Aidoo,39,26,28,10,1,17,31,54.8,14,23,13,10,38,96,3
33,Ola Aina,27,19,11,10,6,15,23,65.2,8,17,3,14,28,30,0
34,Rayan Aït-Nouri,64,36,46,15,3,22,44,50.0,22,24,2,22,22,39,1
35,Kristoffer Ajer,29,18,21,6,2,13,21,61.9,8,19,11,8,26,74,0
36,Ludovic Ajorque,36,25,5,19,12,7,40,17.5,33,28,3,25,8,31,1
37,Manuel Akanji,33,23,20,11,2,22,32,68.8,10,26,15,11,35,58,0
38,Carlos Akapo,43,31,26,15,2,21,37,56.8,16,26,7,19,51,61,0
39,Marley Aké,0,0,0,0,0,0,2,0.0,2,0,0,0,1,0,0
40,Nathan Aké,16,9,7,8,1,6,8,75.0,2,7,5,2,8,23,0
41,Ilias Akhomach,2,0,0,1,1,0,0,,0,0,0,0,0,0,0
42,Maghnes Akliouche,2,0,0,2,0,0,1,0.0,1,2,0,2,0,0,0
43,Paul Akouokou,14,9,5,7,2,8,12,66.7,4,6,0,6,11,6,0
44,Jean-Daniel Akpa-Akpro,17,10,7,9,1,7,12,58.3,5,4,2,2,2,6,0
45,Kevin Akpoguma,33,19,16,11,6,16,28,57.1,12,32,2,30,20,29,2
46,David Alaba,23,13,15,6,2,9,19,47.4,10,26,15,11,22,70,1
47,Sofiane Alakouch,7,4,3,4,0,2,5,40.0,3,4,0,4,1,4,0
48,Tomás Alarcón,31,20,17,10,4,10,31,32.3,21,19,7,12,30,31,0
49,Lucas Alario,6,5,0,2,4,2,5,40.0,3,5,0,5,1,6,0
50,Jordi Alba,47,34,12,26,9,27,47,57.4,20,26,6,20,33,41,1
51,Josué Albert,0,0,0,0,0,0,0,,0,0,0,0,1,2,0
52,Luis Alberto,29,17,8,11,10,8,52,15.4,44,32,4,28,13,7,0
53,Raúl Albiol,26,15,20,5,1,14,18,77.8,4,24,15,9,21,126,1
54,Marc Albrighton,31,19,16,9,6,10,47,21.3,37,15,3,12,14,20,0
55,Paco Alcácer,9,3,2,4,3,1,5,20.0,4,7,0,7,6,1,0
56,Thiago Alcántara,48,29,14,24,10,10,42,23.8,32,22,2,20,26,13,2
57,Rubén Alcaraz,41,20,14,24,3,22,45,48.9,23,10,2,8,13,14,0
58,Omar Alderete,53,34,34,17,2,34,53,64.2,19,30,18,12,35,153,0
59,Iván Alejo,33,15,21,10,2,15,44,34.1,29,12,0,12,8,17,0
60,Doğan Alemdar,0,0,0,0,0,0,0,,0,0,0,0,0,9,1
61,Carles Aleñá,27,19,11,13,3,9,48,18.8,39,21,2,19,15,16,0
62,Trent Alexander-Arnold,40,23,19,13,8,27,60,45.0,33,22,4,18,43,40,0
63,Mohamed Ali Cho,10,5,1,4,5,5,17,29.4,12,17,1,16,8,0,1
64,Alisson,3,1,3,0,0,3,5,60.0,2,1,0,1,0,28,1
65,Allan,74,44,28,39,7,34,105,32.4,71,40,9,31,23,39,1
66,Jim Allevinah,18,13,8,8,2,5,18,27.8,13,11,0,11,6,4,0
67,Dele Alli,14,8,10,3,1,5,17,29.4,12,22,5,17,6,16,0
68,Dele Alli,7,2,3,4,0,0,4,0.0,4,7,2,5,6,10,0
69,Miguel Almirón,47,29,23,17,7,11,44,25.0,33,14,1,13,20,13,0
70,Marcos Alonso,41,29,20,12,9,17,36,47.2,19,29,5,24,43,53,0
71,Giorgio Altare,39,28,18,18,3,21,26,80.8,5,17,5,12,30,70,0
72,Hugo Álvarez,1,0,1,0,0,0,0,,0,0,0,0,0,1,0
73,Yeray Álvarez,24,14,15,8,1,10,18,55.6,8,21,16,5,45,97,0
74,Dani Alves,30,19,13,13,4,14,26,53.8,12,10,3,7,11,10,2
75,Steven Alzate,10,4,4,5,1,4,7,57.1,3,2,1,1,10,10,0
76,Ibrahim Amadou,16,8,10,6,0,8,15,53.3,7,4,2,2,14,26,0
77,Emmanuel Amankwaa Akurugu,0,0,0,0,0,0,2,0.0,2,1,0,1,0,0,0
78,Daniel Amartey,26,13,19,7,0,19,29,65.5,10,30,22,8,21,93,4
79,Amath,21,11,11,6,4,7,17,41.2,10,12,0,12,7,7,0
80,Jordan Amavi,16,10,8,7,1,10,17,58.8,7,3,1,2,15,7,0
81,Jordan Amavi,6,5,3,1,2,5,10,50.0,5,1,0,1,1,3,0
82,Wisdom Amey,3,2,1,1,1,2,3,66.7,1,2,0,2,3,1,0
83,Kelvin Amian,66,42,43,18,5,30,41,73.2,11,39,21,18,32,75,0
84,Nadiem Amiri,6,4,2,2,2,2,9,22.2,7,7,0,7,0,0,0
85,Nadiem Amiri,8,4,3,2,3,4,8,50.0,4,4,2,2,5,0,0
86,Ethan Ampadu,67,43,37,27,3,24,58,41.4,34,49,19,30,51,76,0
87,Sofyan Amrabat,24,13,9,13,2,11,19,57.9,8,25,8,17,5,6,1
88,Joachim Andersen,30,23,21,9,0,16,27,59.3,11,29,19,10,37,125,3
89,Felipe Anderson,71,45,30,33,8,27,99,27.3,72,65,6,59,20,16,0
90,Sebastian Andersson,11,7,0,3,8,3,9,33.3,6,8,0,8,3,14,0
91,Florin Andone,1,1,1,0,0,0,1,0.0,1,2,0,2,0,1,0
92,Andrés Andrade Cedeño,27,16,18,8,1,17,35,48.6,18,16,7,9,19,44,0
93,Benjamin André,123,69,49,65,9,51,113,45.1,62,49,11,38,50,56,0
94,Fredrik André Bjørkan,12,10,7,4,1,7,9,77.8,2,6,2,4,6,8,0
95,Marcos André,15,11,4,6,5,5,16,31.3,11,15,0,15,7,13,0
96,Robert Andrich,33,17,18,14,1,14,28,50.0,14,19,7,12,31,46,0
97,José Ángel,20,13,9,9,2,9,14,64.3,5,6,1,5,10,21,0
98,Angeliño,28,21,14,13,1,14,30,46.7,16,24,3,21,29,40,0
99,Ebenezer Annan,1,1,1,0,0,0,0,,0,0,0,0,1,1,0
100,Cristian Ansaldi,20,9,11,7,2,10,13,76.9,3,9,1,8,6,10,0
101,Janis Antiste,18,11,6,6,6,5,13,38.5,8,7,1,6,4,6,0
102,Waldemar Anton,40,26,22,15,3,19,32,59.4,13,27,16,11,32,116,1
103,Josep Antoni Gayá,0,0,0,0,0,0,0,,0,1,0,1,1,3,1
104,Michail Antonio,23,17,5,9,9,7,18,38.9,11,19,1,18,3,13,0
105,Christopher Antwi-Adjei,21,18,7,8,6,6,26,23.1,20,12,0,12,1,8,0
106,Houssem Aouar,46,30,9,25,12,27,54,50.0,27,26,1,25,20,5,0
107,Adil Aouchiche,13,6,5,5,3,5,33,15.2,28,18,1,17,17,4,0
108,Dennis Appiah,55,34,35,18,2,28,48,58.3,20,30,13,17,27,74,0
109,Mauro Arambarri,62,37,19,32,11,20,68,29.4,48,35,5,30,32,18,0
110,Mattia Aramu,20,15,5,9,6,8,33,24.2,25,20,2,18,8,19,0
111,Charles Aránguiz,45,25,18,21,6,22,52,42.3,30,24,4,20,33,21,0
112,Néstor Araujo,22,14,17,5,0,9,21,42.9,12,17,10,7,27,105,2
113,Ronald Araújo,41,23,29,12,0,21,25,84.0,4,37,20,17,23,66,1
114,Cameron Archer,0,0,0,0,0,0,0,,0,0,0,0,0,0,0
115,Alphonse Areola,0,0,0,0,0,0,0,,0,0,0,0,0,1,0
116,Jesús Areso,3,3,2,1,0,0,2,0.0,2,0,0,0,0,2,1
117,Matias Arezo,5,3,2,1,2,4,9,44.4,5,1,0,1,1,1,0
118,Santiago Arias,12,5,8,3,1,4,9,44.4,5,8,4,4,5,10,0
119,Adam Armstrong,10,4,2,2,6,0,6,0.0,6,13,1,12,3,6,0
120,Stuart Armstrong,27,19,15,6,6,9,23,39.1,14,10,1,9,8,15,0
121,Marko Arnautović,17,9,1,11,5,7,30,23.3,23,13,2,11,7,17,0
122,Maximilian Arnold,37,20,19,16,2,20,50,40.0,30,43,15,28,37,55,0
123,Kepa Arrizabalaga,0,0,0,0,0,0,0,,0,0,0,0,0,4,0
124,Tolgay Arslan,35,20,15,16,4,19,50,38.0,31,17,4,13,13,23,1
125,Santiago Arzamendia,14,6,6,5,3,6,13,46.2,7,6,0,6,4,7,0
126,Takuma Asano,11,6,3,6,2,5,19,26.3,14,14,1,13,7,7,0
127,Santiago Ascacíbar,93,54,50,37,6,38,89,42.7,51,31,6,25,41,42,0
128,Sergio Asenjo,0,0,0,0,0,0,1,0.0,1,0,0,0,1,6,0
129,Alejandro Asensio,0,0,0,0,0,0,0,,0,0,0,0,0,0,0
130,Marco Asensio,12,8,6,4,2,4,18,22.2,14,8,1,7,12,6,1
131,Harrison Ashby,0,0,0,0,0,0,0,,0,1,0,1,1,1,0
132,Kristoffer Askildsen,18,6,7,11,0,9,19,47.4,10,14,7,7,15,15,0
133,Fisnik Asllani,0,0,0,0,0,0,1,0.0,1,0,0,0,0,0,0
134,Kristjan Asllani,18,9,9,8,1,11,29,37.9,18,16,7,9,19,15,1
135,Iago Aspas,14,7,1,5,8,4,24,16.7,20,23,2,21,11,19,0
136,Lorenz Assignon,15,10,11,3,1,5,9,55.6,4,3,1,2,11,19,0
137,Simon Asta,13,6,4,5,4,4,8,50.0,4,14,2,12,8,16,0
138,Youcef Atal,29,19,17,10,2,14,25,56.0,11,13,2,11,32,21,0
139,Pierre-Emerick Aubameyang,11,5,6,4,1,3,10,30.0,7,12,1,11,0,4,0
140,Pierre-Emerick Aubameyang,2,2,0,1,1,0,5,0.0,5,9,1,8,2,4,0
141,Emil Audero,3,1,3,0,0,3,5,60.0,2,0,0,0,2,17,2
142,Tommaso Augello,36,20,22,8,6,17,29,58.6,12,19,4,15,29,68,1
143,Jean-Kévin Augustin,1,0,0,0,1,0,3,0.0,3,1,0,1,0,0,0
144,Ludwig Augustinsson,18,14,11,3,4,8,13,61.5,5,10,3,7,5,21,0
145,Serge Aurier,14,9,11,2,1,4,7,57.1,3,14,7,7,11,25,0
146,Ezequiel Ávila,17,7,6,7,4,7,21,33.3,14,14,2,12,13,15,1
147,Taiwo Awoniyi,11,7,3,6,2,1,9,11.1,8,11,2,9,2,29,0
148,Ramzi Aya,1,1,1,0,0,1,1,100.0,0,0,0,0,0,4,0
149,Jordan Ayew,47,30,20,20,7,17,31,54.8,14,33,3,30,15,15,0
150,Kaan Ayhan,20,12,14,6,0,7,15,46.7,8,20,14,6,13,57,0
151,Luke Ayling,74,42,46,23,5,51,97,52.6,46,46,25,21,28,52,1
152,Karim Azamoum,6,5,4,2,0,3,5,60.0,2,4,2,2,1,10,0
153,Sardar Azmoun,3,1,0,2,1,0,5,0.0,5,2,0,2,0,8,0
154,César Azpilicueta,51,28,18,27,6,16,35,45.7,19,32,9,23,23,65,1
155,Iddrisu Baba,57,30,31,23,3,25,43,58.1,18,19,5,14,24,34,1
156,Carlos Bacca,4,4,2,0,2,0,3,0.0,3,5,0,5,1,5,0
157,Daniel Bachmann,0,0,0,0,0,0,0,,0,0,0,0,1,5,0
158,Loïc Bade,6,5,4,2,0,3,5,60.0,2,12,10,2,12,48,0
159,Milan Badelj,64,37,25,30,9,34,80,42.5,46,39,7,32,85,43,0
160,Édgar Badía,0,0,0,0,0,0,0,,0,0,0,0,0,16,2
161,Benoît Badiashile,36,19,21,15,0,14,23,60.9,9,18,12,6,28,68,1
162,Youssouph Badji,1,0,0,1,0,0,1,0.0,1,0,0,0,0,0,0
163,Miguel Baeza,0,0,0,0,0,0,0,,0,0,0,0,0,0,0
164,Nicola Bagnolini,0,0,0,0,0,0,0,,0,0,0,0,0,0,0
165,Issa Bah,0,0,0,0,0,0,0,,0,0,0,0,0,0,0
166,Stéphane Bahoken,13,8,2,7,4,1,9,11.1,8,15,0,15,3,3,0
167,Leon Bailey,17,11,6,8,3,6,13,46.2,7,10,1,9,1,2,0
168,Eric Bailly,5,4,4,0,1,3,4,75.0,1,4,2,2,3,11,0
169,Dénys Bain,3,3,1,2,0,1,1,100.0,0,3,1,2,3,5,0
170,Stefan Bajic,0,0,0,0,0,0,0,,0,0,0,0,0,4,0
171,Nedim Bajrami,21,14,5,13,3,4,14,28.6,10,11,0,11,3,8,0
172,Cédric Bakambu,2,0,1,0,1,0,3,0.0,3,2,0,2,0,1,0
173,Abdoulaye Bakayoko,15,9,13,2,0,8,12,66.7,4,5,4,1,12,15,0
174,Tiemoué Bakayoko,19,13,9,7,3,5,16,31.3,11,8,1,7,9,10,2
175,Mitchel Bakker,33,22,16,12,5,20,34,58.8,14,13,2,11,23,42,3
176,Ridle Baku,62,37,30,24,8,25,65,38.5,40,43,1,42,21,52,1
177,Dilane Bakwa,1,1,0,1,0,1,2,50.0,1,0,0,0,0,1,0
178,Tommaso Baldanzi,0,0,0,0,0,0,0,,0,1,0,1,0,0,0
179,Alejandro Balde,2,1,1,0,1,0,0,,0,2,2,0,1,1,0
180,Ibrahima Baldé,0,0,0,0,0,0,0,,0,0,0,0,0,0,0
181,Keita Baldé,8,4,1,5,2,1,10,10.0,9,6,0,6,4,6,0
182,Gareth Bale,2,1,1,0,1,1,4,25.0,3,2,0,2,2,1,0
183,Mikel Balenziaga,33,24,15,15,3,25,43,58.1,18,27,4,23,21,79,0
184,Leonardo Balerdi,9,6,9,0,0,5,14,35.7,9,11,4,7,19,30,0
185,Iván Balliu,45,22,25,11,9,19,31,61.3,12,24,5,19,39,64,0
186,Fodé Ballo-Touré,18,14,5,13,0,4,9,44.4,5,6,2,4,3,5,0
187,Folarin Balogun,1,1,0,0,1,0,0,,0,1,0,1,0,1,0
188,Abdoulaye Bamba,6,5,6,0,0,4,11,36.4,7,5,1,4,9,13,0
189,Jonathan Bamba,30,12,13,9,8,13,36,36.1,23,24,1,23,21,10,0
190,Patrick Bamford,1,0,0,1,0,0,3,0.0,3,8,2,6,2,8,0
191,Filippo Bandinelli,33,20,10,17,6,15,31,48.4,16,22,5,17,10,37,2
192,Mattia Bani,23,13,17,6,0,14,18,77.8,4,19,11,8,20,76,0
193,Simon Banza,2,1,0,0,2,0,2,0.0,2,1,0,1,1,2,0
194,Shandon Baptiste,14,4,9,4,1,6,15,40.0,9,10,0,10,11,12,0
195,Antonín Barák,18,8,9,8,1,5,17,29.4,12,32,5,27,6,26,0
196,Barbero,0,0,0,0,0,0,0,,0,0,0,0,0,1,0
197,Danilo Barbosa,0,0,0,0,0,0,0,,0,1,1,0,2,10,0
198,Barcia,0,0,0,0,0,0,0,,0,1,1,0,1,0,1
199,Bradley Barcola,7,4,2,3,2,1,8,12.5,7,7,1,6,2,1,0
200,Melvin Bard,59,37,38,17,4,41,63,65.1,22,33,10,23,51,56,0
201,Enis Bardhi,29,12,12,14,3,12,35,34.3,23,13,2,11,10,7,0
202,Francesco Bardi,0,0,0,0,0,0,0,,0,0,0,0,0,0,0
203,Keidi Bare,27,17,14,12,1,11,31,35.5,20,20,10,10,15,26,1
204,Nicolò Barella,63,42,17,35,11,29,55,52.7,26,26,2,24,21,8,2
205,Kike Barja,15,11,4,7,4,8,22,36.4,14,10,1,9,9,4,0
206,Ross Barkley,0,0,0,0,0,0,1,0.0,1,1,0,1,1,0,0
207,Aymen Barkok,6,2,2,3,1,2,7,28.6,5,4,1,3,5,6,0
208,Ashley Barnes,11,2,2,7,2,2,9,22.2,7,8,1,7,2,5,0
209,Harvey Barnes,31,16,9,11,11,7,23,30.4,16,24,1,23,5,7,0
210,Antonio Barragán,21,14,13,7,1,11,17,64.7,6,5,3,2,17,34,0
211,Leandro Barreiro Martins,63,32,23,27,13,29,50,58.0,21,23,6,17,32,23,0
212,Ander Barrenetxea,15,10,9,6,0,8,18,44.4,10,7,0,7,2,2,0
213,Jacob Barrett Laursen,16,12,10,6,0,8,21,38.1,13,19,7,12,28,43,0
214,Musa Barrow,12,4,4,4,4,6,20,30.0,14,20,1,19,6,8,0
215,Abdourahmane Barry,6,4,3,3,0,5,7,71.4,2,5,2,3,4,1,0
216,Marc Bartra,39,14,18,17,4,19,35,54.3,16,39,22,17,33,105,1
217,Daniele Baselli,3,3,2,0,1,2,6,33.3,4,0,0,0,1,2,0
218,Daniele Baselli,6,5,3,1,2,1,5,20.0,4,2,0,2,2,5,0
219,Toma Bašić,12,8,3,9,0,5,17,29.4,12,13,4,9,4,21,0
220,Toma Bašić,2,2,1,0,1,0,4,0.0,4,4,1,3,2,0,0
221,Amine Bassi,6,3,2,3,1,1,3,33.3,2,5,0,5,0,0,0
222,Álvaro Bastida,7,4,2,4,1,4,5,80.0,1,1,0,1,3,1,0
223,Alessandro Bastoni,44,25,28,13,3,17,34,50.0,17,22,12,10,35,59,1
224,Simone Bastoni,52,34,28,17,7,21,65,32.3,44,38,11,27,30,31,0
225,Lewis Bate,1,0,0,0,1,0,8,0.0,8,1,0,1,1,1,0
226,Rodrigo Battaglia,32,16,13,19,0,15,30,50.0,15,21,10,11,10,36,0
227,Maximilian Bauer,28,15,17,10,1,11,28,39.3,17,24,14,10,29,99,0
228,Oliver Baumann,0,0,0,0,0,0,3,0.0,3,0,0,0,0,19,1
229,Timo Baumgartl,59,28,34,21,4,31,47,66.0,16,27,11,16,37,58,0
230,Julian Baumgartlinger,3,1,2,1,0,1,2,50.0,1,1,0,1,2,0,0
231,Christoph Baumgartner,28,15,14,7,7,13,32,40.6,19,24,3,21,8,16,0
232,Jon Bautista,3,0,0,3,0,0,1,0.0,1,1,0,1,1,1,0
233,Paul Baysse,1,1,0,1,0,0,0,,0,0,0,0,0,1,0
234,Noah Joel Sarenren Bazee,5,2,2,2,1,3,4,75.0,1,8,2,6,1,4,0
235,Bebé,6,5,1,3,2,4,16,25.0,12,18,0,18,3,6,0
236,Ihlas Bebou,22,14,5,12,5,7,21,33.3,14,20,3,17,12,25,0
237,Rodrigo Becão,81,46,49,30,2,34,60,56.7,26,45,20,25,42,89,3
238,Mads Bech Sørensen,8,7,6,2,0,6,7,85.7,1,9,6,3,6,25,0
239,Sheraldo Becker,9,6,3,4,2,6,18,33.3,12,11,0,11,2,4,0
240,Jan Bednarek,32,15,18,13,1,19,33,57.6,14,48,27,21,72,141,0
241,Donny van de Beek,6,4,4,1,1,1,2,50.0,1,5,1,4,2,1,0
242,Donny van de Beek,15,7,8,6,1,6,13,46.2,7,6,2,4,6,4,0
243,Asmir Begović,0,0,0,0,0,0,0,,0,0,0,0,0,3,0
244,Valon Behrami,3,1,0,2,1,0,7,0.0,7,4,1,3,1,4,0
245,Kevin Behrens,3,2,1,1,1,0,4,0.0,4,3,0,3,3,7,0
246,Youcef Belaïli,2,1,0,0,2,2,9,22.2,7,5,1,4,7,4,0
247,Vid Belec,0,0,0,0,0,0,0,,0,0,0,0,0,9,1
248,Ishak Belfodil,9,6,4,4,1,4,8,50.0,4,9,1,8,5,16,0
249,Haris Belkebla,46,23,21,21,4,18,39,46.2,21,26,6,20,48,30,1
250,Stefan Bell,54,23,37,16,1,30,63,47.6,33,26,15,11,41,112,1
251,Armel Bella Kotchap,34,20,25,9,0,18,28,64.3,10,21,16,5,42,84,2
252,Raoul Bellanova,29,15,14,12,3,6,27,22.2,21,39,8,31,21,51,0
253,Karim Bellarabi,9,4,4,4,1,3,13,23.1,10,5,0,5,9,4,0
254,Jean-Ricner Bellegarde,51,32,21,21,9,17,41,41.5,24,29,4,25,27,19,0
255,Héctor Bellerín,52,32,29,20,3,31,44,70.5,13,11,2,9,23,57,1
256,Jude Bellingham,52,34,15,31,6,21,53,39.6,32,50,4,46,42,32,0
257,George Bello,7,7,7,0,0,4,4,100.0,0,5,4,1,6,11,0
258,Jeanuël Belocian,0,0,0,0,0,0,0,,0,0,0,0,0,0,0
259,Andrea Belotti,7,3,2,2,3,3,12,25.0,9,12,4,8,2,9,0
260,Fran Beltrán,56,41,27,23,6,28,68,41.2,40,29,5,24,32,39,0
261,Hatem Ben Arfa,4,2,2,1,1,2,4,50.0,2,3,0,3,0,1,0
262,Salim Ben Seghir,0,0,0,0,0,0,0,,0,0,0,0,0,0,0
263,Wissam Ben Yedder,18,8,1,11,6,6,15,40.0,9,12,1,11,0,1,0
264,Marco Benassi,1,0,1,0,0,1,2,50.0,1,3,0,3,3,3,0
265,Marco Benassi,6,3,3,2,1,1,10,10.0,9,4,0,4,3,6,0
266,Darío Benedetto,5,1,2,2,1,3,6,50.0,3,4,0,4,1,1,0
267,Darío Benedetto,0,0,0,0,0,0,0,,0,2,0,2,0,0,0
268,László Bénes,5,3,1,3,1,1,6,16.7,5,5,2,3,2,5,0
269,Walter Benítez,0,0,0,0,0,0,2,0.0,2,1,0,1,0,12,2
270,Iker Benito,2,1,1,0,1,0,1,0.0,1,2,0,2,0,2,0
271,Loris Benito,0,0,0,0,0,0,0,,0,0,0,0,1,3,1
272,Pedro Benito,0,0,0,0,0,0,1,0.0,1,0,0,0,0,0,0
273,Filip Benković,0,0,0,0,0,0,0,,0,0,0,0,0,0,0
274,Ismaël Bennacer,44,30,22,15,7,21,50,42.0,29,20,4,16,25,15,0
275,Keanan Bennetts,2,0,1,1,0,1,1,100.0,0,1,0,1,0,0,0
276,Saïd Benrahma,28,17,16,9,3,15,38,39.5,23,17,1,16,9,8,0
277,Ramy Bensebaini,42,30,24,15,3,27,44,61.4,17,33,7,26,39,77,1
278,Nabil Bentaleb,42,24,15,20,7,16,29,55.2,13,24,9,15,28,13,0
279,Rodrigo Bentancur,36,18,14,14,8,16,32,50.0,16,24,9,15,20,35,0
280,Rodrigo Bentancur,32,18,11,18,3,7,20,35.0,13,15,2,13,26,15,1
281,Christian Benteke,3,2,1,2,0,2,6,33.3,4,7,3,4,2,33,0
282,Karim Benzema,11,9,5,3,3,2,9,22.2,7,10,0,10,4,13,0
283,Alessandro Berardi,0,0,0,0,0,0,0,,0,0,0,0,0,0,0
284,Domenico Berardi,32,19,9,16,7,15,57,26.3,42,39,2,37,31,23,0
285,Yuri Berchiche,25,11,10,11,4,7,14,50.0,7,19,6,13,13,25,0
286,Álex Berenguer,45,26,23,14,8,11,51,21.6,40,40,2,38,16,20,0
287,Bartosz Bereszyński,64,38,34,25,5,37,80,46.3,43,38,12,26,42,73,1
288,Jóhann Berg Guðmundsson,16,6,7,7,2,5,20,25.0,15,11,2,9,12,22,0
289,Patrick Berg,14,6,6,8,0,0,4,0.0,4,2,1,1,4,3,0
290,Mitchell van Bergen,8,5,7,0,1,6,15,40.0,9,9,0,9,4,7,0
291,Steven Bergwijn,3,2,2,1,0,1,10,10.0,9,3,0,3,1,8,0
292,Etrit Berisha,0,0,0,0,0,0,0,,0,0,0,0,0,4,0
293,Valon Berisha,10,7,2,5,3,2,10,20.0,8,9,0,9,4,3,0
294,Federico Bernardeschi,16,10,7,4,5,6,13,46.2,7,12,4,8,5,15,0
295,Paul Bernardoni,3,2,3,0,0,3,4,75.0,1,0,0,0,0,8,1
296,Paul Bernardoni,0,0,0,0,0,0,0,,0,0,0,0,0,14,2
297,Juan Bernat,24,14,10,10,4,13,18,72.2,5,8,0,8,8,16,0
298,Dimitry Bertaud,0,0,0,0,0,0,1,0.0,1,0,0,0,0,5,1
299,Jason Berthomier,29,14,5,17,7,12,34,35.3,22,14,2,12,8,4,1
300,Nicolò Bertola,3,2,3,0,0,3,4,75.0,1,0,0,0,3,1,0
301,Ryan Bertrand,8,5,3,4,1,2,5,40.0,3,8,3,5,1,7,0
302,Daniel Bessa,7,2,3,3,1,4,15,26.7,11,13,3,10,5,11,0
303,Beto,21,6,2,14,5,9,19,47.4,10,16,1,15,5,25,1
304,Jordan Beyer,46,27,32,13,1,23,39,59.0,16,18,5,13,15,52,2
305,Giulian Biancone,70,42,44,22,4,40,69,58.0,29,23,8,15,53,71,1
306,Bartosz Białek,0,0,0,0,0,0,1,0.0,1,1,0,1,0,2,0
307,Ermin Bičakčić,0,0,0,0,0,0,0,,0,0,0,0,0,0,0
308,Mads Bidstrup,1,0,0,1,0,0,3,0.0,3,0,0,0,1,2,0
309,Pedro Bigas,24,10,16,8,0,9,20,45.0,11,21,16,5,18,77,1
310,El Bilal Touré,13,6,4,6,3,2,7,28.6,5,10,3,7,6,19,0
311,Jean-Claude Billong,17,8,14,1,2,8,11,72.7,3,9,1,8,10,35,0
312,Luis Binks,8,4,7,1,0,4,6,66.7,2,6,5,1,17,33,1
313,Cristiano Biraghi,37,24,17,15,5,22,53,41.5,31,28,10,18,19,31,1
314,Davide Biraschi,31,16,19,9,3,17,24,70.8,7,16,9,7,16,26,0
315,Tom Bischof,0,0,0,0,0,0,0,,0,1,0,1,0,1,0
316,Yves Bissouma,76,49,35,37,4,21,37,56.8,16,33,3,30,50,49,0
317,Nathan Bitu Mazala,0,0,0,0,0,0,0,,0,1,0,1,0,0,0
318,Marco Bizot,3,1,3,0,0,3,5,60.0,2,1,0,1,0,24,1
319,Bjarki Bjarkason,0,0,0,0,0,0,0,,0,0,0,0,0,0,0
320,Antonio Blanco,2,0,1,1,0,0,0,,0,1,1,0,1,0,0
321,Ludovic Blas,33,18,7,20,6,15,44,34.1,29,33,3,30,31,6,1
322,Danny Blum,2,1,0,0,2,0,2,0.0,2,4,0,4,2,1,0
323,Myron Boadu,9,7,2,3,4,1,5,20.0,4,6,0,6,2,1,0
324,Jérôme Boateng,20,15,11,9,0,9,17,52.9,8,20,10,10,20,73,0
325,Kevin-Prince Boateng,6,5,1,4,1,3,9,33.3,6,7,2,5,6,11,0
326,Antonin Bobichon,1,0,0,1,0,0,0,,0,0,0,0,1,0,0
327,Herbert Bockhorn,20,14,13,4,3,12,20,60.0,8,10,1,9,14,18,0
328,Jean-Paul Boëtius,40,23,18,17,5,22,53,41.5,31,41,3,38,25,11,0
329,Jeremie Boga,7,3,0,4,3,4,6,66.7,2,6,0,6,1,3,1
330,Jeremie Boga,7,4,1,2,4,2,3,66.7,1,3,0,3,2,1,1
331,Luka Bogdan,6,3,6,0,0,4,8,50.0,4,3,2,1,6,21,0
332,Emil Bohinen,15,9,4,9,2,10,20,50.0,10,17,3,14,12,14,0
333,Quentin Boisgard,19,11,6,10,3,8,17,47.1,9,15,0,15,6,5,0
334,Charles Boli,2,1,0,2,0,0,0,,0,0,0,0,0,0,0
335,Willy Boly,25,19,18,7,0,8,15,53.3,7,14,6,8,14,35,0
336,Giacomo Bonaventura,33,17,12,16,5,21,46,45.7,25,20,2,18,14,9,1
337,Federico Bonazzoli,24,12,9,8,7,6,25,24.0,19,17,1,16,6,7,0
338,Tarsis Bonga,0,0,0,0,0,0,0,,0,0,0,0,0,0,0
339,Kevin Bonifazi,25,16,16,7,2,13,14,92.9,1,22,7,15,16,35,0
340,Solomon Bonnah,0,0,0,0,0,0,0,,0,1,0,1,1,0,0
341,Leonardo Bonucci,14,5,4,10,0,8,13,61.5,5,22,17,5,26,82,0
342,Sebastiaan Bornauw,30,19,23,5,2,16,25,64.0,9,29,8,21,42,97,1
343,Rafael Borré,31,22,4,13,14,7,33,21.2,26,24,4,20,5,9,0
344,Sven Botman,24,11,13,11,0,12,18,66.7,6,32,21,11,26,116,0
345,Denis Bouanga,46,25,14,13,19,22,63,34.9,41,30,0,30,8,34,1
346,Hicham Boudaoui,31,18,15,10,6,13,36,36.1,23,17,4,13,18,15,0
347,Ryad Boudebouz,27,15,11,12,4,12,29,41.4,17,17,2,15,10,5,0
348,Sofiane Boufal,44,29,19,16,9,18,38,47.4,20,19,2,17,7,1,0
349,Farid Boulaya,18,10,7,9,2,14,38,36.8,24,8,2,6,12,5,0
350,Yassine Bounou,0,0,0,0,0,0,0,,0,0,0,0,0,11,1
351,Ismaëlben Boura,2,2,1,1,0,0,0,,0,1,1,0,2,5,0
352,Mehdi Bourabia,5,1,2,3,0,3,11,27.3,8,7,6,1,3,10,0
353,Benjamin Bourigeaud,46,24,16,18,12,24,67,35.8,43,33,3,30,30,44,0
354,Redwan Bourles,0,0,0,0,0,0,0,,0,0,0,0,0,0,0
355,Edoardo Bove,1,1,1,0,0,0,2,0.0,2,1,0,1,1,0,0
356,Jarrod Bowen,36,20,20,11,5,17,44,38.6,27,29,2,27,21,14,0
357,Dedryck Boyata,15,13,11,3,1,8,11,72.7,3,17,13,4,17,134,1
358,Lucas Boyé,27,13,5,15,7,9,24,37.5,15,24,1,23,2,23,0
359,Domagoj Bradarić,11,9,8,2,1,7,12,58.3,5,5,2,3,10,7,1
360,Bilal Brahimi,1,1,0,1,0,0,2,0.0,2,1,0,1,2,1,0
361,Bilal Brahimi,1,1,0,1,0,0,3,0.0,3,0,0,0,1,1,0
362,Martin Braithwaite,1,1,0,0,1,0,0,,0,2,0,2,1,1,0
363,Julian Brandt,37,19,13,20,4,17,54,31.5,37,19,2,17,24,14,1
364,Jarrad Branthwaite,4,1,3,1,0,3,8,37.5,5,3,2,1,1,20,0
365,Darko Brašanac,35,22,19,14,2,14,40,35.0,26,25,8,17,25,15,0
366,Lilian Brassier,40,24,23,13,4,10,21,47.6,11,31,21,10,32,86,0
367,Claudio Bravo,0,0,0,0,0,0,0,,0,0,0,0,0,6,2
368,Iker Bravo,1,1,0,1,0,0,0,,0,0,0,0,0,0,0
369,Fabian Bredlow,0,0,0,0,0,0,0,,0,0,0,0,0,1,0
370,Josip Brekalo,9,5,5,1,3,3,21,14.3,18,16,1,15,4,7,1
371,Josip Brekalo,0,0,0,0,0,0,0,,0,0,0,0,0,0,0
372,Gleison Bremer,49,24,27,22,0,18,28,64.3,10,54,23,31,105,137,0
373,Jimmy Briand,2,0,2,0,0,0,2,0.0,2,0,0,0,1,2,0
374,Yan Brice Eteki,6,3,3,2,1,3,7,42.9,4,7,3,4,4,6,1
375,Brian Brobbey,1,0,0,1,0,1,1,100.0,0,1,0,1,0,0,0
376,Armando Broja,12,5,2,7,3,2,9,22.2,7,17,1,16,3,11,0
377,Dylan Bronn,47,29,33,13,1,20,31,64.5,11,32,19,13,40,78,1
378,John Brooks,47,25,25,18,4,36,60,60.0,24,33,19,14,41,125,1
379,Daniel Brosinski,2,1,1,1,0,1,1,100.0,0,6,0,6,3,9,0
380,Josh Brownhill,73,37,25,42,6,21,53,39.6,32,37,12,25,68,42,1
381,Marcelo Brozović,77,45,34,35,8,34,68,50.0,34,28,10,18,37,36,2
382,Cédric Brunner,51,35,29,20,2,25,49,51.0,24,27,10,17,43,84,0
383,Lewis Brunt,0,0,0,0,0,0,0,,0,1,0,1,0,0,0
384,Jacob Bruun Larsen,2,1,1,1,0,0,5,0.0,5,14,3,11,5,5,2
385,Ante Budimir,24,10,3,15,6,6,19,31.6,13,22,4,18,3,16,0
386,Emi Buendía,38,18,16,13,9,21,51,41.2,30,21,3,18,9,11,0
387,Osman Bukari,18,8,7,6,5,8,22,36.4,14,8,0,8,8,1,0
388,Aleksander Buksa,0,0,0,0,0,0,1,0.0,1,0,0,0,0,1,0
389,Alessandro Buongiorno,20,9,9,8,3,9,13,69.2,4,12,6,6,31,44,0
390,Sascha Burchert,1,1,1,0,0,1,2,50.0,1,0,0,0,0,11,1
391,Delano Burgzorg,1,1,1,0,0,0,1,0.0,1,0,0,0,0,0,0
392,Jonathan Burkardt,17,8,0,10,7,6,25,24.0,19,31,5,26,8,16,0
393,Roman Bürki,0,0,0,0,0,0,0,,0,0,0,0,0,0,0
394,Dan Burn,16,11,11,4,1,7,11,63.6,4,22,14,8,20,101,0
395,Dan Burn,22,12,13,8,1,6,15,40.0,9,14,10,4,24,51,0
396,Maxime Busi,26,15,20,5,1,19,36,52.8,17,19,5,14,17,28,0
397,Gianluca Busio,53,28,27,20,6,28,63,44.4,35,45,13,32,21,30,1
398,Oriol Busquets,3,3,0,3,0,2,6,33.3,4,7,4,3,1,2,0
399,Sergio Busquets,93,49,31,48,14,46,83,55.4,37,44,8,36,45,31,0
400,Jack Butland,0,0,0,0,0,0,0,,0,0,0,0,0,1,0
401,Adrián Butzke,0,0,0,0,0,0,0,,0,0,0,0,0,0,0
402,Marcin Bułka,0,0,0,0,0,0,0,,0,0,0,0,0,0,0
403,Jamie Bynoe-Gittens,3,2,0,2,1,2,5,40.0,3,4,1,3,1,1,0
404,Sam Byram,24,15,17,6,1,19,27,70.4,8,21,11,10,22,48,0
405,Erick Cabaco,2,1,1,1,0,2,5,40.0,3,5,2,3,4,10,0
406,Willy Caballero,0,0,0,0,0,0,0,,0,0,0,0,0,2,1
407,Rémy Cabella,15,7,4,8,3,5,15,33.3,10,7,0,7,5,1,0
408,Jimmy Cabot,81,44,59,15,7,47,83,56.6,36,29,0,29,32,30,0
409,Arthur Cabral,9,5,2,5,2,4,7,57.1,3,4,1,3,1,8,0
410,Jovane Cabral,2,1,1,0,1,0,0,,0,1,1,0,1,1,0
411,Leandro Cabrera,37,24,27,10,0,21,34,61.8,13,32,23,9,44,222,2
412,Liberato Cacace,15,6,8,4,3,8,8,100.0,0,7,2,5,8,9,0
413,Martín Cáceres,13,7,5,5,3,4,12,33.3,8,12,3,9,14,21,0
414,Martín Cáceres,2,2,2,0,0,1,5,20.0,4,2,2,0,11,16,1
415,Anthony Caci,65,34,35,24,6,33,55,60.0,22,22,3,19,33,49,1
416,Mathieu Cafaro,4,2,3,1,0,0,7,0.0,7,2,0,2,3,1,0
417,Yannick Cahuzac,5,2,2,3,0,0,5,0.0,5,8,2,6,9,12,0
418,Felipe Caicedo,3,3,0,2,1,0,1,0.0,1,1,0,1,0,4,0
419,Felipe Caicedo,0,0,0,0,0,0,0,,0,1,0,1,0,0,0
420,Moisés Caicedo,16,10,7,7,2,5,12,41.7,7,18,4,14,10,7,0
421,Marc-Aurèle Caillard,0,0,0,0,0,0,2,0.0,2,0,0,0,2,9,1
422,Jens Cajuste,10,6,6,2,2,6,17,35.3,11,7,2,5,5,6,0
423,Cala,9,4,9,0,0,8,17,47.1,9,12,6,6,12,56,0
424,Davide Calabria,62,37,31,23,8,37,72,51.4,35,25,5,20,23,40,1
425,Riccardo Calafiori,1,0,0,0,1,1,2,50.0,1,2,1,1,2,4,0
426,Riccardo Calafiori,5,4,2,2,1,1,5,20.0,4,3,0,3,3,1,0
427,Mattia Caldara,48,28,30,15,3,20,34,58.8,14,49,37,12,62,147,1
428,Calderón,2,0,1,0,1,1,3,33.3,2,0,0,0,0,2,0
429,Fernando Calero,17,10,12,5,0,8,13,61.5,5,7,2,5,16,63,1
430,Duje Ćaleta-Car,21,8,15,6,0,11,14,78.6,3,11,7,4,24,55,2
431,Hakan Çalhanoğlu,41,23,16,19,6,11,40,27.5,29,29,5,24,25,12,0
432,Daniel Caligiuri,46,30,17,26,3,27,72,37.5,45,36,5,31,18,33,0
433,José Callejón,15,6,6,6,3,13,31,41.9,18,6,0,6,3,1,1
434,Lucas Calodat,0,0,0,0,0,0,0,,0,0,0,0,0,0,0
435,Dominic Calvert-Lewin,11,8,1,6,4,3,8,37.5,5,5,2,3,3,12,0
436,Mahdi Camara,101,57,39,50,12,39,70,55.7,31,44,8,36,57,35,1
437,Mamadou Camara,1,1,1,0,0,0,0,,0,0,0,0,0,0,0
438,Víctor Camarasa,2,1,1,1,0,0,1,0.0,1,2,1,1,2,2,0
439,Eduardo Camavinga,52,35,22,20,10,20,38,52.6,18,20,2,18,17,14,1
440,Eduardo Camavinga,4,1,2,1,1,2,5,40.0,3,1,1,0,1,3,0
441,Andrea Cambiaso,46,20,28,14,4,18,32,56.3,14,33,8,25,23,37,1
442,José Campaña,27,16,13,10,4,12,32,37.5,20,13,2,11,21,19,1
443,Chem Campbell,1,1,0,1,0,0,0,,0,0,0,0,0,0,0
444,Emre Can,36,22,20,16,0,15,30,50.0,15,26,10,16,36,40,2
445,Sergio Canales,24,14,8,12,4,10,35,28.6,25,16,1,15,10,12,0
446,Matteo Cancellieri,4,4,2,2,0,0,5,0.0,5,2,0,2,1,0,0
447,João Cancelo,83,54,33,35,15,46,91,50.5,45,25,3,22,59,45,1
448,Fali Candé,30,18,13,15,2,13,31,41.9,18,11,2,9,6,21,0
449,Antonio Candreva,27,16,9,11,7,19,55,34.5,36,23,2,21,33,19,0
450,Sergi Canós,56,25,32,15,9,33,60,55.0,27,32,3,29,22,38,0
451,Álex Cantero,6,4,2,3,1,1,8,12.5,7,2,0,2,1,0,0
452,Todd Cantwell,15,13,8,6,1,6,17,35.3,11,2,0,2,3,2,0
453,Ander Capa,0,0,0,0,0,0,0,,0,0,0,0,0,0,0
454,Pierrick Capelle,36,24,16,17,3,18,52,34.6,34,12,1,11,16,20,0
455,Leonardo Capezzi,3,1,0,3,0,1,4,25.0,3,8,4,4,0,2,0
456,Étienne Capoue,44,26,18,23,3,15,28,53.6,13,17,5,12,35,51,0
457,Gianluca Caprari,43,25,10,22,11,17,51,33.3,34,32,0,32,4,7,0
458,Francesco Caputo,5,2,1,3,1,1,6,16.7,5,5,0,5,2,10,0
459,Francesco Caputo,0,0,0,0,0,0,0,,0,0,0,0,0,0,0
460,Maxence Caqueret,73,40,29,36,8,30,80,37.5,50,38,10,28,43,26,2
461,Andrea Carboni,53,24,33,16,4,19,42,45.2,23,42,15,27,27,87,0
462,Isaac Carcelen,43,29,29,12,2,28,56,50.0,28,25,6,19,34,42,0
463,Cárdenas,1,1,1,0,0,0,3,0.0,3,0,0,0,1,19,0
464,Irvin Cardona,13,7,5,4,4,3,16,18.8,13,10,0,10,5,17,0
465,Igor Carioca,27,16,16,8,3,15,43,34.9,28,17,2,15,25,28,0
466,Carlo,0,0,0,0,0,0,0,,0,0,0,0,0,0,0
467,Diego Carlos,35,24,20,13,2,16,24,66.7,8,48,33,15,24,120,5
468,Carmona,0,0,0,0,0,0,0,,0,0,0,0,1,0,0
469,Yannick Carrasco,34,19,16,12,6,19,44,43.2,25,26,5,21,19,12,2
470,Guido Carrillo,7,4,2,4,1,3,13,23.1,10,9,2,7,1,27,0
471,Dani Carvajal,43,28,21,15,7,15,26,57.7,11,22,8,14,20,38,2
472,William Carvalho,49,33,20,25,4,15,40,37.5,25,18,7,11,16,20,0
473,Nicolò Casale,46,30,25,19,2,21,37,56.8,16,31,12,19,49,95,0
474,Casemiro,79,51,45,30,4,30,67,44.8,37,65,19,46,38,65,3
475,Matty Cash,89,50,52,34,3,47,78,60.3,31,54,16,38,49,100,2
476,Kiko Casilla,0,0,0,0,0,0,1,0.0,1,0,0,0,1,2,2
477,Moreto Cassamã,12,6,7,4,1,3,19,15.8,16,10,5,5,9,5,0
478,Francesco Cassata,0,0,0,0,0,0,0,,0,0,0,0,0,0,0
479,Timothy Castagne,67,31,38,22,7,27,43,62.8,16,28,9,19,29,54,1
480,Koen Casteels,0,0,0,0,0,0,1,0.0,1,0,0,0,0,9,2
481,Jean-Charles Castelletto,45,24,27,17,1,25,35,71.4,10,38,27,11,30,73,0
482,Samu Castillejo,4,2,0,2,2,1,8,12.5,7,4,1,3,2,1,0
483,Gonzalo Castro,8,3,4,4,0,1,5,20.0,4,3,0,3,3,3,0
484,Jonny Castro,25,15,13,11,1,11,20,55.0,9,14,3,11,13,11,0
485,Gaetano Castrovilli,25,17,15,6,4,12,23,52.2,11,18,4,14,11,6,0
486,Danilo Cataldi,36,17,15,17,4,12,38,31.6,26,24,12,12,17,19,1
487,Catena,39,23,24,15,0,25,42,59.5,17,26,19,7,30,168,3
488,Craig Cathcart,32,15,25,6,1,16,30,53.3,14,39,29,10,28,132,3
489,Edinson Cavani,4,1,0,3,1,2,8,25.0,6,6,0,6,2,8,0
490,Dani Ceballos,7,5,4,3,0,1,5,20.0,4,8,2,6,4,2,0
491,Pietro Ceccaroni,55,31,33,18,4,25,36,69.4,11,45,32,13,30,143,0
492,Federico Ceccherini,32,16,19,10,3,19,33,57.6,14,13,8,5,50,76,1
493,Emil Ceide,1,1,0,1,0,1,2,50.0,1,1,0,1,0,0,0
494,Zeki Çelik,64,37,43,17,4,36,63,57.1,27,32,9,23,43,62,2
495,Fabien Centonze,33,21,22,9,2,13,32,40.6,19,37,8,29,32,51,0
496,Luca Ceppitelli,23,12,13,10,0,16,27,59.3,11,21,14,7,25,54,0
497,Franco Cervi,73,41,35,22,16,33,77,42.9,44,38,2,36,21,19,0
498,Damir Ceter,0,0,0,0,0,0,0,,0,0,0,0,0,0,0
499,Julian Chabot,12,10,8,4,0,8,10,80.0,2,7,4,3,9,28,1
500,Julian Chabot,8,3,4,4,0,2,5,40.0,3,4,2,2,3,5,1
501,El Chadaille Bitshiabu,0,0,0,0,0,0,0,,0,0,0,0,0,2,0
502,Nassim Chadli,5,3,3,0,2,2,4,50.0,2,1,0,1,0,0,0
503,Kayky Chagas,0,0,0,0,0,0,0,,0,0,0,0,0,0,0
504,Mehdi Chahiri,1,1,1,0,0,1,1,100.0,0,0,0,0,0,0,0
505,Trevoh Chalobah,40,27,22,18,0,24,31,77.4,7,16,6,10,19,43,2
506,Calum Chambers,5,3,3,1,1,3,4,75.0,1,6,3,3,0,10,0
507,Calum Chambers,16,8,10,6,0,4,6,66.7,2,14,8,6,5,42,0
508,Dylan Chambost,16,11,6,9,1,4,25,16.0,21,9,2,7,8,4,0
509,Timothy Chandler,18,12,10,8,0,11,24,45.8,13,10,3,7,19,28,1
510,Chapela,4,2,1,0,3,2,4,50.0,2,6,1,5,4,5,0
511,Brendan Chardonnet,44,25,32,11,1,29,40,72.5,11,42,29,13,55,141,0
512,Xavier Chavalerin,49,26,19,25,5,12,55,21.8,43,32,5,27,39,36,0
513,Xavier Chavalerin,4,4,2,1,1,1,3,33.3,2,2,0,2,5,2,1
514,Justin Che,2,0,1,0,1,1,2,50.0,1,0,0,0,1,0,0
515,Chema,0,0,0,0,0,0,1,0.0,1,0,0,0,0,0,0
516,Rayan Cherki,6,2,1,3,2,4,9,44.4,5,2,0,2,1,0,0
517,Denis Cheryshev,14,5,6,1,7,6,15,40.0,9,9,1,8,9,9,0
518,Daniel Chesters,0,0,0,0,0,0,0,,0,0,0,0,0,0,0
519,Giorgio Chiellini,22,13,17,4,1,7,13,53.8,6,24,18,6,22,59,0
520,Federico Chiesa,26,19,9,9,8,12,26,46.2,14,7,0,7,4,3,0
521,Ben Chilwell,8,3,2,6,0,2,5,40.0,3,7,0,7,4,14,1
522,Chiquinho,9,6,4,5,0,4,5,80.0,1,5,0,5,2,1,0
523,Vlad Chiricheș,28,15,19,9,0,10,21,47.6,11,34,21,13,41,71,4
524,Pedro Chirivella,49,31,14,26,9,25,70,35.7,45,23,2,21,37,11,0
525,Joris Chotard,59,30,33,23,3,36,78,46.2,42,27,15,12,42,56,0
526,Hamza Choudhury,9,3,4,4,1,3,5,60.0,2,0,0,0,12,10,0
527,Andreas Christensen,14,8,9,4,1,4,7,57.1,3,14,6,8,29,57,1
528,Max Christiansen,46,25,19,22,5,18,43,41.9,25,52,16,36,68,56,0
529,Carney Chukwuemeka,7,1,2,5,0,3,5,60.0,2,3,0,3,1,2,1
530,Samuel Chukwueze,13,9,6,5,2,3,6,50.0,3,7,0,7,5,4,0
531,Víctor Chust,19,10,14,4,1,11,17,64.7,6,20,8,12,16,87,0
532,Riccardo Ciervo,8,3,4,3,1,2,6,33.3,4,1,0,1,2,2,0
533,Jasper Cillessen,0,0,0,0,0,0,1,0.0,1,0,0,0,1,6,0
534,Pathé Ciss,31,15,20,8,3,12,26,46.2,14,16,6,10,30,27,0
535,Moustapha Cissé,1,0,0,1,0,0,3,0.0,3,0,0,0,0,0,0
536,Giorgio Cittadini,0,0,0,0,0,0,0,,0,0,0,0,1,0,0
537,Ciaran Clark,13,10,4,7,2,9,14,64.3,5,14,11,3,13,43,1
538,Alexis Claude-Maurice,2,0,1,0,1,1,4,25.0,3,7,0,7,3,1,0
539,Jonathan Clauss,63,34,33,20,10,22,55,40.0,33,43,1,42,73,51,0
540,Carlos Clerc,35,17,21,10,4,7,19,36.8,12,8,3,5,26,32,1
541,Tom Cleverley,37,20,19,17,1,18,33,54.5,15,23,6,17,18,19,3
542,Nathaniel Clyne,21,10,11,9,1,10,20,50.0,10,7,2,5,15,32,0
543,Conor Coady,31,14,23,7,1,16,28,57.1,12,46,40,6,28,140,0
544,Marcus Coco,34,14,17,11,6,8,18,44.4,10,11,1,10,10,15,0
545,Coke,3,2,1,1,1,3,4,75.0,1,1,0,1,2,7,0
546,Séamus Coleman,61,36,35,16,10,33,51,64.7,18,30,11,19,32,80,2
547,Álex Collado,27,12,6,16,5,12,31,38.7,19,28,2,26,6,11,0
548,Ebrima Colley,6,1,3,2,1,1,7,14.3,6,8,0,8,3,2,0
549,Omar Colley,47,36,32,14,1,22,32,68.8,10,31,19,12,80,135,2
550,Nathan Collins,37,15,27,8,2,17,27,63.0,10,38,25,13,24,83,2
551,Kingsley Coman,14,8,1,9,4,5,16,31.3,11,14,0,14,8,5,0
552,Eray Cömert,5,3,4,1,0,3,6,50.0,3,3,2,1,2,6,0
553,Santi Comesaña,87,56,45,33,9,40,104,38.5,64,46,6,40,33,30,0
554,Diego Conde,0,0,0,0,0,0,0,,0,0,0,0,0,0,0
555,Aaron Connolly,0,0,0,0,0,0,1,0.0,1,2,0,2,0,0,0
556,Andrea Consigli,0,0,0,0,0,0,2,0.0,2,0,0,0,0,23,3
557,Abdu Conté,22,12,16,5,1,12,24,50.0,12,12,2,10,4,10,0
558,Andrea Conti,4,2,2,1,1,3,6,50.0,3,4,0,4,7,4,0
559,Andrea Conti,0,0,0,0,0,0,0,,0,0,0,0,0,0,0
560,Liam Cooper,41,23,27,13,1,23,33,69.7,10,29,18,11,43,72,2
561,Lucas Copado,1,0,1,0,0,1,1,100.0,0,0,0,0,0,0,0
562,Diego Coppola,8,4,4,4,0,3,3,100.0,0,5,1,4,4,5,0
563,Francis Coquelin,26,17,9,11,6,11,20,55.0,9,15,5,10,19,11,0
564,Sébastien Corchia,33,20,17,11,5,24,42,57.1,18,24,3,21,13,36,0
565,Sergio Córdova,4,3,2,2,0,1,2,50.0,1,4,0,4,0,4,0
566,Jack Cork,20,6,6,11,3,7,20,35.0,13,17,4,13,17,29,1
567,Maxwel Cornet,16,9,7,5,4,7,15,46.7,8,13,4,9,10,14,0
568,Maxwel Cornet,3,1,1,0,2,3,4,75.0,1,0,0,0,1,1,0
569,Jesús Corona,12,7,7,5,0,3,6,50.0,3,4,0,4,8,6,0
570,Ángel Correa,16,8,5,10,1,7,29,24.1,22,25,2,23,10,4,0
571,Joaquín Correa,11,5,2,6,3,1,13,7.7,12,8,1,7,3,2,0
572,Thierry Correia,35,23,26,6,3,14,29,48.3,15,20,5,15,19,27,0
573,Danny da Costa,15,4,6,7,2,6,18,33.3,12,14,1,13,11,18,1
574,David Pereira da Costa,22,12,9,6,7,11,26,42.3,15,12,0,12,13,5,0
575,Hélder Costa,0,0,0,0,0,0,0,,0,1,0,1,0,0,0
576,Hélder Costa,27,16,11,9,7,14,41,34.1,27,12,1,11,3,9,0
577,Jaume Costa,35,26,23,7,5,23,31,74.2,8,22,7,15,23,55,0
578,Benoît Costil,1,0,1,0,0,1,2,50.0,1,0,0,0,0,6,3
579,Vladimír Coufal,45,25,24,14,7,18,36,50.0,18,31,9,22,22,64,1
580,Kalifa Coulibaly,5,1,1,1,3,0,4,0.0,4,2,2,0,0,11,0
581,Lassana Coulibaly,58,32,29,26,3,24,62,38.7,38,40,13,27,22,27,0
582,Mamadou Coulibaly,15,12,8,5,2,7,20,35.0,13,9,0,9,11,9,0
583,Tanguy Coulibaly,27,15,14,11,2,9,19,47.4,10,14,2,12,4,10,0
584,Thibaut Courtois,1,0,1,0,0,1,2,50.0,1,0,0,0,0,9,1
585,Philippe Coutinho,17,12,4,11,2,6,21,28.6,15,11,1,10,7,4,0
586,Philippe Coutinho,6,3,3,3,0,3,11,27.3,8,3,0,3,4,3,0
587,Nicolas Cozza,80,47,50,23,7,35,65,53.8,30,35,19,16,38,82,1
588,Alessio Cragno,3,3,2,1,0,3,3,100.0,0,0,0,0,1,14,1
589,Aaron Cresswell,28,18,18,6,4,13,25,52.0,12,31,18,13,35,66,0
590,Charlie Cresswell,5,2,1,4,0,3,3,100.0,0,1,1,0,2,6,0
591,Domenico Criscito,37,21,19,14,4,16,25,64.0,9,22,12,10,39,57,0
592,Bryan Cristante,79,39,31,39,9,37,69,53.6,32,31,5,26,40,45,0
593,Cristo,0,0,0,0,0,0,0,,0,0,0,0,0,0,0
594,Enzo Crivelli,1,0,0,0,1,0,0,,0,0,0,0,0,1,0
595,Domen Črnigoj,21,13,7,11,3,11,29,37.9,18,27,8,19,24,42,0
596,Giovanni Crociata,0,0,0,0,0,0,1,0.0,1,0,0,0,0,0,0
597,Juan Cruz Armada,28,21,15,12,1,8,16,50.0,8,15,12,3,16,58,1
598,Juan Cuadrado,48,23,30,13,5,30,55,54.5,25,23,5,18,29,34,0
599,Cucho,13,5,5,5,3,5,27,18.5,22,13,1,12,5,9,0
600,Marc Cucurella,93,62,43,32,18,44,71,62.0,27,42,14,28,30,74,0
601,Marc Cucurella,0,0,0,0,0,0,0,,0,0,0,0,0,0,0
602,Jorge Cuenca,46,32,30,15,1,21,28,75.0,7,29,14,15,39,155,0
603,Mickaël Cuisance,23,9,7,12,4,10,28,35.7,18,14,0,14,12,5,0
604,Mickaël Cuisance,1,1,0,1,0,0,0,,0,0,0,0,0,0,0
605,Luke Cundle,4,3,0,4,0,1,1,100.0,0,0,0,0,1,1,0
606,Matheus Cunha,19,12,3,11,5,5,20,25.0,15,18,2,16,6,9,0
607,Matheus Cunha,0,0,0,0,0,0,0,,0,0,0,0,0,0,0
608,Patrick Cutrone,5,2,0,3,2,1,9,11.1,8,11,1,10,5,1,0
609,Wylan Cyprien,33,17,12,18,3,13,32,40.6,19,16,6,10,10,14,2
610,Rafael Czichos,29,18,18,9,2,14,28,50.0,14,23,13,10,19,53,2
611,Lennart-Marten Czyborra,0,0,0,0,0,0,2,0.0,2,0,0,0,3,3,1
612,Danilo D'Ambrosio,30,15,21,8,1,11,22,50.0,11,21,10,11,8,20,0
613,Lucas Da Cunha,13,7,2,7,4,6,11,54.5,5,2,0,2,1,2,0
614,Lucas Da Cunha,17,11,5,8,4,9,18,50.0,9,13,0,13,1,3,0
615,Damien Da Silva,13,9,7,5,1,5,9,55.6,4,15,10,5,22,53,1
616,Moanes Dabbur,18,10,3,5,10,4,17,23.5,13,10,0,10,5,4,0
617,Colin Dagba,4,2,2,2,0,3,6,50.0,3,4,2,2,2,1,0
618,Finn Dahmen,0,0,0,0,0,0,0,,0,0,0,0,0,2,0
619,Mahmoud Dahoud,42,19,10,24,8,20,46,43.5,26,18,3,15,17,16,0
620,Patson Daka,15,10,2,8,5,2,19,10.5,17,7,0,7,2,8,0
621,Stuart Dallas,93,55,58,31,4,56,105,53.3,49,45,14,31,57,63,2
622,Diogo Dalot,55,41,35,12,8,31,57,54.4,26,24,13,11,29,59,0
623,Mikkel Damsgaard,27,13,12,11,4,20,36,55.6,16,16,1,15,7,7,0
624,Flavius Daniliuc,46,31,26,17,3,34,43,79.1,9,13,7,6,14,34,1
625,Danilo,37,26,20,13,4,18,28,64.3,10,21,12,9,32,53,1
626,Arnaut Danjuma,7,6,3,0,4,2,4,50.0,2,5,0,5,2,3,0
627,Kevin Danso,41,29,29,12,0,23,34,67.6,11,38,25,13,40,111,0
628,Dante,42,29,30,12,0,23,33,69.7,10,43,27,16,49,96,1
629,Ebrima Darboe,1,1,0,1,0,0,0,,0,0,0,0,1,0,1
630,Márton Dárdai,10,4,8,2,0,8,18,44.4,10,16,6,10,20,33,2
631,Sergi Darder,45,22,16,19,10,18,54,33.3,36,16,1,15,26,32,1
632,Vladimír Darida,32,18,15,13,4,13,32,40.6,19,22,3,19,20,17,2
633,Karl Darlow,0,0,0,0,0,0,0,,0,0,0,0,0,5,1
634,Matteo Darmian,32,16,17,9,6,16,41,39.0,25,16,1,15,19,25,0
635,Josh Dasilva,2,1,0,1,1,1,2,50.0,1,3,0,3,1,7,0
636,Jonathan David,24,9,7,11,6,9,30,30.0,21,14,4,10,5,15,0
637,Alphonso Davies,34,17,17,8,9,13,31,41.9,18,27,1,26,23,26,1
638,Ben Davies,36,21,20,12,4,13,26,50.0,13,32,19,13,30,75,1
639,Tom Davies,3,1,1,1,1,2,5,40.0,3,2,1,1,2,9,0
640,Keinan Davis,0,0,0,0,0,0,0,,0,0,0,0,0,0,0
641,Paweł Dawidowicz,30,18,16,10,4,16,25,64.0,9,14,11,3,21,53,0
642,Craig Dawson,29,17,20,8,1,14,25,56.0,11,59,52,7,29,139,0
643,Kevin De Bruyne,32,16,4,15,13,12,37,32.4,25,32,2,30,6,16,0
644,Konrad De La Fuente,11,7,8,2,1,7,11,63.6,4,5,0,5,2,4,0
645,Sebastien De Maio,5,1,4,1,0,1,9,11.1,8,6,5,1,1,9,0
646,Tommaso De Nipoti,0,0,0,0,0,0,0,,0,0,0,0,0,0,0
647,Rodrigo De Paul,55,30,22,25,8,30,60,50.0,30,24,3,21,21,17,2
648,Mattia De Sciglio,24,12,7,9,8,11,24,45.8,13,10,0,10,10,30,0
649,Lorenzo De Silvestri,23,14,13,8,2,9,31,29.0,22,25,7,18,26,52,0
650,Saulo Decarli,0,0,0,0,0,0,0,,0,0,0,0,0,0,0
651,Troy Deeney,0,0,0,0,0,0,1,0.0,1,0,0,0,0,2,0
652,Grégoire Defrel,15,9,4,8,3,6,16,37.5,10,11,1,10,4,11,0
653,Alessandro Deiola,47,22,15,25,7,23,58,39.7,35,28,10,18,26,45,0
654,Romain Del Castillo,2,1,0,1,1,2,2,100.0,0,0,0,0,1,0,0
655,Romain Del Castillo,27,16,3,17,7,12,31,38.7,19,12,0,12,7,3,0
656,Thomas Delaine,48,35,34,12,2,22,42,52.4,20,20,7,13,27,31,0
657,Thomas Delaney,41,24,17,21,3,16,30,53.3,14,19,10,9,13,35,0
658,Thomas Delaney,0,0,0,0,0,0,0,,0,0,0,0,0,0,0
659,Liam Delap,0,0,0,0,0,0,0,,0,0,0,0,0,0,0
660,Sacha Delaye,8,6,3,2,3,2,8,25.0,6,1,0,1,1,1,1
661,Filippo Delli Carri,6,4,4,2,0,5,14,35.7,9,6,2,4,4,14,0
662,Andy Delort,15,9,3,5,7,7,12,58.3,5,13,4,9,9,14,0
663,Andy Delort,2,0,0,1,1,0,1,0.0,1,1,0,1,0,4,0
664,Fabian Delph,18,15,10,7,1,8,21,38.1,13,12,5,7,14,10,0
665,Moussa Dembélé,18,9,5,5,8,6,15,40.0,9,13,0,13,8,30,1
666,Ousmane Dembélé,24,16,6,10,8,7,23,30.4,16,8,0,8,8,3,0
667,Yusuf Demir,3,1,1,1,1,2,5,40.0,3,1,0,1,2,1,0
668,Merih Demiral,31,17,18,12,1,15,28,53.6,13,26,14,12,58,68,1
669,Kerem Demirbay,52,31,19,30,3,16,41,39.0,25,32,9,23,33,21,0
670,Ermedin Demirović,12,6,4,4,4,1,10,10.0,9,14,1,13,1,7,0
671,Diego Demme,21,12,4,13,4,10,21,47.6,11,11,2,9,9,2,0
672,Jason Denayer,11,4,8,3,0,6,7,85.7,1,8,7,1,16,52,0
673,Leander Dendoncker,42,17,25,14,3,22,50,44.0,28,37,10,27,9,38,1
674,Emmanuel Dennis,51,35,20,22,9,17,52,32.7,35,36,2,34,15,13,0
675,Fabio Depaoli,12,7,6,4,2,1,7,14.3,6,9,2,7,8,14,0
676,Fabio Depaoli,3,1,1,2,0,0,2,0.0,2,2,1,1,1,2,0
677,Mike van der Hoorn,1,0,1,0,0,0,0,,0,0,0,0,1,2,0
678,Arthur Desmas,0,0,0,0,0,0,3,0.0,3,0,0,0,0,1,3
679,Sergiño Dest,32,15,21,10,1,13,18,72.2,5,22,4,18,2,18,0
680,Mattia Destro,9,4,1,4,4,1,6,16.7,5,14,1,13,2,16,0
681,Gerard Deulofeu,11,6,2,3,6,7,29,24.1,22,14,0,14,9,4,0
682,Kiernan Dewsbury-Hall,39,24,20,14,5,19,40,47.5,21,37,8,29,21,26,1
683,Jacopo Dezi,0,0,0,0,0,0,1,0.0,1,0,0,0,1,0,0
684,Samuel Di Carmine,0,0,0,0,0,0,0,,0,0,0,0,0,0,0
685,Federico Di Francesco,16,5,2,8,6,9,23,39.1,14,17,1,16,9,11,0
686,Giovanni Di Lorenzo,58,36,30,20,8,33,58,56.9,25,28,10,18,38,46,1
687,Ángel Di María,29,18,6,13,10,14,37,37.8,23,17,0,17,6,3,0
688,Francesco Di Mariano,1,1,0,1,0,0,0,,0,2,1,1,0,0,0
689,Francesco Di Tacchio,17,7,5,10,2,9,25,36.0,16,16,8,8,22,25,0
690,Boulaye Dia,8,6,3,4,1,2,5,40.0,3,6,1,5,5,4,0
691,Moussa Diaby,20,11,8,9,3,5,38,13.2,33,11,0,11,8,2,0
692,Yadaly Diaby,0,0,0,0,0,0,1,0.0,1,0,0,0,2,2,0
693,Mouctar Diakhaby,35,24,18,15,2,13,23,56.5,10,29,17,12,30,87,3
694,Ibrahim Diakité,0,0,0,0,0,0,1,0.0,1,0,0,0,0,0,0
695,Abdou Diallo,22,14,10,9,3,8,14,57.1,6,6,2,4,10,19,1
696,Habib Diallo,9,5,0,8,1,0,8,0.0,8,13,4,9,4,11,0
697,Ibrahima Diallo,22,11,10,9,3,10,24,41.7,14,7,0,7,9,10,0
698,Habib Diarra,2,1,1,1,0,1,1,100.0,0,0,0,0,0,0,0
699,Stéphane Diarra,11,9,7,3,1,5,10,50.0,5,4,0,4,7,1,0
700,Rúben Dias,26,19,11,12,3,8,15,53.3,7,19,13,6,23,66,0
701,Krépin Diatta,3,2,1,0,2,1,3,33.3,2,2,0,2,1,0,0
702,Amadou Diawara,7,2,5,2,0,1,3,33.3,2,2,0,2,0,1,0
703,Brahim Díaz,23,17,3,11,9,8,22,36.4,14,11,0,11,8,4,0
704,Javier Díaz,0,0,0,0,0,0,0,,0,0,0,0,0,0,0
705,Luis Díaz,9,7,3,5,1,2,8,25.0,6,7,0,7,4,2,0
706,Víctor Díaz,23,15,14,9,0,12,25,48.0,13,19,11,8,17,71,1
707,Daniel Didavi,6,2,0,4,2,4,7,57.1,3,4,1,3,1,1,0
708,Bamba Dieng,17,11,5,5,7,4,14,28.6,10,7,0,7,5,8,0
709,Eric Dier,15,9,6,8,1,7,14,50.0,7,37,32,5,27,142,1
710,Elhadji Dieye,3,2,2,1,0,0,1,0.0,1,2,0,2,1,0,0
711,Lucas Digne,13,10,8,3,2,9,19,47.4,10,15,8,7,23,40,0
712,Lucas Digne,33,19,26,4,3,21,28,75.0,7,16,5,11,14,30,0
713,Mitchell Dijks,15,6,6,6,3,5,12,41.7,7,11,2,9,3,10,1
714,Javairô Dilrosun,13,4,2,8,3,7,24,29.2,17,14,1,13,11,5,0
715,Javairô Dilrosun,3,1,1,2,0,1,1,100.0,0,1,0,1,0,0,0
716,Federico Dimarco,28,15,10,15,3,13,24,54.2,11,6,1,5,19,19,0
717,Landry Dimata,2,2,1,1,0,1,4,25.0,3,0,0,0,1,7,0
718,Stole Dimitrievski,0,0,0,0,0,0,0,,0,0,0,0,1,14,3
719,Junior Dina Ebimbe,9,4,3,4,2,2,3,66.7,1,5,3,2,2,1,0
720,Tristan Dingomé,23,11,10,12,1,10,18,55.6,8,7,1,6,9,3,0
721,Sinaly Diomande,6,3,4,2,0,5,6,83.3,1,6,6,0,12,26,0
722,Issa Diop,10,8,5,5,0,4,11,36.4,7,14,13,1,7,44,0
723,Sofiane Diop,38,20,12,19,7,15,47,31.9,32,10,0,10,23,4,0
724,Andy Diouf,1,1,1,0,0,1,1,100.0,0,1,0,1,0,0,0
725,Assane Dioussé,1,1,1,0,0,1,1,100.0,0,0,0,0,0,0,0
726,Axel Disasi,42,27,20,21,1,23,39,59.0,16,40,30,10,26,75,0
727,Filippo Distefano,0,0,0,0,0,0,0,,0,0,0,0,0,0,0
728,Matías Dituro,0,0,0,0,0,0,0,,0,0,0,0,0,10,5
729,Tiago Djaló,60,39,39,19,2,26,39,66.7,13,26,10,16,24,71,0
730,Djené,44,26,24,16,4,23,34,67.6,11,24,5,19,59,109,2
731,Moussa Djenepo,9,3,3,5,1,3,11,27.3,8,6,1,5,2,6,1
732,Koffi Djidji,48,29,21,23,4,14,18,77.8,4,20,9,11,34,60,0
733,Alexander Djiku,50,37,33,13,4,18,35,51.4,17,30,13,17,61,90,2
734,Bryan Djile Nokoué,3,3,1,2,0,2,2,100.0,0,1,0,1,1,2,0
735,Berat Djimsiti,43,24,21,20,2,29,46,63.0,17,21,11,10,31,56,0
736,Ouparine Djoco,0,0,0,0,0,0,0,,0,0,0,0,1,14,2
737,Naïs Djouahra,7,3,2,2,3,4,8,50.0,4,3,0,3,2,2,0
738,Marko Dmitrović,0,0,0,0,0,0,0,,0,0,0,0,0,3,1
739,Lewis Dobbin,2,1,0,1,1,1,2,50.0,1,0,0,0,0,0,0
740,Matt Doherty,18,12,5,11,2,8,14,57.1,6,11,2,9,13,20,0
741,Jeremy Doku,10,5,3,5,2,3,6,50.0,3,4,0,4,3,0,0
742,Kasper Dolberg,9,4,4,3,2,3,9,33.3,6,15,1,14,6,17,0
743,Jaume Doménech,0,0,0,0,0,0,0,,0,0,0,0,0,3,1
744,Brandon Domingues,6,2,2,4,0,2,3,66.7,1,3,0,3,3,0,0
745,Carlos Dominguez,4,1,4,0,0,4,6,66.7,2,2,1,1,4,21,0
746,Mario Dominguez,0,0,0,0,0,0,0,,0,0,0,0,0,1,0
747,Nicolás Domínguez,76,45,36,32,8,32,76,42.1,44,38,9,29,32,34,1
748,John Donald,7,4,4,2,1,5,8,62.5,3,5,3,2,3,3,0
749,Lee Dongjun,2,1,0,2,0,1,3,33.3,2,2,0,2,2,1,0
750,Anastasios Donis,8,7,4,2,2,2,6,33.3,4,3,0,3,0,1,0
751,Gianluigi Donnarumma,0,0,0,0,0,0,0,,0,0,0,0,0,9,2
752,Niklas Dorsch,76,47,47,23,6,30,60,50.0,30,34,12,22,35,36,3
753,Jodel Dossou,36,17,15,14,7,15,43,34.9,28,14,0,14,5,7,0
754,Lohann Doucet,0,0,0,0,0,0,0,,0,0,0,0,1,0,0
755,Abdoulaye Doucouré,75,43,30,37,8,32,71,45.1,39,33,8,25,28,32,0
756,Cheick Doucouré,75,43,34,34,7,35,79,44.3,44,30,7,23,68,24,0
757,Fodé Doucouré,12,9,9,3,0,9,11,81.8,2,1,0,1,4,6,0
758,Ismaël Doukouré,0,0,0,0,0,0,0,,0,0,0,0,0,1,0
759,Kamory Doumbia,8,2,2,5,1,5,13,38.5,8,9,3,6,3,3,0
760,Moussa Doumbia,0,0,0,0,0,0,1,0.0,1,0,0,0,0,0,0
761,Souleyman Doumbia,30,20,16,9,5,13,27,48.1,14,25,4,21,39,51,0
762,Kieran Dowell,18,7,8,7,3,9,32,28.1,23,10,1,9,7,4,0
763,Bartłomiej Drągowski,0,0,0,0,0,0,0,,0,0,0,0,1,5,2
764,Radu Drăgușin,4,3,2,2,0,2,6,33.3,4,8,4,4,10,33,0
765,Radu Drăgușin,5,4,2,3,0,4,10,40.0,6,7,3,4,13,17,0
766,Cody Drameh,4,2,3,1,0,1,3,33.3,2,0,0,0,1,4,0
767,Julian Draxler,3,2,0,3,0,0,4,0.0,4,3,0,3,5,3,0
768,Matthieu Dreyer,1,1,1,0,0,1,1,100.0,0,0,0,0,0,9,0
769,Domingos Duarte,18,14,9,9,0,6,11,54.5,5,27,20,7,22,82,0
770,Óscar Duarte,18,8,12,6,0,8,23,34.8,15,18,9,9,24,102,0
771,Rubén Duarte,76,47,43,27,6,43,85,50.6,42,40,6,34,57,82,0
772,Leo Dubois,43,27,22,14,7,27,46,58.7,19,27,3,24,22,35,1
773,Martin Dúbravka,1,1,1,0,0,0,1,0.0,1,0,0,0,0,8,2
774,Ondrej Duda,23,16,4,12,7,6,23,26.1,17,14,2,12,17,9,0
775,Jeremy Dudziak,17,6,5,8,4,3,14,21.4,11,8,0,8,10,4,0
776,Shane Duffy,15,12,12,3,0,8,14,57.1,6,24,18,6,16,76,1
777,Unai Dufur,0,0,0,0,0,0,0,,0,1,0,1,4,4,0
778,Denzel Dumfries,32,12,9,14,9,16,32,50.0,16,15,6,9,9,26,0
779,Paul Dummett,7,3,3,4,0,5,8,62.5,3,5,0,5,3,5,0
780,Alfred Duncan,34,19,13,16,5,11,32,34.4,21,32,3,29,10,7,0
781,Lewis Dunk,10,8,5,5,0,5,11,45.5,6,32,28,4,27,113,3
782,Erik Durm,13,7,6,5,2,10,13,76.9,3,8,1,7,10,7,0
783,Hugo Duro,0,0,0,0,0,0,0,,0,0,0,0,0,0,0
784,Hugo Duro,25,19,11,13,1,15,38,39.5,23,24,2,22,4,20,1
785,Jean-Kevin Duverne,71,44,43,21,7,42,90,46.7,48,40,5,35,53,92,0
786,Paulo Dybala,30,13,7,14,9,8,35,22.9,27,19,0,19,9,4,3
787,Edin Džeko,14,8,7,4,3,8,25,32.0,17,22,5,17,4,35,0
788,Enzo Ebosse,25,14,19,6,0,11,19,57.9,8,19,9,10,15,42,0
789,Tyronne Ebuehi,28,12,16,8,4,10,18,55.6,8,13,3,10,16,38,1
790,Ederson,2,1,2,0,0,0,2,0.0,2,0,0,0,0,12,0
791,Éderson,29,18,11,14,4,14,26,53.8,12,11,2,9,19,8,0
792,Odsonne Édouard,16,10,2,7,7,7,21,33.3,14,20,5,15,0,18,0
793,CJ Egan-Riley,1,1,1,0,0,1,1,100.0,0,0,0,0,0,0,0
794,Maximilian Eggestein,48,28,17,25,6,22,50,44.0,28,35,11,24,30,32,1
795,Lilian Egloff,1,0,0,1,0,0,0,,0,1,0,1,0,0,0
796,Kingsley Ehizibue,32,18,27,5,0,15,24,62.5,9,13,4,9,9,26,0
797,Julian Eitschberger,0,0,0,0,0,0,1,0.0,1,1,1,0,2,2,0
798,Albin Ekdal,43,28,17,21,5,26,56,46.4,30,27,7,20,29,25,0
799,Hugo Ekitike,18,10,8,6,4,4,11,36.4,7,9,2,7,6,15,0
800,Jurgen Ekkelenkamp,8,3,2,6,0,2,7,28.6,5,9,2,7,4,5,0
801,Caleb Ekuban,19,12,2,12,5,7,23,30.4,16,19,5,14,9,6,0
802,Anthony Elanga,26,20,12,12,2,15,29,51.7,14,17,1,16,9,7,0
803,Alberth Elis,19,10,5,5,9,11,25,44.0,14,9,0,9,7,10,0
804,Harvey Elliott,3,0,1,1,1,0,6,0.0,6,8,1,7,4,2,0
805,Elif Elmas,25,15,10,10,5,12,28,42.9,16,13,2,11,8,17,0
806,Mohamed Elneny,16,8,10,5,1,7,12,58.3,5,7,1,6,14,13,0
807,Aritz Elustondo,21,14,16,5,0,10,20,50.0,10,19,13,6,29,86,0
808,Nico Elvedi,40,24,23,17,0,22,36,61.1,14,33,22,11,34,83,1
809,Mohamed Elyounoussi,36,17,14,15,7,11,39,28.2,28,23,2,21,12,28,0
810,Adri Embarba,44,29,22,15,7,26,69,37.7,43,35,3,32,19,30,0
811,Breel Embolo,16,11,1,12,3,3,8,37.5,5,14,2,12,6,7,0
812,Emerson,72,47,50,16,6,36,67,53.7,31,25,2,23,22,92,1
813,Emerson,3,3,2,1,0,1,2,50.0,1,1,0,1,2,1,0
814,Renaud Emond,1,0,0,1,0,0,4,0.0,4,2,1,1,0,1,0
815,Youssef En-Nesyri,10,5,5,2,3,4,11,36.4,7,9,1,8,4,18,0
816,Keita Endo,1,1,1,0,0,0,0,,0,1,0,1,0,0,0
817,Wataru Endo,73,41,34,34,5,31,72,43.1,41,43,12,31,30,64,0
818,Christian Eriksen,13,6,4,5,4,8,17,47.1,9,9,1,8,9,14,0
819,Martin Erlic,28,16,18,10,0,10,18,55.6,8,54,39,15,28,122,1
820,Gonzalo Escalante,1,0,1,0,0,1,1,100.0,0,2,1,1,1,0,0
821,Gonzalo Escalante,30,14,9,20,1,13,34,38.2,21,27,2,25,21,28,0
822,Aarón Escandell,0,0,0,0,0,0,1,0.0,1,0,0,0,0,4,0
823,Sergio Escudero,46,24,25,17,4,26,54,48.1,28,18,3,15,26,35,0
824,Alfonso Espino,107,63,58,39,10,44,112,39.3,68,45,10,35,54,87,1
825,Michael Esser,0,0,0,0,0,0,1,0.0,1,0,0,0,0,2,0
826,Estanis,1,1,0,1,0,1,1,100.0,0,0,0,0,0,0,0
827,Maxime Estève,27,18,22,4,1,15,27,55.6,12,31,24,7,22,69,1
828,Pervis Estupiñán,36,22,20,11,5,17,24,70.8,7,13,5,8,25,29,2
829,Oghenekaro Etebo,11,8,7,4,0,3,8,37.5,5,3,1,2,5,5,0
830,Jonny Evans,24,14,14,8,2,14,22,63.6,8,17,13,4,20,59,0
831,Eberechi Eze,10,6,5,2,3,6,11,54.5,5,4,1,3,5,1,0
832,Abdessamad Ezzalzouli,17,9,9,5,3,5,8,62.5,3,3,0,3,9,0,0
833,Łukasz Fabiański,0,0,0,0,0,0,0,,0,0,0,0,0,11,0
834,Fabinho,46,25,17,23,6,24,70,34.3,46,33,10,23,39,25,1
835,Fábio,61,40,31,23,7,36,74,48.6,38,29,7,22,35,31,1
836,Cesc Fàbregas,1,0,0,1,0,1,1,100.0,0,0,0,0,1,0,0
837,Wout Faes,40,24,30,9,1,25,33,75.8,8,47,37,10,53,169,2
838,Wahid Faghir,0,0,0,0,0,0,1,0.0,1,2,0,2,0,0,0
839,Romain Faivre,10,4,2,6,2,4,13,30.8,9,4,0,4,3,2,0
840,Romain Faivre,30,18,12,13,5,12,30,40.0,18,11,0,11,13,10,0
841,Radamel Falcao,2,1,0,1,1,1,4,25.0,3,4,1,3,2,11,0
842,Diego Falcinelli,2,2,2,0,0,0,0,,0,0,0,0,1,1,0
843,Wladimiro Falcone,0,0,0,0,0,0,0,,0,0,0,0,1,5,0
844,Fali,32,19,24,8,0,17,32,53.1,15,26,16,10,24,82,0
845,Paolo Faragò,1,1,1,0,0,0,0,,0,2,0,2,0,0,0
846,Omar Faraj,1,0,1,0,0,1,1,100.0,0,0,0,0,0,0,0
847,Davide Faraoni,62,40,38,21,3,29,62,46.8,33,38,5,33,23,62,1
848,Mohamed Fares,4,2,1,3,0,0,4,0.0,4,8,3,5,8,11,0
849,Diego Farias,1,1,0,1,0,1,3,33.3,2,0,0,0,0,0,0
850,Wuilker Faríñez,0,0,0,0,0,0,0,,0,0,0,0,0,4,0
851,Ömer Faruk Beyaz,4,3,1,3,0,1,5,20.0,4,0,0,0,2,0,0
852,Noah Fatar,1,0,0,0,1,0,1,0.0,1,0,0,0,1,0,0
853,Ansu Fati,3,2,0,2,1,1,1,100.0,0,4,0,4,1,0,0
854,Julien Faussurier,10,6,3,3,4,6,13,46.2,7,12,1,11,5,6,0
855,Andrea Favilli,1,1,0,0,1,0,0,,0,0,0,0,0,2,0
856,Federico Fazio,17,11,10,6,1,9,12,75.0,3,21,16,5,27,67,1
857,Aleix Febas,4,1,0,4,0,2,4,50.0,2,0,0,0,0,0,0
858,Adrian Fein,0,0,0,0,0,0,1,0.0,1,0,0,0,2,0,0
859,Nabil Fekir,43,29,5,25,13,7,36,19.4,29,14,0,14,7,7,0
860,Felipe,20,15,11,8,1,8,18,44.4,10,17,11,6,28,77,0
861,Luiz Felipe,41,23,21,16,4,20,34,58.8,14,40,33,7,33,102,1
862,João Félix,5,2,1,4,0,1,5,20.0,4,4,1,3,7,8,0
863,Ohis Felix Uduokhai,9,6,6,3,0,6,11,54.5,5,13,8,5,9,33,0
864,Kiko Femenía,35,22,23,10,2,21,37,56.8,16,24,8,16,37,51,0
865,Evan Ferguson,0,0,0,0,0,0,0,,0,0,0,0,0,0,0
866,Nathan Ferguson,0,0,0,0,0,0,0,,0,0,0,0,0,0,0
867,Bruno Fernandes,54,28,26,22,6,26,91,28.6,65,36,0,36,17,42,2
868,Edimilson Fernandes,2,0,1,1,0,1,4,25.0,3,2,2,0,2,6,0
869,Aitor Fernández,2,1,2,0,0,2,2,100.0,0,0,0,0,0,7,0
870,Álex Fernández,47,31,22,17,8,21,61,34.4,40,30,7,23,30,31,0
871,Álvaro Fernández,0,0,0,0,0,0,0,,0,0,0,0,0,5,2
872,Federico Fernández,3,0,3,0,0,2,5,40.0,3,10,10,0,4,28,0
873,Fernandinho,21,10,7,10,4,9,27,33.3,18,8,2,6,8,13,1
874,Fernando,24,17,14,9,1,12,33,36.4,21,21,13,8,29,32,2
875,Alex Ferrari,40,22,28,9,3,19,33,57.6,14,31,22,9,39,63,1
876,Salvador Ferrer,32,18,15,9,8,12,25,48.0,13,24,12,12,18,46,0
877,Jordan Ferri,55,35,28,23,4,29,87,33.3,58,21,5,16,30,35,0
878,Riccardo Fiamozzi,7,5,2,2,3,2,4,50.0,2,6,5,1,7,12,0
879,Fidel,44,23,18,17,9,14,57,24.6,43,9,1,8,7,20,0
880,Karol Fila,10,8,5,4,1,4,8,50.0,4,7,2,5,4,6,0
881,Alfreð Finnbogason,3,1,0,2,1,2,4,50.0,2,5,1,4,2,8,0
882,Luca Fiordilino,21,13,11,6,4,13,27,48.1,14,14,4,10,11,12,0
883,Vincenzo Fiorillo,0,0,0,0,0,0,0,,0,0,0,0,0,1,0
884,Roberto Firmino,23,14,5,8,10,3,16,18.8,13,20,0,20,4,3,0
885,Junior Firpo,61,29,30,26,5,31,59,52.5,28,22,6,16,24,37,0
886,Mark Flekken,0,0,0,0,0,0,2,0.0,2,1,0,1,2,10,1
887,Ashley Fletcher,2,1,1,1,0,1,1,100.0,0,1,1,0,0,0,0
888,Alexis Flips,37,21,21,9,7,22,45,48.9,23,21,0,21,24,17,0
889,Alessandro Florenzi,28,14,14,7,7,14,32,43.8,18,9,2,7,27,10,1
890,Phil Foden,16,8,10,4,2,7,17,41.2,10,9,0,9,11,5,0
891,Mamadou Fofana,1,1,0,1,0,1,2,50.0,1,2,1,1,1,2,0
892,Seko Fofana,27,19,11,13,3,12,58,20.7,46,24,2,22,26,17,1
893,Wesley Fofana,12,8,11,1,0,7,11,63.6,4,5,2,3,12,26,1
894,Youssouf Fofana,69,43,19,41,9,29,56,51.8,27,29,7,22,32,22,2
895,Thomas Foket,28,19,12,13,3,18,40,45.0,22,26,4,22,33,35,0
896,Thomas Fontaine,2,0,1,0,1,0,1,0.0,1,3,3,0,2,4,0
897,José Fontán,5,3,3,2,0,1,5,20.0,4,3,1,2,10,10,0
898,José Fonte,23,12,14,7,2,11,25,44.0,14,39,32,7,44,159,1
899,Fernando Forestieri,0,0,0,0,0,0,1,0.0,1,1,0,1,0,1,0
900,Pablo Fornals,54,28,21,21,12,22,84,26.2,62,49,2,47,27,16,1
901,Emil Forsberg,21,12,2,11,8,7,22,31.8,15,18,0,18,2,2,1
902,Adam Forshaw,53,23,21,27,5,21,54,38.9,33,17,1,16,19,12,2
903,Marcus Forss,3,3,0,2,1,2,4,50.0,2,5,0,5,1,0,0
904,Fraser Forster,1,0,1,0,0,0,1,0.0,1,0,0,0,0,23,2
905,Philipp Förster,20,13,4,12,4,11,26,42.3,15,12,1,11,3,2,0
906,Francesco Forte,3,2,0,2,1,2,5,40.0,3,1,0,1,0,2,0
907,Steven Fortes,2,0,2,0,0,1,2,50.0,1,2,1,1,0,4,0
908,Ben Foster,0,0,0,0,0,0,3,0.0,3,0,0,0,0,9,4
909,Tariqe Fosu,0,0,0,0,0,0,0,,0,1,0,1,0,0,0
910,Timothy Fosu-Mensah,5,3,3,1,1,4,4,100.0,0,1,0,1,2,2,0
911,Dimitri Foulquier,0,0,0,0,0,0,1,0.0,1,2,1,1,1,2,0
912,Dimitri Foulquier,36,17,17,15,4,21,34,61.8,13,19,3,16,29,49,0
913,Juan Foyth,69,49,35,28,6,35,47,74.5,12,29,7,22,20,50,0
914,Gianluca Frabotta,0,0,0,0,0,0,1,0.0,1,1,0,1,1,0,0
915,Raphael Framberger,26,19,12,10,4,13,27,48.1,14,8,2,6,9,25,0
916,Przemysław Frankowski,57,39,22,27,8,36,74,48.6,38,27,0,27,28,52,0
917,Enric Franquesa,5,3,4,0,1,0,1,0.0,1,4,0,4,7,11,0
918,Fransérgio,24,10,8,12,4,12,43,27.9,31,18,6,12,23,23,0
919,Ryan Fraser,10,3,5,3,2,5,13,38.5,8,11,1,10,11,11,0
920,Davide Frattesi,46,16,26,18,2,26,52,50.0,26,44,12,32,29,62,1
921,Fred,63,27,32,24,7,22,79,27.8,57,38,11,27,32,24,0
922,Ryan Fredericks,2,2,2,0,0,0,1,0.0,1,2,1,1,4,6,0
923,Morten Frendrup,40,24,19,13,8,13,29,44.8,16,19,2,17,17,7,1
924,Remo Freuler,69,39,22,33,14,30,70,42.9,40,48,8,40,35,26,1
925,Marvin Friedrich,14,8,10,4,0,9,11,81.8,2,5,3,2,5,26,0
926,Marvin Friedrich,17,5,14,3,0,10,16,62.5,6,13,7,6,23,47,0
927,Jeremie Frimpong,32,18,19,12,1,12,23,52.2,11,24,6,18,17,40,2
928,Christian Früchtl,0,0,0,0,0,0,0,,0,0,0,0,0,0,0
929,Jorge de Frutos,33,15,14,11,8,10,51,19.6,41,11,1,10,12,13,0
930,Leo Fuhr Hjelde,5,4,3,2,0,3,3,100.0,0,3,3,0,4,7,0
931,Chris Führich,28,16,10,10,8,18,39,46.2,21,31,2,29,8,9,0
932,Angelo Fulgini,35,25,8,18,9,14,44,31.8,30,21,5,16,22,5,1
933,Marius Funk,0,0,0,0,0,0,0,,0,0,0,0,0,8,1
934,Stephan Fürstner,0,0,0,0,0,0,2,0.0,2,0,0,0,0,1,0
935,Matteo Gabbia,4,3,1,3,0,0,4,0.0,4,2,2,0,8,12,0
936,Manolo Gabbiadini,6,4,3,2,1,1,7,14.3,6,5,2,3,3,10,0
937,Mijat Gaćinović,3,3,1,1,1,3,3,100.0,0,1,0,1,1,2,0
938,Gianluca Gaetano,1,1,1,0,0,1,2,50.0,1,0,0,0,2,0,0
939,Luca Gagliano,0,0,0,0,0,0,0,,0,1,0,1,0,1,0
940,Roberto Gagliardini,12,6,7,4,1,1,13,7.7,12,14,5,9,9,7,0
941,Riccardo Gagliolo,23,12,16,4,3,16,27,59.3,11,15,8,7,28,52,0
942,Javi Galán,108,66,60,37,11,42,99,42.4,57,48,8,40,45,52,0
943,Iñigo Ruiz de Galarreta,40,21,14,21,5,14,30,46.7,16,16,2,14,20,21,0
944,Nicolas Galazzi,2,1,1,0,1,0,1,0.0,1,0,0,0,0,0,0
945,Pablo Galdames Millán,28,12,6,16,6,12,35,34.3,23,16,2,14,8,9,1
946,Thiago Galhardo,12,6,3,3,6,2,12,16.7,10,15,2,13,6,9,0
947,Conor Gallagher,69,38,35,20,14,21,69,30.4,48,58,9,49,29,26,0
948,Gauthier Gallon,3,0,3,0,0,1,1,100.0,0,0,0,0,2,12,1
949,Cristian Gamboa,59,36,40,16,3,30,61,49.2,31,22,7,15,32,35,1
950,Kévin Gameiro,19,10,5,9,5,6,18,33.3,12,22,1,21,6,1,0
951,Idrissa Gana Gueye,60,36,24,24,12,18,44,40.9,26,23,4,19,24,13,0
952,Ignatius Ganago,3,2,1,2,0,2,6,33.3,4,4,0,4,2,3,0
953,Silvère Ganvoula M'Boussy,0,0,0,0,0,0,1,0.0,1,0,0,0,0,1,0
954,Álvaro García,42,23,15,18,9,8,35,22.9,27,27,3,24,42,24,0
955,Dani García,36,22,15,17,4,14,47,29.8,33,27,10,17,24,41,1
956,David García,28,14,15,11,2,12,22,54.5,10,27,21,6,52,168,0
957,Eric García,27,18,13,13,1,11,26,42.3,15,22,12,10,44,53,3
958,Fran Garcia,60,35,44,12,4,39,73,53.4,34,34,8,26,45,53,0
959,Joan García,0,0,0,0,0,0,0,,0,0,0,0,1,1,2
960,Manu García,18,9,6,9,3,9,27,33.3,18,8,2,6,13,4,0
961,Raúl García,27,17,6,11,10,8,36,22.2,28,30,4,26,9,21,0
962,Rubén García,43,26,12,23,8,16,49,32.7,33,31,4,27,24,16,0
963,Saúl García,1,1,1,0,0,0,0,,0,0,0,0,0,0,0
964,Unai García,21,12,14,6,1,14,17,82.4,3,19,11,8,22,78,0
965,Alejandro Garnacho,0,0,0,0,0,0,1,0.0,1,0,0,0,0,0,0
966,Mario Gaspar,10,4,2,5,3,6,10,60.0,4,6,3,3,6,15,0
967,Djeidi Gassama,0,0,0,0,0,0,0,,0,1,1,0,0,0,0
968,Johan Gastien,56,34,26,25,5,27,74,36.5,47,45,11,34,53,49,1
969,Gavi,38,18,13,18,7,9,33,27.3,24,36,0,36,25,13,0
970,Dwight Gayle,1,0,0,1,0,0,1,0.0,1,0,0,0,1,0,0
971,Jean-Philippe Gbamin,1,1,1,0,0,0,2,0.0,2,0,0,0,1,1,0
972,David de Gea,0,0,0,0,0,0,0,,0,0,0,0,0,11,2
973,Linus Gechter,15,8,13,2,0,7,14,50.0,7,12,7,5,11,29,0
974,Dennis Geiger,34,23,9,20,5,17,30,56.7,13,15,1,14,14,7,1
975,Joe Gelhardt,4,3,1,0,3,2,10,20.0,8,9,0,9,0,3,0
976,Luca Gemello,0,0,0,0,0,0,0,,0,0,0,0,0,0,0
977,Yannick Gerhardt,42,20,18,17,7,22,36,61.1,14,24,1,23,25,25,1
978,Valère Germain,23,14,6,11,6,8,31,25.8,23,13,1,12,9,27,0
979,Gerson,42,17,16,20,6,8,35,22.9,27,26,4,22,16,16,2
980,Willem Geubbels,8,5,4,2,2,5,12,41.7,7,5,0,5,6,5,0
981,Hamadi Al Ghaddioui,5,4,2,1,2,0,4,0.0,4,3,1,2,0,4,0
982,Ismaël Gharbi,0,0,0,0,0,0,0,,0,0,0,0,0,0,0
983,Anwar El Ghazi,4,4,2,2,0,2,7,28.6,5,6,0,6,1,2,0
984,Anwar El Ghazi,1,1,1,0,0,1,1,100.0,0,3,0,3,0,0,0
985,Lamine Ghezali,0,0,0,0,0,0,0,,0,1,0,1,0,0,0
986,Paolo Ghiglione,17,12,8,6,3,9,14,64.3,5,11,5,6,10,12,1
987,Saman Ghoddos,17,10,8,6,3,9,15,60.0,6,2,0,2,3,16,0
988,Faouzi Ghoulam,3,1,1,2,0,0,3,0.0,3,2,1,1,3,10,0
989,Dimitris Giannoulis,36,21,17,17,2,24,36,66.7,12,22,6,16,19,41,1
990,Morgan Gibbs-White,0,0,0,0,0,0,0,,0,1,0,1,0,0,0
991,Ben Gibson,23,16,17,6,0,7,12,58.3,5,36,30,6,27,139,2
992,Niko Gießelmann,24,17,10,11,3,15,38,39.5,23,26,4,22,18,29,1
993,Rafał Gikiewicz,2,0,2,0,0,2,7,28.6,5,0,0,0,3,11,5
994,Bryan Gil,3,0,1,0,2,1,2,50.0,1,2,0,2,0,0,0
995,Bryan Gil,13,8,6,3,4,2,13,15.4,11,13,0,13,1,4,0
996,Óscar Gil,52,35,27,20,5,25,46,54.3,21,33,9,24,19,33,2
997,Mario Gila,1,0,1,0,0,0,1,0.0,1,0,0,0,1,1,0
998,Billy Gilmour,41,21,16,21,4,14,52,26.9,38,21,4,17,17,29,0
999,Daniel Ginczek,0,0,0,0,0,0,0,,0,0,0,0,0,0,0
1000,Matthias Ginter,36,22,20,13,3,27,40,67.5,13,21,10,11,33,76,0
1001,Nicholas Gioacchini,7,5,3,2,2,4,10,40.0,6,8,0,8,4,5,0
1002,Sebastian Giovinco,0,0,0,0,0,0,1,0.0,1,0,0,0,0,0,0
1003,Jimmy Giraudon,14,6,10,4,0,7,22,31.8,15,24,14,10,37,68,1
1004,Andrei Girotto,85,52,49,32,4,52,103,50.5,51,67,33,34,69,143,0
1005,Olivier Giroud,15,11,4,6,5,3,17,17.6,14,13,4,9,3,19,0
1006,Serge Gnabry,47,31,16,20,11,22,57,38.6,35,26,0,26,14,3,0
1007,Ben Godfrey,47,32,29,14,4,24,39,61.5,15,41,19,22,15,100,2
1008,Diego Godín,18,7,13,3,2,10,15,66.7,5,7,5,2,13,46,0
1009,Edoardo Goldaniga,12,5,7,5,0,4,11,36.4,7,8,5,3,22,23,0
1010,Edoardo Goldaniga,0,0,0,0,0,0,0,,0,0,0,0,0,0,0
1011,Aleksandr Golovin,40,22,10,18,12,18,41,43.9,23,26,1,25,12,8,0
1012,André Gomes,16,4,6,6,4,8,32,25.0,24,8,2,6,1,7,1
1013,Angel Gomes,23,13,6,12,5,10,15,66.7,5,4,0,4,3,4,0
1014,Toti Gomes,11,7,10,1,0,7,9,77.8,2,6,3,3,8,15,0
1015,Dani Gómez,7,4,3,2,2,4,12,33.3,8,3,0,3,3,5,0
1016,Joe Gomez,10,6,5,2,3,5,9,55.6,4,4,1,3,5,6,0
1017,Maxi Gómez,5,3,1,2,2,5,8,62.5,3,5,1,4,3,22,0
1018,Moi Gómez,15,7,8,3,4,5,17,29.4,12,5,0,5,6,6,0
1019,Papu Gómez,19,11,9,5,5,9,35,25.7,26,15,2,13,7,12,2
1020,Sergi Gómez,33,24,29,3,1,18,27,66.7,9,33,23,10,40,125,2
1021,Victor Gomez,0,0,0,0,0,0,0,,0,0,0,0,0,0,0
1022,Alfred Gomis,1,0,1,0,0,1,2,50.0,1,0,0,0,1,8,2
1023,Maxime Gonalons,43,28,17,22,4,14,39,35.9,25,33,10,23,18,29,0
1024,Vagner Gonçalves,2,1,0,2,0,1,1,100.0,0,0,0,0,1,0,0
1025,Cedric Gondo,5,2,2,2,1,2,5,40.0,3,2,0,2,3,2,0
1026,Álvaro González,1,1,1,0,0,1,1,100.0,0,0,0,0,1,9,0
1027,Diego González,25,16,18,7,0,9,16,56.3,7,21,13,8,19,87,0
1028,Édgar González,25,19,15,8,2,17,24,70.8,7,17,11,6,23,82,0
1029,Giovanni González,9,3,4,4,1,3,5,60.0,2,7,2,5,4,14,0
1030,Nicolás González,21,16,6,8,7,9,28,32.1,19,26,2,24,21,4,1
1031,Nicolás González,31,20,5,23,3,11,27,40.7,16,12,0,12,6,12,0
1032,Peter González,0,0,0,0,0,0,0,,0,0,0,0,1,0,0
1033,Roberto González,5,4,3,2,0,4,6,66.7,2,5,0,5,1,1,0
1034,Charlie Goode,7,5,5,2,0,4,4,100.0,0,4,2,2,2,8,0
1035,Anthony Gordon,54,32,20,30,4,21,59,35.6,38,49,3,46,22,17,0
1036,Kaide Gordon,1,0,0,0,1,0,0,,0,0,0,0,0,0,0
1037,Leon Goretzka,25,15,12,9,4,11,26,42.3,15,11,1,10,17,23,2
1038,Gori,0,0,0,0,0,0,0,,0,2,0,2,0,0,0
1039,Andoni Gorosabel,47,31,32,9,6,25,47,53.2,22,16,3,13,18,49,0
1040,Robin Gosens,7,3,3,4,0,4,8,50.0,4,4,0,4,9,1,0
1041,Robin Gosens,3,1,1,2,0,0,0,,0,5,2,3,3,3,0
1042,Dan Gosling,2,1,1,1,0,2,6,33.3,4,2,0,2,0,3,0
1043,Amine Gouiri,22,13,2,13,7,10,32,31.3,22,22,5,17,11,17,1
1044,Lucas Gourna-Douath,45,26,22,18,5,21,36,58.3,15,22,3,19,13,9,2
1045,Jeffrey Gouweleeuw,50,27,33,17,0,22,36,61.1,14,35,18,17,49,116,0
1046,Jonathan Gradit,60,28,24,28,8,25,45,55.6,20,39,27,12,65,106,0
1047,Jens Grahl,0,0,0,0,0,0,0,,0,0,0,0,0,1,0
1048,Alberto Grassi,47,26,13,30,4,16,38,42.1,22,27,9,18,63,33,1
1049,Jaume Grau,1,1,1,0,0,0,1,0.0,1,0,0,0,0,0,0
1050,Andrew Gravillon,32,24,19,13,0,17,27,63.0,10,25,15,10,33,83,1
1051,Demarai Gray,30,19,13,10,7,10,22,45.5,12,30,2,28,15,21,1
1052,Adrian Grbić,2,1,0,2,0,2,6,33.3,4,3,1,2,0,7,0
1053,Ivo Grbić,0,0,0,0,0,0,0,,0,0,0,0,0,14,1
1054,Jack Grealish,18,17,4,10,4,5,13,38.5,8,11,1,10,8,7,0
1055,Etienne Green,1,1,1,0,0,0,0,,0,0,0,0,1,9,0
1056,Julian Green,9,5,0,8,1,2,8,25.0,6,10,2,8,7,10,0
1057,Mason Greenwood,15,9,9,1,5,3,9,33.3,6,5,0,5,1,6,0
1058,Sam Greenwood,8,5,0,5,3,4,7,57.1,3,3,0,3,2,1,0
1059,Michael Gregoritsch,19,8,4,10,5,2,15,13.3,13,18,2,16,6,29,0
1060,Dominik Greif,0,0,0,0,0,0,0,,0,0,0,0,0,0,0
1061,Clément Grenier,0,0,0,0,0,0,0,,0,1,1,0,0,1,0
1062,Sebastian Griesbeck,60,31,38,19,3,39,62,62.9,23,38,13,25,43,100,1
1063,Sebastian Griesbeck,1,1,0,1,0,1,1,100.0,0,0,0,0,0,0,0
1064,Antoine Griezmann,13,5,3,10,0,2,6,33.3,4,4,0,4,3,5,0
1065,Antoine Griezmann,30,14,11,15,4,12,32,37.5,20,18,1,17,7,18,0
1066,Vincenzo Grifo,27,15,9,13,5,9,26,34.6,17,12,2,10,13,28,0
1067,Lennart Grill,0,0,0,0,0,0,0,,0,0,0,0,0,0,0
1068,Florian Grillitsch,37,19,15,21,1,17,31,54.8,14,18,7,11,29,36,1
1069,Pascal Groß,28,15,15,11,2,12,33,36.4,21,34,8,26,18,23,0
1070,Carlos Gruezo,22,11,10,10,2,8,21,38.1,13,11,2,9,9,15,0
1071,Vicente Guaita,1,0,1,0,0,1,1,100.0,0,0,0,0,1,8,1
1072,Andrés Guardado,30,13,12,17,1,13,34,38.2,21,18,4,14,21,29,1
1073,Sergi Guardiola,10,9,3,5,2,1,21,4.8,20,14,2,12,4,17,0
1074,Nemanja Gudelj,16,7,10,4,2,5,8,62.5,3,14,9,5,22,37,0
1075,Gabriel Gudmundsson,43,31,24,16,3,17,35,48.6,18,15,3,12,20,13,0
1076,Noah Guede-Nadje,0,0,0,0,0,0,0,,0,0,0,0,0,0,0
1077,Gonçalo Guedes,21,14,6,7,8,2,22,9.1,20,14,0,14,9,1,0
1078,Marc Guéhi,35,17,24,10,1,15,16,93.8,1,34,26,8,30,127,0
1079,Mattéo Guendouzi,45,30,10,26,9,13,47,27.7,34,15,1,14,16,18,0
1080,Yanis Guermouche,2,1,0,1,1,1,1,100.0,0,0,0,0,0,0,0
1081,Raphaël Guerreiro,35,19,19,12,4,16,31,51.6,15,18,2,16,25,14,1
1082,Evann Guessand,9,8,2,5,2,3,8,37.5,5,4,0,4,0,1,0
1083,Ander Guevara,18,13,6,10,2,10,17,58.8,7,12,6,6,12,8,0
1084,Lamine Gueye,5,5,1,1,3,3,7,42.9,4,4,0,4,6,1,0
1085,Pape Gueye,38,19,15,22,1,16,31,51.6,15,15,3,12,24,16,0
1086,John Guidetti,2,1,0,0,2,0,1,0.0,1,1,0,1,0,0,0
1087,Josuha Guilavogui,39,16,18,17,4,14,29,48.3,15,16,8,8,36,23,0
1088,Josuha Guilavogui,23,14,13,9,1,7,18,38.9,11,11,6,5,25,42,0
1089,Frederic Guilbert,69,39,33,24,12,32,62,51.6,30,37,11,26,55,39,0
1090,Hugo Guillamón,43,27,20,16,7,18,44,40.9,26,26,10,16,30,53,1
1091,Bruno Guimarães,44,23,18,22,4,21,38,55.3,17,25,6,19,9,13,0
1092,Bruno Guimarães,50,31,20,25,5,23,59,39.0,36,21,4,17,21,11,1
1093,Serhou Guirassy,4,2,1,2,1,1,7,14.3,6,4,0,4,1,8,0
1094,Péter Gulácsi,0,0,0,0,0,0,0,,0,0,0,0,1,15,1
1095,Manuel Gulde,18,10,14,3,1,8,11,72.7,3,16,8,8,17,37,0
1096,Gerard Gumbau,46,19,22,19,5,22,51,43.1,29,18,4,14,23,25,0
1097,Robert Gumny,48,29,25,20,3,25,43,58.1,18,24,7,17,28,57,3
1098,İlkay Gündoğan,23,9,10,12,1,12,31,38.7,19,11,1,10,15,10,0
1099,Angus Gunn,0,0,0,0,0,0,0,,0,0,0,0,0,11,0
1100,Christian Günter,34,20,16,15,3,18,50,36.0,32,23,6,17,17,49,2
1101,Koray Günter,32,18,19,11,2,16,32,50.0,16,27,21,6,69,110,1
1102,Lasse Günther,8,5,4,3,1,5,9,55.6,4,0,0,0,2,2,0
1103,Jon Guridi,5,3,2,3,0,1,4,25.0,3,3,1,2,3,4,0
1104,Malo Gusto,55,35,29,21,5,24,40,60.0,16,21,6,15,33,41,1
1105,Raúl Guti,25,15,7,14,4,10,30,33.3,20,9,3,6,25,7,0
1106,Marcos Mauro López Gutiérrez,1,0,0,1,0,0,2,0.0,2,2,1,1,1,9,0
1107,Miguel Gutiérrez,7,5,5,0,2,3,5,60.0,2,0,0,0,2,2,0
1108,Albert Guðmundsson,5,3,2,1,2,3,8,37.5,5,2,0,2,5,4,0
1109,Joško Gvardiol,47,31,28,17,2,22,39,56.4,17,30,11,19,51,62,2
1110,Emmanuel Gyasi,47,30,31,9,7,21,41,51.2,20,22,4,18,16,43,1
1111,Norbert Gyömbér,53,32,40,11,2,33,50,66.0,17,38,24,14,44,126,1
1112,Erling Haaland,2,1,0,1,1,0,1,0.0,1,8,1,7,1,31,0
1113,Nicolas Haas,35,22,15,10,10,17,39,43.6,22,24,4,20,9,17,1
1114,Janik Haberer,14,8,5,6,3,7,19,36.8,12,11,4,7,16,11,0
1115,Alexander Hack,52,26,35,17,0,29,46,63.0,17,31,14,17,51,95,1
1116,Robin Hack,14,8,6,5,3,3,21,14.3,18,18,1,17,5,4,0
1117,Munir El Haddadi,8,4,1,6,1,2,8,25.0,6,7,1,6,5,2,0
1118,André Hahn,36,20,9,15,12,17,50,34.0,33,38,5,33,15,43,0
1119,Amadou Haidara,30,14,11,19,0,17,37,45.9,20,22,6,16,16,8,1
1120,Massadio Haïdara,28,21,18,7,3,15,24,62.5,9,18,4,14,22,31,0
1121,Oualid El Hajjam,22,11,12,6,4,15,23,65.2,8,12,6,6,22,28,0
1122,Achraf Hakimi,74,51,38,27,9,40,72,55.6,32,26,5,21,28,23,2
1123,Marcel Halstenberg,10,7,6,4,0,6,11,54.5,5,6,0,6,7,11,0
1124,Pierre-Yves Hamel,0,0,0,0,0,0,1,0.0,1,0,0,0,2,0,0
1125,Pierre-Yves Hamel,11,6,0,5,6,5,6,83.3,1,2,1,1,0,0,0
1126,Romain Hamouma,10,7,1,5,4,2,13,15.4,11,8,0,8,4,1,0
1127,Samir Handanović,1,0,1,0,0,1,2,50.0,1,1,0,1,0,6,3
1128,Grant Hanley,44,25,28,14,2,18,35,51.4,17,56,45,11,56,176,2
1129,Ridgeciano Haps,36,20,26,4,6,11,21,52.4,10,34,12,22,29,57,1
1130,Genki Haraguchi,37,20,12,22,3,15,48,31.3,33,25,3,22,26,15,0
1131,Amine Harit,18,11,9,9,0,9,17,52.9,8,10,0,10,4,2,0
1132,Varazdat Haroyan,31,21,20,10,1,19,29,65.5,10,22,12,10,15,62,0
1133,Jack Harrison,57,37,22,22,13,31,76,40.8,45,35,1,34,21,19,0
1134,Abdou Harroui,11,4,4,7,0,8,11,72.7,3,14,0,14,4,5,0
1135,Luis Hartwig,0,0,0,0,0,0,0,,0,0,0,0,0,0,0
1136,Makoto Hasebe,27,12,15,11,1,13,29,44.8,16,24,8,16,22,36,0
1137,Hans Hateboer,22,14,10,8,4,11,26,42.3,15,11,1,10,7,20,0
1138,Kortney Hause,3,3,2,0,1,3,4,75.0,1,8,5,3,6,13,0
1139,Kai Havertz,17,8,5,7,5,4,14,28.6,10,28,1,27,4,32,1
1140,Isaac Hayden,28,14,11,14,3,12,29,41.4,17,17,8,9,14,24,0
1141,Eden Hazard,6,3,3,2,1,3,7,42.9,4,3,0,3,2,0,0
1142,Thorgan Hazard,23,13,8,10,5,15,40,37.5,25,23,1,22,6,4,0
1143,Jonas Hector,76,39,36,26,14,29,74,39.2,45,59,8,51,50,68,1
1144,Hwang Hee-chan,27,13,9,16,2,14,44,31.8,30,10,0,10,13,7,1
1145,Hwang Hee-chan,0,0,0,0,0,0,0,,0,0,0,0,1,0,0
1146,Silvan Hefti,50,30,23,22,5,32,58,55.2,26,20,4,16,20,34,1
1147,Dominique Heintz,8,5,5,3,0,3,6,50.0,3,7,4,3,7,14,0
1148,Dominique Heintz,0,0,0,0,0,0,0,,0,0,0,0,1,0,0
1149,Jordan Henderson,36,20,9,25,2,17,44,38.6,27,25,1,24,23,14,0
1150,Liam Henderson,22,13,7,8,7,9,31,29.0,22,14,4,10,9,13,0
1151,Jeff Hendrick,1,1,0,1,0,1,1,100.0,0,0,0,0,0,1,0
1152,Wayne Hennessey,0,0,0,0,0,0,0,,0,0,0,0,1,0,1
1153,Benjamin Henrichs,30,21,18,6,6,12,22,54.5,10,16,1,15,19,14,0
1154,Henrique,13,7,10,1,2,5,16,31.3,11,13,1,12,22,14,0
1155,Dalbert Henrique,43,23,23,16,4,11,35,31.4,24,28,5,23,24,34,0
1156,Luis Henrique,4,3,2,1,1,2,5,40.0,3,2,0,2,5,1,0
1157,Matheus Henrique,10,3,6,3,1,6,24,25.0,18,14,2,12,7,12,1
1158,Rico Henry,28,20,18,8,2,12,34,35.3,22,31,10,21,26,76,1
1159,Thomas Henry,9,4,2,3,4,5,13,38.5,8,11,5,6,2,25,0
1160,Christophe Hérelle,48,28,30,16,2,17,26,65.4,9,20,15,5,44,84,1
1161,Jérôme Hergault,3,1,1,2,0,2,5,40.0,3,4,1,3,4,7,0
1162,Kike Hermoso,2,1,2,0,0,2,2,100.0,0,2,1,1,0,5,1
1163,Mario Hermoso,30,15,23,4,3,20,38,52.6,18,18,3,15,29,49,2
1164,Aridane Hernández,12,9,10,2,0,3,13,23.1,10,11,9,2,20,71,0
1165,Lucas Hernández,50,31,20,24,6,26,42,61.9,16,22,11,11,28,54,1
1166,Luis Hernández,9,5,9,0,0,5,8,62.5,3,5,3,2,16,34,0
1167,Mario Hernández,10,4,7,3,0,5,9,55.6,4,1,0,1,4,7,0
1168,Theo Hernández,53,35,34,14,5,29,40,72.5,11,16,3,13,23,29,3
1169,Hernani,20,10,8,9,3,13,32,40.6,19,17,4,13,13,5,1
1170,Ander Herrera,29,17,7,16,6,14,39,35.9,25,22,8,14,14,8,0
1171,Héctor Herrera,16,8,11,4,1,7,20,35.0,13,13,2,11,12,16,0
1172,Sergio Herrera,3,2,3,0,0,3,6,50.0,3,1,0,1,1,18,0
1173,Yangel Herrera,41,31,19,19,3,18,39,46.2,21,27,5,22,19,33,1
1174,Patrick Herrmann,15,7,5,6,4,9,24,37.5,15,10,1,9,6,8,0
1175,Son Heung-min,15,6,5,7,3,5,23,21.7,18,27,6,21,13,8,0
1176,Daan Heymans,3,1,1,2,0,1,5,20.0,4,7,3,4,4,3,0
1177,Aaron Hickey,46,29,24,15,7,20,30,66.7,10,36,13,23,29,44,0
1178,Piero Hincapié,33,23,23,8,2,19,25,76.0,6,34,15,19,33,56,2
1179,Martin Hinteregger,45,28,28,16,1,28,43,65.1,15,36,16,20,42,78,3
1180,Marwin Hitz,0,0,0,0,0,0,0,,0,0,0,0,0,2,0
1181,Ki-Jana Hoever,10,6,5,5,0,7,12,58.3,5,6,0,6,6,8,0
1182,Nicolas Höfler,73,42,37,29,7,28,62,45.2,34,50,21,29,46,42,0
1183,Jonas Hofmann,30,20,6,17,7,17,42,40.5,25,23,0,23,12,10,0
1184,Rob Holding,13,9,11,1,1,5,6,83.3,1,23,18,5,10,42,1
1185,Lucas Höler,41,25,10,17,14,13,28,46.4,15,25,4,21,17,39,2
1186,Mason Holgate,35,18,26,9,0,11,26,42.3,15,25,17,8,26,95,1
1187,Gerrit Holtmann,15,9,5,3,7,6,22,27.3,16,26,2,24,8,6,0
1188,Martin Hongla,14,8,5,6,3,4,8,50.0,4,6,2,4,4,16,1
1189,Franck Honorat,54,38,25,13,16,27,47,57.4,20,24,2,22,15,25,0
1190,Justin Hoogma,6,5,4,2,0,4,6,66.7,2,5,5,0,4,4,0
1191,Sydney van Hooijdonk,0,0,0,0,0,0,1,0.0,1,1,0,1,0,0,0
1192,Matthew Hoppe,1,0,0,0,1,0,3,0.0,3,0,0,0,0,0,0
1193,Jannes Horn,6,4,4,2,0,4,8,50.0,4,1,1,0,3,9,0
1194,Timo Horn,0,0,0,0,0,0,1,0.0,1,0,0,0,0,5,0
1195,Fraser Hornby,3,1,1,2,0,0,2,0.0,2,3,0,3,4,5,0
1196,Cédric Hountondji,33,17,20,12,1,16,24,66.7,8,23,12,11,34,76,0
1197,Lukáš Hrádecký,1,1,1,0,0,1,1,100.0,0,0,0,0,0,10,1
1198,Branimir Hrgota,46,29,10,31,5,21,72,29.2,51,27,1,26,11,3,1
1199,Petko Hristov,17,10,11,6,0,10,16,62.5,6,29,23,6,19,47,0
1200,Ajdin Hrustic,16,11,5,7,4,11,32,34.4,21,18,1,17,10,7,0
1201,Timo Hübers,45,27,28,17,0,27,45,60.0,18,31,19,12,52,95,0
1202,Benjamin Hübner,9,5,0,7,2,3,5,60.0,2,2,2,0,9,7,0
1203,Callum Hudson-Odoi,14,10,5,6,3,8,23,34.8,15,8,0,8,2,6,1
1204,Will Hughes,29,14,10,16,3,7,16,43.8,9,13,7,6,8,10,0
1205,Mats Hummels,34,22,20,13,1,20,36,55.6,16,18,13,5,32,66,1
1206,Elseid Hysaj,46,30,25,17,4,29,45,64.4,16,18,6,12,24,34,1
1207,Suk Hyun-jun,0,0,0,0,0,0,0,,0,2,0,2,0,2,0
1208,Pierre Højbjerg,78,45,31,38,9,38,85,44.7,47,61,13,48,48,54,0
1209,Iago,49,29,25,19,5,15,34,44.1,19,28,6,22,27,62,0
1210,Robert Ibáñez,3,3,2,0,1,1,2,50.0,1,1,0,1,1,1,0
1211,Roger Ibanez,54,32,31,19,4,26,43,60.5,17,26,7,19,62,104,2
1212,Vicente Iborra,19,10,9,7,3,12,24,50.0,12,11,5,6,11,27,1
1213,Zlatan Ibrahimović,0,0,0,0,0,0,2,0.0,2,2,1,1,3,9,0
1214,Mauro Icardi,5,3,1,3,1,3,7,42.9,4,3,0,3,5,12,0
1215,Adam Idah,9,6,2,5,2,2,3,66.7,1,4,2,2,3,7,0
1216,Oussama Idrissi,1,0,0,1,0,0,1,0.0,1,1,0,1,1,1,0
1217,Oussama Idrissi,8,4,3,4,1,4,15,26.7,11,8,0,8,3,5,0
1218,Iglesias,19,10,11,8,0,7,17,41.2,10,8,2,6,10,28,0
1219,Borja Iglesias,6,4,1,2,3,0,8,0.0,8,11,1,10,4,7,0
1220,Jonathan Iglesias,18,11,6,10,2,10,18,55.6,8,8,2,6,5,2,1
1221,Juan Ignacio Ramírez,2,1,0,1,1,0,0,,0,0,0,0,0,0,0
1222,Igor,53,31,34,16,3,30,40,75.0,10,37,19,18,31,46,4
1223,Kelechi Iheanacho,10,7,2,5,3,3,14,21.4,11,19,0,19,4,10,0
1224,Danylo Ihnatenko,17,9,8,7,2,10,24,41.7,14,9,2,7,6,17,1
1225,Jonathan Ikone,7,3,2,3,2,3,10,30.0,7,10,2,8,1,2,0
1226,Jonathan Ikone,11,3,6,4,1,4,11,36.4,7,13,1,12,5,4,0
1227,Ivan Ilić,39,18,16,19,4,20,54,37.0,34,34,12,22,22,55,0
1228,Josip Iličić,7,7,3,2,2,4,17,23.5,13,6,1,5,3,1,0
1229,Asier Illarramendi,9,5,5,3,1,1,10,10.0,9,5,1,4,4,12,0
1230,Stefan Ilsanker,14,8,7,6,1,5,10,50.0,5,6,2,4,6,15,1
1231,Ciro Immobile,10,5,4,4,2,1,15,6.7,14,7,1,6,3,16,0
1232,Burak İnce,1,1,1,0,0,1,2,50.0,1,1,0,1,0,0,0
1233,Danny Ings,23,16,2,16,5,13,37,35.1,24,31,2,29,6,22,0
1234,Marcus Ingvartsen,0,0,0,0,0,0,2,0.0,2,0,0,0,2,1,0
1235,Marcus Ingvartsen,3,2,2,0,1,3,9,33.3,6,6,0,6,6,7,1
1236,Bonke Innocent,27,16,10,16,1,11,26,42.3,15,11,3,8,16,14,0
1237,Lorenzo Insigne,23,14,8,12,3,8,44,18.2,36,30,1,29,20,3,1
1238,Nikita Iosifov,0,0,0,0,0,0,0,,0,0,0,0,0,0,0
1239,Tim Iroegbunam,5,4,2,3,0,1,1,100.0,0,0,0,0,2,1,0
1240,Alexander Isak,7,4,1,3,3,2,12,16.7,10,14,2,12,3,10,0
1241,Isco,9,5,4,4,1,5,12,41.7,7,1,0,1,2,1,0
1242,Wilson Isidor,0,0,0,0,0,0,4,0.0,4,1,0,1,0,0,0
1243,Ardian Ismajli,13,9,8,4,1,5,14,35.7,9,21,11,10,24,80,0
1244,Hiroki Ito,43,31,21,19,3,25,43,58.1,18,40,19,21,53,95,0
1245,Cedric Itten,5,2,1,2,2,1,6,16.7,5,3,0,3,2,4,0
1246,Gian-Luca Itter,44,26,30,11,3,21,38,55.3,17,24,9,15,13,51,0
1247,Alex Iwobi,40,19,23,12,5,21,52,40.4,31,39,3,36,20,25,2
1248,Armando Izzo,16,9,14,2,0,9,11,81.8,2,5,4,1,17,21,0
1249,Nicolas Jackson,2,0,1,0,1,0,0,,0,0,0,0,1,1,0
1250,Lee Jae-sung,30,12,8,14,8,6,27,22.2,21,20,2,18,18,18,0
1251,Paul Jaeckel,51,29,27,24,0,29,51,56.9,22,34,10,24,57,81,0
1252,Mato Jajalo,24,14,14,7,3,11,23,47.8,12,7,0,7,11,5,0
1253,Kristijan Jakić,37,22,10,21,6,15,62,24.2,47,33,3,30,21,25,1
1254,Ismail Jakobs,32,16,14,15,3,16,35,45.7,19,16,1,15,17,31,0
1255,Marin Jakoliš,2,1,0,1,1,0,6,0.0,6,0,0,0,1,0,0
1256,Abdel Jalil Medioub,9,5,5,3,1,3,4,75.0,1,8,4,4,12,34,0
1257,Daniel James,2,1,0,2,0,0,0,,0,2,0,2,0,1,0
1258,Daniel James,24,14,8,8,8,10,23,43.5,13,18,1,17,8,12,0
1259,Reece James,33,25,14,18,1,9,22,40.9,13,20,2,18,17,22,0
1260,Vitaly Janelt,61,32,26,27,8,27,53,50.9,26,23,7,16,28,35,0
1261,Jakub Jankto,11,7,5,5,1,10,17,58.8,7,4,0,4,4,7,0
1262,Pontus Jansson,40,21,32,8,0,22,34,64.7,12,37,27,10,52,187,0
1263,Tony Jantschke,6,5,2,4,0,3,6,50.0,3,3,2,1,5,8,0
1264,Adnan Januzaj,17,11,5,8,4,9,24,37.5,15,15,3,12,12,15,0
1265,Léo Jardim,0,0,0,0,0,0,0,,0,0,0,0,1,10,0
1266,Paweł Jaroszyński,10,5,7,3,0,5,7,71.4,2,4,0,4,10,19,0
1267,Jason,11,7,6,4,1,7,20,35.0,13,7,0,7,7,5,0
1268,Jason,4,1,2,1,1,0,1,0.0,1,2,0,2,1,1,0
1269,Dennis Jastrzembski,2,1,1,1,0,2,8,25.0,6,1,0,1,5,3,0
1270,Luis Javier Suárez,26,14,9,9,8,8,27,29.6,19,25,3,22,6,23,0
1271,Corentin Jean,9,6,4,4,1,3,6,50.0,3,5,0,5,1,0,0
1272,Jemerson,37,25,30,7,0,18,26,69.2,8,23,8,15,25,33,1
1273,Fredrik Jensen,5,4,1,3,1,4,7,57.1,3,5,1,4,2,4,0
1274,Mathias Jensen,33,18,12,16,5,22,63,34.9,41,32,3,29,22,13,0
1275,Moritz Jenz,26,12,18,6,2,11,24,45.8,13,19,11,8,28,55,0
1276,Gabriel Jesus,18,12,2,4,12,6,26,23.1,20,18,0,18,15,8,0
1277,Juan Jesus,25,17,14,11,0,12,18,66.7,6,21,16,5,9,34,0
1278,Álvaro Jiménez,6,3,3,2,1,4,7,57.1,3,3,0,3,3,0,0
1279,Raúl Jiménez,29,14,6,16,7,6,30,20.0,24,31,5,26,13,26,0
1280,João Pedro,20,14,7,8,5,6,23,26.1,17,23,3,20,15,17,0
1281,Joaquín,6,2,4,2,0,3,8,37.5,5,5,2,3,3,10,0
1282,Joelinton,72,38,30,33,9,26,61,42.6,35,46,11,35,34,50,2
1283,Jofre,1,1,0,0,1,1,1,100.0,0,0,0,0,0,0,0
1284,Marco John,0,0,0,0,0,0,1,0.0,1,1,0,1,1,1,0
1285,Dennis Johnsen,14,10,8,4,2,6,18,33.3,12,14,1,13,5,3,0
1286,Ben Johnson,33,16,15,15,3,21,28,75.0,7,16,8,8,22,55,0
1287,Curtis Jones,11,9,3,6,2,1,10,10.0,9,4,0,4,6,4,0
1288,Phil Jones,5,5,3,1,1,2,3,66.7,1,4,4,0,3,8,0
1289,Frenkie de Jong,35,19,12,18,5,12,23,52.2,11,19,5,14,20,16,0
1290,Luuk de Jong,9,7,1,5,3,1,2,50.0,1,4,0,4,0,12,0
1291,Joan Jordán,61,30,22,31,8,28,65,43.1,37,27,6,21,30,18,1
1292,Kaio Jorge,2,1,0,2,0,1,3,33.3,2,1,0,1,0,2,0
1293,Jorginho,64,33,27,31,6,29,83,34.9,54,27,4,23,36,21,1
1294,Josan,36,22,23,9,4,26,44,59.1,18,11,4,7,10,21,0
1295,Willian José,15,13,2,10,3,2,8,25.0,6,10,2,8,3,16,0
1296,Joselu,16,11,1,9,6,7,25,28.0,18,21,4,17,7,45,0
1297,Josema,3,2,1,1,1,0,2,0.0,2,1,1,0,0,11,0
1298,Lenny Joseph,2,1,1,1,0,0,0,,0,3,0,3,0,0,0
1299,Diogo Jota,39,18,12,18,9,13,55,23.6,42,19,2,17,6,6,0
1300,Stevan Jovetić,5,2,0,2,3,1,6,16.7,5,3,0,3,1,6,0
1301,Luka Jović,1,1,0,1,0,0,1,0.0,1,3,0,3,1,4,0
1302,Miguel Juan Llambrich,2,2,1,1,0,0,0,,0,1,0,1,0,5,0
1303,José Juan Macías,1,0,0,0,1,0,1,0.0,1,1,0,1,1,0,0
1304,Juanmi,39,25,11,19,9,19,49,38.8,30,24,1,23,9,10,1
1305,Gideon Jung,3,1,1,2,0,2,4,50.0,2,1,1,0,2,5,0
1306,Flavio Junior Bianchi,2,2,1,0,1,0,2,0.0,2,0,0,0,0,0,0
1307,Lago Junior,3,2,3,0,0,3,5,60.0,2,0,0,0,2,2,0
1308,Hamed Junior Traorè,32,18,8,14,10,10,46,21.7,36,22,2,20,12,6,1
1309,Vinicius Júnior,46,24,23,19,4,15,50,30.0,35,25,0,25,6,6,0
1310,James Justin,22,13,11,8,3,7,15,46.7,8,16,4,12,17,34,0
1311,Jutglà,2,1,0,1,1,0,1,0.0,1,2,0,2,1,1,0
1312,Jens Jønsson,40,29,22,17,1,17,35,48.6,18,17,7,10,34,32,0
1313,Mathias Jørgensen,10,4,3,5,2,7,10,70.0,3,6,1,5,10,13,0
1314,Ozan Kabak,10,5,4,6,0,5,9,55.6,4,19,11,8,16,26,0
1315,Christian Kabasele,11,5,10,1,0,7,10,70.0,3,20,16,4,14,67,1
1316,Issa Kaboré,45,22,22,14,9,20,38,52.6,18,27,2,25,20,38,1
1317,Anton Kade,4,2,3,1,0,2,8,25.0,6,3,0,3,3,1,0
1318,Pavel Kadeřábek,11,10,6,3,2,5,16,31.3,11,18,6,12,13,22,0
1319,Tino Kadewere,7,5,2,2,3,4,13,30.8,9,7,0,7,4,1,1
1320,Florian Kainz,41,26,9,25,7,23,51,45.1,28,27,3,24,32,24,0
1321,Gaël Kakuta,22,14,2,13,7,4,20,20.0,16,10,0,10,4,3,0
1322,Sasa Kalajdzic,10,6,2,5,3,3,11,27.3,8,5,0,5,2,14,0
1323,Arnaud Kalimuendo,9,8,1,3,5,2,7,28.6,5,6,1,5,8,0,0
1324,Arnaud Kalimuendo,0,0,0,0,0,0,0,,0,0,0,0,0,0,0
1325,Nikola Kalinić,2,0,0,1,1,1,2,50.0,1,2,0,2,0,2,0
1326,Yayah Kallon,15,11,5,6,4,3,11,27.3,8,7,1,6,1,5,0
1327,Samuel Kalu,2,2,0,2,0,1,1,100.0,0,2,0,2,3,3,0
1328,Samuel Kalu,8,5,3,4,1,2,5,40.0,3,2,0,2,3,1,0
1329,Pierre Kalulu,61,36,36,21,4,17,22,77.3,5,36,15,21,26,54,0
1330,Daichi Kamada,40,21,7,26,7,11,40,27.5,29,18,0,18,8,10,0
1331,Boubacar Kamara,68,38,27,36,5,26,47,55.3,21,29,10,19,46,44,1
1332,Hassane Kamara,53,34,31,16,6,27,43,62.8,16,20,4,16,69,67,0
1333,Hassane Kamara,13,10,4,6,3,5,8,62.5,3,10,2,8,9,4,0
1334,Dimitrije Kamenović,1,1,1,0,0,1,1,100.0,0,0,0,0,2,1,0
1335,Kevin Kampl,41,19,16,20,5,10,42,23.8,32,24,5,19,24,17,0
1336,Jean-Armel Kana-Biyik,10,6,8,2,0,4,9,44.4,5,11,4,7,16,22,1
1337,Nordine Kandil,2,1,2,0,0,1,1,100.0,0,1,1,0,0,0,0
1338,Harry Kane,15,5,2,10,3,7,18,38.9,11,26,8,18,3,39,0
1339,Lee Kang-in,13,6,2,9,2,5,29,17.2,24,11,1,10,5,7,0
1340,N'Golo Kanté,59,31,20,27,12,25,40,62.5,15,37,2,35,31,8,0
1341,Stefanos Kapino,0,0,0,0,0,0,0,,0,0,0,0,0,0,0
1342,Atakan Karazor,48,24,18,27,3,18,36,50.0,18,37,14,23,34,47,0
1343,Rick Karsdorp,53,38,33,13,7,28,50,56.0,22,22,5,17,34,26,1
1344,Denso Kasius,9,7,5,3,1,2,5,40.0,3,4,0,4,3,4,0
1345,Grigoris Kastanos,30,19,9,19,2,7,23,30.4,16,21,5,16,22,8,0
1346,Silas Katompa,5,4,4,0,1,3,7,42.9,4,5,0,5,2,1,0
1347,Noah Katterbach,1,1,1,0,0,1,1,100.0,0,0,0,0,0,1,0
1348,Eiji Kawashima,0,0,0,0,0,0,0,,0,0,0,0,0,0,0
1349,Edo Kayembe,21,13,11,9,1,8,16,50.0,8,6,1,5,9,13,0
1350,Moise Kean,0,0,0,0,0,0,0,,0,0,0,0,0,0,0
1351,Moise Kean,9,4,2,5,2,6,16,37.5,10,5,0,5,3,8,1
1352,Michael Keane,46,25,32,13,1,28,45,62.2,17,33,28,5,62,128,2
1353,Ilan Kebbal,31,15,13,10,8,12,44,27.3,32,16,0,16,13,3,0
1354,Wajdi Kechrida,9,6,6,3,0,8,13,61.5,5,10,2,8,8,15,0
1355,Thilo Kehrer,21,14,9,11,1,9,21,42.9,12,19,11,8,24,29,0
1356,Habib Keita,0,0,0,0,0,0,0,,0,0,0,0,0,0,0
1357,Naby Keïta,46,23,17,19,10,26,42,61.9,16,33,2,31,14,8,0
1358,Yannik Keitel,11,4,5,4,2,5,15,33.3,10,7,1,6,1,8,0
1359,Caoimhín Kelleher,1,1,1,0,0,1,1,100.0,0,0,0,0,0,1,0
1360,Marc-Oliver Kempf,10,9,9,1,0,5,14,35.7,9,14,7,7,25,49,1
1361,Marc-Oliver Kempf,13,8,7,4,2,3,10,30.0,7,16,14,2,16,26,2
1362,Kenedy,5,2,1,2,2,2,3,66.7,1,0,0,0,0,0,0
1363,Jonjoe Kenny,17,7,11,6,0,13,21,61.9,8,8,1,7,20,31,0
1364,Dimitrios Keramitsis,0,0,0,0,0,0,0,,0,0,0,0,0,0,0
1365,Franck Kessié,41,23,12,24,5,17,26,65.4,9,39,10,29,23,22,0
1366,Saîf-Eddine Khaoui,19,10,5,10,4,9,18,50.0,9,9,0,9,14,5,0
1367,Wahbi Khazri,33,18,7,17,9,9,34,26.5,25,21,0,21,12,7,0
1368,Rani Khedira,75,38,25,42,8,32,66,48.5,34,21,8,13,50,27,1
1369,Kiké,11,7,3,4,4,3,23,13.0,20,10,1,9,3,12,0
1370,Luca Kilian,0,0,0,0,0,0,0,,0,0,0,0,0,0,0
1371,Luca Kilian,42,24,30,9,3,21,41,51.2,20,31,13,18,46,109,3
1372,Max Kilman,50,26,38,10,2,24,37,64.9,13,36,21,15,45,113,3
1373,Joshua Kimmich,39,20,14,17,8,18,58,31.0,40,34,8,26,52,29,1
1374,Presnel Kimpembe,34,19,18,15,1,14,23,60.9,9,20,14,6,38,73,1
1375,Joshua King,19,15,7,6,6,4,17,23.5,13,15,4,11,8,31,0
1376,Jakub Kiwior,50,27,25,19,6,26,57,45.6,31,38,15,23,40,53,0
1377,Sofian Kiyine,24,14,9,11,4,12,32,37.5,20,15,1,14,10,9,0
1378,Simon Kjær,20,12,9,8,3,6,12,50.0,6,17,13,4,9,39,0
1379,Kristoffer Klaesson,0,0,0,0,0,0,0,,0,0,0,0,0,0,0
1380,Philipp Klement,7,3,1,4,2,3,3,100.0,0,6,1,5,1,0,0
1381,Mateusz Klich,47,25,18,23,6,25,66,37.9,41,22,4,18,11,20,0
1382,Thibault Klidje,0,0,0,0,0,0,1,0.0,1,1,1,0,2,0,0
1383,Mateo Klimowicz,13,6,6,7,0,5,16,31.3,11,2,0,2,4,3,0
1384,Fabian Klos,7,5,0,5,2,2,10,20.0,8,17,4,13,0,31,0
1385,Lukas Klostermann,29,16,11,15,3,13,19,68.4,6,16,3,13,26,58,0
1386,Justin Kluivert,19,9,6,12,1,5,21,23.8,16,13,1,12,14,6,0
1387,Lukas Klünter,1,1,1,0,0,1,5,20.0,4,1,0,1,2,2,0
1388,Ansgar Knauff,3,1,1,1,1,0,4,0.0,4,2,0,2,0,4,0
1389,Ansgar Knauff,18,14,8,5,5,8,15,53.3,7,11,1,10,8,6,0
1390,Robin Knoche,50,24,38,12,0,30,53,56.6,23,45,26,19,49,151,1
1391,Gregor Kobel,0,0,0,0,0,0,2,0.0,2,0,0,0,1,20,0
1392,Robin Koch,21,13,9,10,2,9,34,26.5,25,26,10,16,20,44,0
1393,Samuel Koeberlé,0,0,0,0,0,0,0,,0,0,0,0,0,0,0
1394,Philippe Koffi,4,0,0,3,1,0,2,0.0,2,2,1,1,3,3,0
1395,Dominik Kohr,40,20,18,19,3,16,42,38.1,26,21,2,19,35,22,0
1396,Koba Koindredi,4,3,2,1,1,2,6,33.3,4,3,0,3,4,5,0
1397,Koke,55,30,19,29,7,26,63,41.3,37,21,5,16,24,31,1
1398,Aleksandr Kokorin,1,1,1,0,0,0,0,,0,1,0,1,0,0,0
1399,Aleksandar Kolarov,1,1,1,0,0,1,1,100.0,0,0,0,0,1,2,0
1400,Sead Kolašinac,0,0,0,0,0,0,0,,0,0,0,0,4,1,0
1401,Sead Kolašinac,7,6,2,3,2,5,8,62.5,3,4,0,4,0,7,1
1402,Luca Koleosho,0,0,0,0,0,0,0,,0,0,0,0,0,0,0
1403,Randal Kolo Muani,28,14,7,10,11,10,25,40.0,15,14,3,11,6,31,0
1404,Timothée Kolodziejczak,43,24,22,14,7,20,36,55.6,16,29,7,22,60,72,1
1405,Ghislain Konan,35,19,19,15,1,16,30,53.3,14,35,8,27,28,45,0
1406,Ibrahima Konaté,16,10,9,6,1,7,10,70.0,3,13,9,4,16,37,1
1407,Geoffrey Kondogbia,74,44,25,40,9,21,49,42.9,28,16,5,11,44,24,0
1408,Ibrahima Koné,7,4,0,3,4,2,3,66.7,1,8,3,5,1,3,0
1409,Manu Koné,60,37,29,28,3,25,42,59.5,17,27,4,23,34,12,0
1410,Youssouf Koné,30,18,21,8,1,19,30,63.3,11,8,3,5,10,25,0
1411,Ezri Konsa,25,15,13,11,1,10,13,76.9,3,31,22,9,15,86,2
1412,Teun Koopmeiners,40,24,10,19,11,22,54,40.7,32,31,2,29,15,19,0
1413,Laurent Koscielny,14,9,10,3,1,8,13,61.5,5,17,12,5,12,39,0
1414,Odilon Kossonou,23,17,16,6,1,15,25,60.0,10,36,14,22,26,66,0
1415,Filip Kostić,44,17,26,9,9,20,53,37.7,33,24,1,23,15,24,0
1416,Rominigue Kouamé,47,22,24,20,3,19,58,32.8,39,33,5,28,46,22,2
1417,Kalidou Koulibaly,39,23,31,6,2,25,38,65.8,13,41,25,16,29,90,1
1418,Jules Koundé,40,17,27,10,3,18,28,64.3,10,33,18,15,21,101,2
1419,Christos Kourfalidis,0,0,0,0,0,0,1,0.0,1,1,0,1,0,0,0
1420,Boubakar Kouyaté,84,50,56,28,0,48,77,62.3,29,63,33,30,79,217,3
1421,Cheikhou Kouyaté,52,38,28,22,2,18,39,46.2,21,40,14,26,38,39,0
1422,Mateo Kovačić,51,31,14,26,11,17,35,48.6,18,19,4,15,7,9,1
1423,Viktor Kovalenko,16,10,7,8,1,9,21,42.9,12,16,3,13,13,8,0
1424,Emil Krafth,37,16,25,11,1,27,36,75.0,9,16,10,6,25,56,0
1425,Alex Král,0,0,0,0,0,0,0,,0,0,0,0,0,0,0
1426,Andrej Kramarić,8,4,1,5,2,7,17,41.2,10,10,0,10,9,7,1
1427,Christoph Kramer,28,11,15,10,3,12,28,42.9,16,18,5,13,12,9,0
1428,Jean-Philippe Krasso,7,5,0,5,2,2,10,20.0,8,7,1,6,0,1,0
1429,Julian Kristoffersen,0,0,0,0,0,0,0,,0,0,0,0,0,0,0
1430,Toni Kroos,34,26,13,17,4,14,36,38.9,22,16,3,13,12,13,1
1431,Florian Krüger,3,1,0,3,0,2,10,20.0,8,12,1,11,2,13,0
1432,Tim Krul,1,1,1,0,0,1,4,25.0,3,0,0,0,0,10,4
1433,Rade Krunić,33,18,16,14,3,15,31,48.4,16,19,2,17,16,17,0
1434,Max Kruse,9,3,4,4,1,5,12,41.7,7,2,0,2,3,4,0
1435,Max Kruse,4,1,0,3,1,2,16,12.5,14,12,0,12,3,2,0
1436,Lukas Kübler,62,35,38,16,8,28,49,57.1,21,24,8,16,44,70,0
1437,Takefusa Kubo,31,19,12,14,5,10,24,41.7,14,24,3,21,8,4,0
1438,Juraj Kucka,59,39,32,25,2,27,73,37.0,46,30,9,21,27,46,2
1439,Mykola Kukharevych,0,0,0,0,0,0,0,,0,0,0,0,0,0,0
1440,Dejan Kulusevski,19,13,7,10,2,5,23,21.7,18,14,0,14,13,3,0
1441,Dejan Kulusevski,15,12,9,6,0,8,21,38.1,13,14,0,14,5,5,0
1442,Marash Kumbulla,21,13,13,7,1,8,15,53.3,7,17,8,9,16,26,0
1443,Fabian Kunze,35,21,14,20,1,15,32,46.9,17,17,2,15,19,27,1
1444,Enock Kwateng,54,35,31,19,4,33,72,45.8,39,17,4,13,43,48,1
1445,Grejohn Kyei,3,2,1,1,1,0,6,0.0,6,6,0,6,0,1,0
1446,Giorgos Kyriakopoulos,30,14,19,7,4,19,38,50.0,19,32,9,23,11,52,0
1447,Andrea La Mantia,2,0,0,0,2,1,2,50.0,1,3,1,2,1,6,0
1448,Gaëtan Laborde,2,2,1,1,0,2,4,50.0,2,3,0,3,5,5,0
1449,Gaëtan Laborde,19,7,5,8,6,3,22,13.6,19,29,3,26,8,16,0
1450,Alexandre Lacazette,27,10,8,13,6,7,21,33.3,14,12,1,11,5,6,0
1451,Tom Lacoux,18,13,11,5,2,9,24,37.5,15,14,4,10,9,20,1
1452,Lenny Lacroix,9,7,8,1,0,5,8,62.5,3,5,1,4,10,5,0
1453,Maxence Lacroix,59,33,41,16,2,29,40,72.5,11,35,16,19,60,144,0
1454,Alban Lafont,3,3,3,0,0,3,8,37.5,5,1,0,1,1,25,2
1455,Víctor Laguardia,29,16,21,8,0,19,30,63.3,11,36,24,12,27,151,1
1456,Konrad Laimer,38,24,11,22,5,24,53,45.3,29,29,3,26,4,9,0
1457,Stefan Lainer,19,11,9,7,3,12,28,42.9,16,24,5,19,14,31,0
1458,Diego Lainez,1,1,0,1,0,0,3,0.0,3,3,0,3,1,0,0
1459,Adam Lallana,34,17,14,14,6,12,41,29.3,29,16,6,10,16,13,1
1460,Vassilis Lambropoulos,18,12,13,3,2,11,25,44.0,14,21,10,11,17,56,0
1461,Érik Lamela,31,18,12,14,5,10,29,34.5,19,11,0,11,5,3,0
1462,Mohamed Lamine Bayo,12,5,4,3,5,3,24,12.5,21,7,1,6,7,14,0
1463,Didier Lamkel Zé,3,1,1,0,2,1,3,33.3,2,3,1,2,1,7,0
1464,Sam Lammers,1,0,0,0,1,0,0,,0,0,0,0,0,0,0
1465,Sam Lammers,4,4,0,2,2,2,6,33.3,4,9,2,7,2,4,0
1466,Tariq Lamptey,36,25,14,17,5,15,25,60.0,10,13,3,10,21,23,0
1467,Manuel Lanzini,28,15,10,11,7,10,35,28.6,25,16,0,16,19,10,0
1468,Aymeric Laporte,33,15,22,10,1,14,20,70.0,6,15,10,5,20,64,2
1469,Julien Laporte,63,45,35,26,2,32,64,50.0,32,37,22,15,54,174,0
1470,Yasser Larouci,6,5,2,4,0,3,3,100.0,0,1,0,1,7,5,0
1471,Kevin Lasagna,13,7,4,5,4,4,15,26.7,11,16,0,16,3,7,0
1472,Jamaal Lascelles,15,7,9,5,1,4,12,33.3,8,38,28,10,22,121,1
1473,Bryan Lasme,6,6,1,2,3,0,3,0.0,3,7,0,7,1,9,0
1474,Paul Lasne,26,12,6,16,4,8,18,44.4,10,11,2,9,24,10,0
1475,Juanmi Latasa,0,0,0,0,0,0,0,,0,0,0,0,0,0,0
1476,Toni Lato,17,12,12,3,2,9,16,56.3,7,6,0,6,8,14,0
1477,Armand Lauriente,33,18,9,16,8,11,30,36.7,19,27,2,25,15,3,0
1478,Darko Lazović,36,23,20,8,8,21,39,53.8,18,28,4,24,19,49,1
1479,Manuel Lazzari,28,14,13,15,0,16,26,61.5,10,10,2,8,12,16,1
1480,Théo Le Bris,2,1,1,1,0,1,2,50.0,1,2,0,2,0,1,0
1481,Jérémy Le Douaron,11,5,4,4,3,1,17,5.9,16,15,0,15,4,14,0
1482,Enzo Le Fée,70,44,25,36,9,41,90,45.6,49,25,1,24,29,18,0
1483,Vincent Le Goff,61,38,38,19,4,37,62,59.7,25,18,3,15,37,50,0
1484,Maxime Le Marchand,17,8,16,1,0,8,10,80.0,2,9,5,4,14,32,0
1485,Robin Le Normand,49,32,36,8,5,28,36,77.8,8,34,22,12,48,125,0
1486,Patrick Leal,0,0,0,0,0,0,1,0.0,1,0,0,0,0,0,0
1487,Rafael Leão,17,7,3,9,5,10,20,50.0,10,12,1,11,12,8,0
1488,Jean-Louis Leca,0,0,0,0,0,0,0,,0,1,0,1,1,11,1
1489,Jeremías Ledesma,3,1,3,0,0,3,4,75.0,1,0,0,0,1,21,4
1490,Pierre Lees-Melou,58,36,23,29,6,25,92,27.2,67,37,11,26,25,23,0
1491,Wu Lei,3,2,1,2,0,3,8,37.5,5,4,0,4,4,3,0
1492,Maxim Leitsch,18,10,9,7,2,10,15,66.7,5,31,19,12,31,74,1
1493,Lucas Leiva,55,30,26,25,4,15,53,28.3,38,27,10,17,28,37,0
1494,Florian Lejeune,33,24,22,10,1,12,20,60.0,8,30,19,11,31,158,0
1495,Iñigo Lekue,32,23,16,12,4,22,44,50.0,22,37,12,25,23,63,0
1496,Thomas Lemar,24,14,9,12,3,8,23,34.8,15,18,0,18,8,11,0
1497,Félix Lemaréchal,0,0,0,0,0,0,1,0.0,1,0,0,0,0,0,0
1498,Mario Lemina,62,35,25,33,4,28,38,73.7,10,32,9,23,48,37,0
1499,Fabien Lemoine,35,22,20,14,1,17,41,41.5,24,21,4,17,14,24,1
1500,Tim Lemperle,4,1,2,1,1,1,3,33.3,2,1,0,1,2,2,0
1501,Ruben Lendinez,3,3,1,2,0,3,8,37.5,5,4,0,4,2,6,0
1502,Clément Lenglet,20,11,11,7,2,8,13,61.5,5,7,3,4,13,21,0
1503,Aaron Lennon,33,17,10,13,10,10,34,29.4,24,26,4,22,9,14,0
1504,Bernd Leno,1,1,1,0,0,1,1,100.0,0,0,0,0,0,1,0
1505,Christopher Lenz,29,15,22,6,1,12,21,57.1,9,9,4,5,7,21,0
1506,Léo Leroy,31,21,17,11,3,12,34,35.3,22,20,4,16,8,8,0
1507,Alexandre Letellier,0,0,0,0,0,0,0,,0,0,0,0,0,0,0
1508,Robert Lewandowski,10,3,0,6,4,5,17,29.4,12,17,2,15,6,8,0
1509,Jamie Leweling,13,8,3,7,3,3,16,18.8,13,9,0,9,13,5,0
1510,Jamal Lewis,8,6,6,1,1,3,4,75.0,1,3,2,1,3,8,0
1511,Luca Lezzerini,0,0,0,0,0,0,0,,0,1,0,1,0,0,0
1512,Ben Lhassine Kone,3,3,1,2,0,1,2,50.0,1,0,0,0,1,1,0
1513,Yanis Lhery,0,0,0,0,0,0,0,,0,4,0,4,0,0,0
1514,Dimitri Liénard,71,43,40,21,10,46,77,59.7,31,12,0,12,21,28,0
1515,Philipp Lienhart,24,13,17,6,1,13,24,54.2,11,33,23,10,50,158,1
1516,Matthijs de Ligt,34,19,21,13,0,15,18,83.3,3,31,21,10,26,103,0
1517,Isaac Lihadji,3,3,1,1,1,1,5,20.0,4,1,0,1,2,0,0
1518,Anderson Lima,2,0,1,1,0,0,2,0.0,2,1,0,1,2,1,0
1519,Andreas Linde,0,0,0,0,0,0,0,,0,0,0,0,1,1,1
1520,Victor Lindelöf,16,11,9,7,0,9,14,64.3,5,26,17,9,25,96,0
1521,Jesper Lindstrøm,28,13,6,13,9,12,36,33.3,24,30,0,30,24,11,1
1522,Karol Linetty,14,8,3,4,7,6,18,33.3,12,8,0,8,3,2,0
1523,Jesse Lingard,9,7,4,3,2,2,6,33.3,4,4,0,4,0,1,0
1524,Pol Lirola,28,16,15,9,4,13,28,46.4,15,15,0,15,13,22,0
1525,Valentino Livramento,54,28,30,18,6,27,45,60.0,18,23,9,14,47,50,1
1526,Dejan Ljubicic,33,19,12,13,8,13,49,26.5,36,19,1,18,15,11,0
1527,Javier Llabrés,2,1,0,1,1,1,2,50.0,1,1,0,1,0,0,0
1528,Diego Llorente,53,31,32,19,2,33,47,70.2,14,35,17,18,40,77,2
1529,Marcos Llorente,51,23,25,22,4,28,43,65.1,15,33,10,23,27,44,0
1530,Hugo Lloris,1,1,1,0,0,1,2,50.0,1,0,0,0,1,24,3
1531,Giovani Lo Celso,8,4,4,2,2,4,10,40.0,6,6,1,5,1,0,1
1532,Giovani Lo Celso,22,12,8,10,4,9,22,40.9,13,4,0,4,5,3,0
1533,Julen Lobete,4,3,3,0,1,1,2,50.0,1,6,1,5,1,1,0
1534,Stanislav Lobotka,39,24,16,20,3,14,36,38.9,22,9,1,8,12,13,1
1535,Jürgen Locadia,0,0,0,0,0,0,0,,0,0,0,0,0,0,0
1536,Jürgen Locadia,4,2,1,0,3,1,1,100.0,0,1,0,1,1,2,0
1537,Manuel Locatelli,44,25,21,16,7,21,47,44.7,26,43,21,22,22,33,0
1538,Bradley Locko,28,19,13,11,4,14,24,58.3,10,20,8,12,14,15,0
1539,Renan Lodi,31,18,14,13,4,11,27,40.7,16,22,4,18,13,19,1
1540,Ruben Loftus-Cheek,29,10,16,11,2,10,19,52.6,9,15,6,9,11,17,0
1541,Kevin Long,3,2,1,2,0,1,2,50.0,1,4,1,3,1,20,0
1542,Shane Long,9,5,2,4,3,1,1,100.0,0,4,0,4,0,2,0
1543,Sean Longstaff,54,34,18,31,5,24,65,36.9,41,18,6,12,9,18,0
1544,Ademola Lookman,32,14,10,13,9,10,28,35.7,18,19,1,18,10,4,0
1545,Anthony Lopes,0,0,0,0,0,0,0,,0,0,0,0,3,12,3
1546,David López,18,13,9,8,1,9,16,56.3,7,10,8,2,10,25,2
1547,Diego López,0,0,0,0,0,0,2,0.0,2,0,0,0,1,21,1
1548,Javi López,8,6,6,2,0,4,6,66.7,2,7,1,6,4,15,0
1549,Maxime Lopez,69,36,40,27,2,35,87,40.2,52,33,7,26,42,38,1
1550,Pau López,0,0,0,0,0,0,1,0.0,1,0,0,0,0,12,1
1551,Unai López,19,9,6,10,3,10,33,30.3,23,7,0,7,10,8,1
1552,Dion Lopy,53,29,22,24,7,21,53,39.6,32,20,4,16,22,17,0
1553,Samuel Loric,7,5,2,3,2,5,8,62.5,3,2,0,2,5,9,0
1554,Anthony Losilla,65,39,29,30,6,34,69,49.3,35,32,9,23,70,53,1
1555,Jonas Lössl,0,0,0,0,0,0,0,,0,0,0,0,0,1,0
1556,Marcel Lotka,1,0,1,0,0,1,1,100.0,0,0,0,0,1,3,3
1557,Jordan Lotomba,33,17,21,9,3,16,30,53.3,14,17,4,13,12,28,0
1558,Johaneko Louisjean,0,0,0,0,0,0,0,,0,0,0,0,0,0,0
1559,Mamadou Loum,49,22,26,22,1,17,45,37.8,28,30,11,19,37,68,1
1560,Imran Louza,41,21,18,20,3,16,38,42.1,22,28,6,22,42,20,1
1561,Matteo Lovato,5,4,4,1,0,0,1,0.0,1,4,2,2,7,8,0
1562,Matteo Lovato,23,15,13,10,0,8,20,40.0,12,21,10,11,28,43,0
1563,Eduard Löwen,28,22,12,11,5,10,43,23.3,33,17,2,15,9,15,1
1564,Matthew Lowton,38,24,20,10,8,20,37,54.1,17,25,11,14,26,68,0
1565,Anthony Lozano,8,4,2,3,3,5,18,27.8,13,16,2,14,2,7,0
1566,Hirving Lozano,28,20,12,11,5,8,30,26.7,22,24,0,24,9,9,0
1567,Jean Lucas,43,25,14,24,5,17,40,42.5,23,15,5,10,13,4,1
1568,Anderson Lucoqui,22,10,11,6,5,11,22,50.0,11,15,3,12,11,10,0
1569,Florentino Luís,42,25,22,17,3,17,35,48.6,18,21,2,19,21,11,1
1570,José Luis Gayà,35,21,24,10,1,16,34,47.1,18,17,3,14,19,37,0
1571,José Luis Morales,27,17,6,9,12,12,42,28.6,30,29,0,29,4,7,0
1572,José Luis Palomino,78,40,42,33,3,32,50,64.0,18,43,21,22,100,80,2
1573,Luismi,0,0,0,0,0,0,0,,0,0,0,0,0,0,0
1574,Douglas Luiz,59,39,30,24,5,21,72,29.2,51,30,7,23,34,28,1
1575,Romelu Lukaku,2,1,0,1,1,1,5,20.0,4,11,1,10,0,20,0
1576,Castello Lukeba,34,19,27,7,0,15,23,65.2,8,18,9,9,38,64,2
1577,Dodi Lukebakio,2,1,2,0,0,1,3,33.3,2,2,0,2,2,0,0
1578,Dodi Lukebakio,7,4,3,2,2,1,10,10.0,9,5,0,5,13,4,0
1579,Saša Lukić,51,34,17,27,7,19,43,44.2,24,34,6,28,24,41,0
1580,Levi Lumeka,0,0,0,0,0,0,2,0.0,2,0,0,0,0,2,0
1581,Andriy Lunin,0,0,0,0,0,0,0,,0,0,0,0,0,2,0
1582,Andrey Lunyov,0,0,0,0,0,0,0,,0,0,0,0,0,0,0
1583,Sebastiano Luperto,29,17,17,10,2,10,20,50.0,10,32,26,6,45,132,0
1584,Andreas Luthe,0,0,0,0,0,0,1,0.0,1,0,0,0,0,11,4
1585,Lyanco,18,15,11,7,0,10,18,55.6,8,18,13,5,13,50,1
1586,Charalambos Lykogiannis,19,12,16,1,2,11,20,55.0,9,18,8,10,31,73,0
1587,Yannis M'Bemba,0,0,0,0,0,0,0,,0,0,0,0,0,1,0
1588,Alexis Mac Allister,65,40,23,30,12,29,68,42.6,39,37,7,30,13,22,0
1589,Deiver Machado,16,14,11,1,4,12,14,85.7,2,9,1,8,3,12,1
1590,Darwin Machís,23,13,11,8,4,9,23,39.1,14,10,0,10,15,17,0
1591,Yvann Macon,41,22,24,14,3,16,42,38.1,26,18,4,14,18,27,0
1592,James Maddison,40,20,8,24,8,14,46,30.4,32,18,3,15,11,12,0
1593,Niki Mäenpää,0,0,0,0,0,0,0,,0,0,0,0,0,8,2
1594,Pablo Maffeo,84,47,48,28,8,38,69,55.1,31,30,13,17,46,74,0
1595,Louis Mafouta,0,0,0,0,0,0,5,0.0,5,1,0,1,0,4,0
1596,Gabriel Magalhães,50,30,36,12,2,30,41,73.2,11,34,26,8,13,112,4
1597,Giulio Maggiore,58,32,20,32,6,31,77,40.3,46,30,5,25,29,33,0
1598,Matej Maglica,0,0,0,0,0,0,1,0.0,1,0,0,0,0,0,0
1599,Francesco Magnanelli,5,4,4,1,0,1,9,11.1,8,3,1,2,1,3,0
1600,Giangiacomo Magnani,10,7,5,5,0,8,16,50.0,8,5,3,2,10,46,0
1601,Giangiacomo Magnani,4,2,4,0,0,1,1,100.0,0,2,2,0,7,12,0
1602,Hugo Magnetti,50,34,27,20,3,22,50,44.0,28,14,3,11,25,13,0
1603,Yohann Magnin,53,31,22,26,5,24,42,57.1,18,17,7,10,20,36,0
1604,Harry Maguire,34,21,22,8,4,19,31,61.3,12,36,29,7,32,101,3
1605,Riyad Mahrez,11,3,5,4,2,5,19,26.3,14,15,1,14,6,6,0
1606,Arne Maier,20,13,6,10,4,8,26,30.8,18,18,1,17,15,13,0
1607,Habib Maïga,47,28,29,13,5,24,48,50.0,24,20,7,13,14,18,0
1608,Mike Maignan,2,1,2,0,0,2,2,100.0,0,0,0,0,1,4,2
1609,Ainsley Maitland-Niles,8,4,5,3,0,2,4,50.0,2,2,0,2,4,4,0
1610,Ainsley Maitland-Niles,8,6,5,0,3,5,14,35.7,9,7,0,7,6,7,0
1611,Josh Maja,0,0,0,0,0,0,0,,0,1,0,1,0,0,0
1612,Abdul Majeed Waris,5,3,2,3,0,5,10,50.0,5,2,0,2,0,1,0
1613,Lovro Majer,32,21,9,14,9,11,42,26.2,31,26,2,24,11,9,0
1614,Jean-Victor Makengo,30,21,7,17,6,15,29,51.7,14,26,6,20,19,17,0
1615,Béni Makouana,2,2,0,0,2,0,1,0.0,1,1,0,1,3,2,0
1616,Nemanja Maksimović,56,32,24,26,6,18,49,36.7,31,42,13,29,71,41,0
1617,Nikola Maksimović,14,6,10,4,0,7,9,77.8,2,17,11,6,12,61,1
1618,Kévin Malcuit,4,2,4,0,0,2,2,100.0,0,3,0,3,8,6,0
1619,Daniel Maldini,8,3,4,3,1,2,6,33.3,4,4,0,4,1,0,0
1620,Youssef Maleh,27,16,8,13,6,12,25,48.0,13,14,1,13,6,2,0
1621,Donyell Malen,13,10,4,5,4,7,13,53.8,6,10,0,10,10,11,0
1622,Ruslan Malinovskyi,18,10,3,10,5,5,19,26.3,14,27,3,24,5,1,0
1623,Hugo Mallo,45,25,24,19,2,16,31,51.6,15,23,9,14,20,53,0
1624,Lennard Maloney,1,0,1,0,0,1,1,100.0,0,0,0,0,0,0,0
1625,Mickael Malsa,37,17,16,18,3,15,42,35.7,27,20,8,12,18,15,0
1626,Giorgi Mamardashvili,0,0,0,0,0,0,0,,0,0,0,0,0,6,1
1627,Rey Manaj,19,12,3,11,5,6,26,23.1,20,16,0,16,4,13,0
1628,Hianga Mananga Mbock,18,12,8,7,3,9,21,42.9,12,5,2,3,5,6,0
1629,Vincent Manceau,32,19,18,13,1,14,37,37.8,23,23,6,17,32,72,0
1630,Gianluca Mancini,41,25,22,18,1,18,33,54.5,15,38,19,19,39,69,0
1631,Leonardo Mancuso,1,1,0,1,0,0,6,0.0,6,2,0,2,1,2,0
1632,Steve Mandanda,0,0,0,0,0,0,1,0.0,1,1,0,1,1,4,1
1633,Reinildo Mandava,45,25,30,14,1,22,30,73.3,8,18,9,9,21,38,0
1634,Reinildo Mandava,43,23,29,11,3,32,51,62.7,19,13,4,9,37,55,0
1635,Aïssa Mandi,11,5,2,8,1,3,6,50.0,3,17,14,3,13,49,3
1636,Rolando Mandragora,21,10,3,16,2,12,21,57.1,9,18,4,14,10,13,0
1637,Anthony Mandrea,0,0,0,0,0,0,0,,0,0,0,0,0,9,0
1638,Sadio Mané,33,20,7,14,12,8,26,30.8,18,30,1,29,8,15,0
1639,Eliaquim Mangala,17,12,12,5,0,8,12,66.7,4,11,8,3,17,61,1
1640,Orel Mangala,17,10,5,7,5,11,22,50.0,11,11,4,7,12,19,1
1641,Thomas Mangani,58,30,23,34,1,31,68,45.6,37,38,11,27,36,29,0
1642,Ricardo Mangas,35,22,22,8,5,26,41,63.4,15,18,4,14,25,47,3
1643,Kostas Manolas,2,2,1,1,0,2,3,66.7,1,2,1,1,4,10,1
1644,Javier Manquillo,39,29,28,10,1,21,36,58.3,15,15,6,9,10,32,0
1645,Myziane Maolida,1,0,0,1,0,0,0,,0,1,0,1,0,0,0
1646,Myziane Maolida,7,4,5,1,1,3,9,33.3,6,5,0,5,1,6,0
1647,Sekou Mara,8,4,1,1,6,1,8,12.5,7,7,0,7,2,6,0
1648,Nikola Maraš,13,9,12,1,0,9,15,60.0,6,17,13,4,15,51,0
1649,Fernando Marçal,42,22,27,14,1,21,37,56.8,16,25,4,21,28,52,0
1650,Marcelo,8,4,2,3,3,5,10,50.0,5,7,2,5,1,11,0
1651,Marcelo,9,5,7,2,0,4,6,66.7,2,4,3,1,13,46,1
1652,Marcelo,4,3,0,4,0,4,6,66.7,2,3,2,1,4,10,0
1653,Solly March,30,17,11,9,10,7,22,31.8,15,22,3,19,17,25,0
1654,Riccardo Marchizza,21,15,11,8,2,11,16,68.8,5,15,6,9,10,24,0
1655,Gian Marco Ferrari,16,11,10,6,0,10,23,43.5,13,37,27,10,43,114,2
1656,Iván Marcone,24,14,17,6,1,12,24,50.0,12,8,3,5,12,13,0
1657,Óscar de Marcos,50,37,24,19,7,28,43,65.1,15,20,3,17,19,27,0
1658,Davide Marfella,0,0,0,0,0,0,0,,0,0,0,0,0,0,0
1659,José Mari,14,7,3,10,1,7,8,87.5,1,4,1,3,7,2,0
1660,Pablo Marí,5,3,1,3,1,3,6,50.0,3,5,4,1,3,10,0
1661,Pablo Marí,16,8,8,6,2,8,16,50.0,8,18,12,6,21,72,0
1662,José María Giménez,18,12,12,6,0,8,16,50.0,8,25,19,6,25,96,1
1663,Mariano,2,0,2,0,0,0,0,,0,2,0,2,1,3,0
1664,Răzvan Marin,42,21,16,22,4,24,54,44.4,30,23,5,18,10,17,1
1665,Guillermo Maripán,36,24,27,9,0,20,40,50.0,20,21,14,7,25,66,1
1666,Mika Màrmol,0,0,0,0,0,0,0,,0,0,0,0,0,0,0
1667,Omar Marmoush,0,0,0,0,0,0,0,,0,0,0,0,0,0,0
1668,Omar Marmoush,26,17,6,14,6,4,20,20.0,16,9,1,8,7,6,0
1669,Marquinhos,37,14,25,11,1,20,35,57.1,15,35,19,16,16,102,0
1670,Roger Martí,23,14,3,13,7,8,30,26.7,22,14,0,14,2,8,0
1671,Anthony Martial,0,0,0,0,0,0,1,0.0,1,1,0,1,0,1,0
1672,Anthony Martial,2,1,0,0,2,2,6,33.3,4,4,0,4,0,3,0
1673,Martín,2,2,0,2,0,0,0,,0,1,0,1,1,3,0
1674,Aarón Martín,54,33,32,18,4,24,55,43.6,31,24,4,20,20,35,0
1675,Ander Martin,1,0,0,1,0,1,1,100.0,0,0,0,0,3,1,0
1676,Andrés Martín,0,0,0,0,0,0,1,0.0,1,1,0,1,0,0,0
1677,Carlos Martín,0,0,0,0,0,0,0,,0,0,0,0,0,1,0
1678,Iván Martín,1,1,1,0,0,0,1,0.0,1,2,0,2,1,1,0
1679,Jonas Martin,35,20,12,21,2,19,53,35.8,34,17,3,14,22,28,1
1680,Gabriel Martinelli,27,19,7,14,6,10,29,34.5,19,26,1,25,20,15,0
1681,Emiliano Martínez,1,1,1,0,0,1,3,33.3,2,0,0,0,0,6,1
1682,Iñigo Martínez,28,13,18,7,3,14,23,60.9,9,22,10,12,39,143,0
1683,Javi Martínez,21,14,8,11,2,10,29,34.5,19,6,0,6,9,10,0
1684,Josep Martinez,0,0,0,0,0,0,0,,0,0,0,0,0,0,0
1685,Lautaro Martínez,20,10,3,10,7,6,11,54.5,5,21,1,20,18,6,0
1686,Pablo Martínez,15,8,7,8,0,4,13,30.8,9,6,3,3,15,5,0
1687,Lucas Martínez Quarta,36,25,23,11,2,21,34,61.8,13,22,9,13,19,46,0
1688,Gelson Martins,42,27,10,26,6,21,59,35.6,38,26,1,25,17,4,0
1689,Adam Marušić,30,18,16,12,2,13,32,40.6,19,19,8,11,41,71,0
1690,Omar Mascarell,46,26,16,23,7,24,60,40.0,36,42,14,28,48,52,2
1691,Andrea Masiello,5,3,4,1,0,4,7,57.1,3,8,4,4,11,20,1
1692,Adam Masina,24,13,11,10,3,12,29,41.4,17,18,6,12,18,45,0
1693,Erhan Mašović,35,20,21,13,1,21,33,63.6,12,28,19,9,34,64,1
1694,Roberto Massimo,14,5,6,7,1,4,16,25.0,12,9,0,9,3,6,0
1695,Arthur Masuaku,31,23,19,11,1,14,23,60.9,9,9,1,8,9,17,0
1696,Jaime Mata,7,5,3,1,3,1,9,11.1,8,4,1,3,1,5,0
1697,Juan Mata,6,4,2,3,1,3,5,60.0,2,1,0,1,1,1,0
1698,Pape Matar Sarr,45,26,21,23,1,18,39,46.2,21,33,3,30,29,22,0
1699,Eliot Matazo,8,7,4,4,0,2,11,18.2,9,11,3,8,13,9,0
1700,Aleš Matějů,16,12,10,5,1,13,29,44.8,16,10,6,4,9,15,0
1701,Jean-Philippe Mateta,8,4,2,5,1,3,18,16.7,15,11,3,8,4,13,0
1702,Nemanja Matić,31,18,19,11,1,15,31,48.4,16,21,6,15,31,21,3
1703,Joël Matip,47,34,23,19,5,20,31,64.5,11,26,14,12,44,93,1
1704,Chrislain Matsima,3,2,1,2,0,2,7,28.6,5,3,3,0,1,6,1
1705,Azor Matusiwa,58,32,28,26,4,26,55,47.3,29,49,19,30,62,43,0
1706,Neal Maupay,17,10,2,6,9,4,18,22.2,14,21,2,19,2,2,0
1707,Stephy Mavididi,24,13,11,7,6,14,39,35.9,25,23,2,21,8,11,0
1708,Konstantinos Mavropanos,57,39,35,21,1,30,51,58.8,21,46,23,23,69,174,2
1709,Eric Maxim Choupo-Moting,10,9,3,6,1,3,10,30.0,7,1,0,1,5,2,0
1710,Luís Maximiano,3,1,3,0,0,3,6,50.0,3,0,0,0,1,16,2
1711,Borja Mayoral,0,0,0,0,0,0,0,,0,0,0,0,0,0,0
1712,Borja Mayoral,7,5,2,3,2,1,2,50.0,1,10,4,6,4,3,0
1713,Derek Mazou-Sacko,1,0,0,0,1,1,1,100.0,0,0,0,0,0,1,0
1714,Pasquale Mazzocchi,18,8,11,4,3,10,26,38.5,16,11,8,3,21,31,1
1715,Pasquale Mazzocchi,28,19,15,11,2,14,34,41.2,20,5,0,5,11,31,0
1716,Kevin Mbabu,31,20,21,5,5,12,23,52.2,11,25,8,17,35,35,0
1717,Kylian Mbappé,11,8,1,4,6,7,13,53.8,6,6,0,6,5,13,0
1718,Ibrahima Mbaye,1,1,1,0,0,1,2,50.0,1,1,1,0,1,6,0
1719,Amadou Mbengue,19,10,10,9,0,11,22,50.0,11,7,2,5,10,19,0
1720,Bryan Mbeumo,28,16,1,12,15,6,20,30.0,14,21,6,15,11,20,0
1721,Jason Mbock,0,0,0,0,0,0,0,,0,0,0,0,0,0,0
1722,Jordi Mboula,8,2,3,3,2,5,9,55.6,4,7,1,6,3,3,0
1723,Moustapha Mbow,6,6,3,2,1,3,3,100.0,0,0,0,0,1,6,0
1724,Nathanael Mbuku,14,13,4,7,3,2,8,25.0,6,14,0,14,11,4,0
1725,James McArthur,33,23,13,19,1,16,44,36.4,28,23,9,14,30,27,0
1726,James Mcatee,0,0,0,0,0,0,2,0.0,2,0,0,0,0,0,0
1727,Kasey McAteer,0,0,0,0,0,0,0,,0,0,0,0,0,0,0
1728,Liam McCarron,0,0,0,0,0,0,0,,0,1,0,1,0,0,0
1729,Alex McCarthy,0,0,0,0,0,0,0,,0,0,0,0,0,4,0
1730,John McGinn,106,64,35,55,16,54,104,51.9,50,53,6,47,35,34,0
1731,Weston McKennie,20,11,11,7,2,8,26,30.8,18,17,8,9,23,20,0
1732,Stuart McKinstry,0,0,0,0,0,0,0,,0,0,0,0,0,0,0
1733,Kenny McLean,42,22,18,20,4,17,59,28.8,42,29,7,22,34,54,0
1734,Dwight McNeil,78,49,27,38,13,33,73,45.2,40,64,11,53,35,31,1
1735,Scott McTominay,65,33,32,24,9,30,61,49.2,31,45,10,35,31,60,1
1736,Gary Medel,39,23,27,11,1,16,36,44.4,20,30,21,9,44,112,0
1737,Facundo Medina,61,42,34,23,4,38,62,61.3,24,24,8,16,37,78,3
1738,Nathan de Medina,17,10,11,6,0,6,10,60.0,4,14,3,11,10,28,0
1739,Ben Mee,26,12,16,7,3,12,19,63.2,7,28,22,6,24,94,1
1740,Admir Mehmedi,0,0,0,0,0,0,0,,0,0,0,0,0,0,0
1741,Hannibal Mejbri,2,1,1,1,0,1,1,100.0,0,0,0,0,0,0,0
1742,Farid El Melali,0,0,0,0,0,0,1,0.0,1,1,0,1,0,1,0
1743,Filippo Melegoni,20,12,5,8,7,8,16,50.0,8,10,1,9,11,8,1
1744,Óscar Melendo,11,5,4,4,3,3,13,23.1,10,4,1,3,1,10,0
1745,Gonzalo Melero,29,16,10,15,4,16,36,44.4,20,21,8,13,7,22,0
1746,Birger Meling,43,27,25,11,7,23,31,74.2,8,23,7,16,22,40,0
1747,Arthur Melo,25,12,10,14,1,13,24,54.2,11,11,2,9,7,8,1
1748,Memphis,10,4,2,4,4,3,13,23.1,10,9,1,8,3,4,0
1749,Houboulang Mendes,58,28,37,18,3,40,57,70.2,17,41,21,20,41,128,4
1750,Nuno Mendes,48,29,23,18,7,25,47,53.2,22,27,5,22,21,17,1
1751,Pedro Mendes,1,1,1,0,0,0,0,,0,1,1,0,0,2,0
1752,Thiago Mendes,36,22,18,16,2,12,30,40.0,18,24,5,19,34,56,1
1753,Tomás Mendes,0,0,0,0,0,0,0,,0,0,0,0,0,1,0
1754,Brais Méndez,68,35,24,35,9,26,87,29.9,61,52,6,46,37,30,0
1755,Édgar Méndez,25,14,11,10,4,11,34,32.4,23,16,0,16,4,17,0
1756,Arial Mendy,6,4,4,2,0,2,11,18.2,9,6,1,5,7,17,0
1757,Batista Mendy,49,28,21,22,6,23,45,51.1,22,37,6,31,34,40,0
1758,Benjamin Mendy,2,2,1,1,0,2,6,33.3,4,0,0,0,0,0,0
1759,Edouard Mendy,1,0,1,0,0,1,3,33.3,2,0,0,0,0,13,4
1760,Ferland Mendy,24,14,11,10,3,8,14,57.1,6,8,2,6,18,27,3
1761,Nampalys Mendy,12,6,8,4,0,6,17,35.3,11,7,4,3,11,11,1
1762,Gideon Mensah,37,24,19,12,6,18,38,47.4,20,11,2,9,16,21,0
1763,Jorge Meré,9,6,3,6,0,4,7,57.1,3,6,4,2,10,19,0
1764,Alex Meret,0,0,0,0,0,0,0,,0,0,0,0,0,3,1
1765,Fran Mérida,7,3,5,2,0,4,10,40.0,6,1,0,1,6,1,0
1766,Mikel Merino,71,38,21,40,10,26,67,38.8,41,50,10,40,21,56,2
1767,Quentin Merlin,45,28,19,20,6,26,49,53.1,23,25,4,21,27,29,2
1768,Martín Merquelanz,2,1,2,0,0,2,6,33.3,4,2,0,2,0,1,0
1769,Yıldırım Mert Çetin,1,0,1,0,0,1,1,100.0,0,0,0,0,0,2,0
1770,Dries Mertens,16,7,1,11,4,3,16,18.8,13,8,2,6,9,2,0
1771,Illan Meslier,1,1,1,0,0,1,1,100.0,0,0,0,0,0,27,1
1772,Lionel Messi,10,3,1,5,4,3,13,23.1,10,5,0,5,4,0,0
1773,Junior Messias,34,18,11,14,9,15,34,44.1,19,11,1,10,17,17,0
1774,Thomas Meunier,29,19,13,12,4,16,33,48.5,17,10,2,8,12,25,1
1775,Mexer,14,10,11,3,0,11,17,64.7,6,12,7,5,21,60,2
1776,Marco Meyerhöfer,53,35,22,22,9,24,37,64.9,13,38,19,19,47,64,1
1777,Matt Miazga,7,7,3,4,0,2,7,28.6,5,14,12,2,11,55,1
1778,Kingsley Michael,4,1,2,2,0,1,2,50.0,1,2,1,1,1,1,1
1779,Sven Michel,10,6,5,3,2,2,8,25.0,6,3,0,3,1,1,0
1780,Edouard Michut,0,0,0,0,0,0,2,0.0,2,2,0,2,1,2,0
1781,Miguel,7,3,1,5,1,2,15,13.3,13,6,0,6,1,7,0
1782,Valentin Mihaila,1,1,0,1,0,0,1,0.0,1,2,0,2,0,0,0
1783,Mikael,1,1,0,1,0,0,0,,0,0,0,0,0,1,0
1784,Hilmir Mikaelsson,2,0,0,1,1,0,0,,0,0,0,0,0,0,0
1785,Georges Mikautadze,0,0,0,0,0,0,0,,0,0,0,0,0,0,0
1786,William Mikelbrencis,11,5,6,4,1,6,9,66.7,3,6,3,3,5,9,0
1787,Nikola Milenković,54,32,31,20,3,29,34,85.3,5,30,15,15,39,94,0
1788,Arkadiusz Milik,9,2,0,5,4,4,18,22.2,14,9,1,8,3,10,1
1789,Sergej Milinković-Savić,67,44,20,32,15,29,67,43.3,38,50,9,41,34,43,1
1790,Vanja Milinković-Savić,0,0,0,0,0,0,1,0.0,1,0,0,0,0,7,2
1791,Éder Militão,50,32,30,12,8,20,39,51.3,19,42,20,22,52,107,3
1792,Luka Milivojević,18,9,9,6,3,10,16,62.5,6,6,1,5,11,15,0
1793,Luis Milla,59,29,25,30,4,25,64,39.1,39,28,4,24,25,34,0
1794,Pere Milla,20,15,14,5,1,8,44,18.2,36,21,1,20,5,21,0
1795,Enzo Millot,2,0,0,2,0,0,1,0.0,1,0,0,0,1,1,0
1796,James Milner,28,16,12,11,5,12,29,41.4,17,19,5,14,17,20,0
1797,Santi Mina,27,17,8,15,4,5,32,15.6,27,28,2,26,6,22,0
1798,Yerry Mina,12,10,12,0,0,10,13,76.9,3,13,9,4,11,38,1
1799,Takumi Minamino,3,2,1,1,1,2,8,25.0,6,2,0,2,1,2,0
1800,Tyrone Mings,23,12,17,3,3,14,22,63.6,8,47,30,17,46,153,2
1801,Óscar Mingueza,25,11,12,11,2,16,23,69.6,7,5,0,5,9,22,1
1802,Rafa Mir,4,3,1,1,2,0,11,0.0,11,4,3,1,0,17,0
1803,Jorge Miramón,36,19,16,12,8,15,44,34.1,29,15,3,12,35,58,0
1804,Aleksei Miranchuk,11,7,3,7,1,4,12,33.3,8,3,0,3,1,7,0
1805,Juan Miranda,21,11,16,4,1,12,22,54.5,10,10,4,6,15,22,0
1806,Fabio Miretti,4,2,2,2,0,2,9,22.2,7,3,1,2,2,3,0
1807,Tyrick Mitchell,104,57,67,26,11,46,67,68.7,21,47,5,42,41,101,0
1808,Stefan Mitrović,16,8,12,4,0,8,13,61.5,5,28,18,10,22,114,1
1809,Maximilian Mittelstädt,52,33,30,12,10,26,50,52.0,24,28,5,23,46,37,0
1810,Henrikh Mkhitaryan,45,29,11,27,7,17,52,32.7,35,33,2,31,22,33,0
1811,Jakub Moder,42,25,18,17,7,23,42,54.8,19,25,2,23,10,22,1
1812,Anthony Modeste,10,6,4,5,1,3,18,16.7,15,11,2,9,4,29,0
1813,Marco Modolo,6,3,4,2,0,2,5,40.0,3,6,6,0,4,26,0
1814,Luka Modrić,18,10,8,7,3,6,27,22.2,21,10,4,6,20,9,0
1815,Terem Moffi,17,10,3,12,2,9,32,28.1,23,11,2,9,4,22,0
1816,Kevin Möhwald,7,1,3,3,1,1,7,14.3,6,3,0,3,3,6,0
1817,Dion Moise Sahi,0,0,0,0,0,0,0,,0,1,0,1,1,1,0
1818,Johan Mojica,46,25,34,7,5,23,31,74.2,8,22,3,19,25,61,3
1819,Clinton Mola,3,1,2,1,0,2,4,50.0,2,5,5,0,3,2,0
1820,Jorge Molina,4,2,2,1,1,2,18,11.1,16,13,2,11,6,11,0
1821,Nahuel Molina,41,24,17,21,3,16,48,33.3,32,24,3,21,22,44,2
1822,Cristian Molinaro,12,9,10,2,0,5,7,71.4,2,7,2,5,6,20,0
1823,Florent Mollet,31,22,14,12,5,14,57,24.6,43,27,4,23,24,13,0
1824,Jon Moncayola,40,20,18,18,4,17,44,38.6,27,26,9,17,20,43,0
1825,Monchu,15,6,5,9,1,5,10,50.0,5,8,3,5,4,4,0
1826,Thomas Monconduit,41,25,19,17,5,20,57,35.1,37,21,10,11,22,51,1
1827,Gonzalo Montiel,15,4,8,5,2,12,24,50.0,12,8,2,6,10,22,0
1828,Lorenzo Montipò,0,0,0,0,0,0,0,,0,0,0,0,1,16,3
1829,Ángel Montoro,26,13,16,7,3,17,27,63.0,10,11,1,10,11,29,1
1830,Martín Montoya,20,12,11,7,2,15,26,57.7,11,6,0,6,11,20,0
1831,Wesley Moraes,0,0,0,0,0,0,0,,0,0,0,0,0,0,0
1832,Álvaro Morata,18,9,4,9,5,8,31,25.8,23,26,1,25,5,24,0
1833,Jan Morávek,11,6,3,7,1,6,18,33.3,12,11,2,9,6,8,0
1834,Jon Morcillo,3,0,1,2,0,3,4,75.0,1,1,0,1,0,0,0
1835,Jérémy Morel,13,9,8,4,1,6,6,100.0,0,9,7,2,7,31,0
1836,Alberto Moreno,13,7,5,7,1,5,18,27.8,13,13,1,12,27,15,0
1837,Álex Moreno,76,40,53,15,8,33,60,55.0,27,28,6,22,34,82,1
1838,Gerard Moreno,5,2,2,2,1,1,7,14.3,6,6,1,5,6,14,0
1839,Tete Morente,21,14,13,7,1,7,28,25.0,21,30,1,29,12,12,0
1840,Ilaix Moriba,26,18,10,13,3,14,35,40.0,21,15,0,15,12,14,0
1841,Ilaix Moriba,0,0,0,0,0,0,4,0.0,4,2,0,2,1,0,0
1842,Manu Morlanes,36,15,16,17,3,18,43,41.9,25,24,5,19,13,17,0
1843,Raúl Moro,3,3,0,2,1,1,5,20.0,4,2,0,2,0,0,0
1844,Loren Morón,6,4,1,3,2,0,12,0.0,12,11,1,10,2,9,0
1845,Loren Morón,1,1,1,0,0,1,1,100.0,0,0,0,0,0,0,0
1846,Tyler Morton,0,0,0,0,0,0,2,0.0,2,0,0,0,3,0,0
1847,Cristhian Mosquera,4,2,3,0,1,3,6,50.0,3,1,0,1,3,1,1
1848,Lebo Mothiba,8,4,4,3,1,2,5,40.0,3,3,0,3,2,0,0
1849,Lebo Mothiba,0,0,0,0,0,0,0,,0,0,0,0,0,0,0
1850,Andrei Motoc,1,1,0,1,0,0,0,,0,2,2,0,2,1,0
1851,Baptiste Mouazan,4,3,2,2,0,1,3,33.3,2,3,0,3,1,1,0
1852,Aimen Moueffek,7,4,2,3,2,2,8,25.0,6,3,0,3,2,4,0
1853,Youssoufa Moukoko,1,0,0,1,0,0,1,0.0,1,5,0,5,3,0,0
1854,Harold Moukoudi,25,12,17,8,0,14,25,56.0,11,27,14,13,35,48,0
1855,Jessy Moulin,0,0,0,0,0,0,0,,0,0,0,0,1,7,0
1856,Steve Mounié,17,6,3,12,2,4,27,14.8,23,13,1,12,6,12,0
1857,Mason Mount,41,16,10,17,14,10,34,29.4,24,18,1,17,13,12,0
1858,Lucas Moura,25,10,7,14,4,8,35,22.9,27,19,0,19,18,19,0
1859,Lys Mousset,1,0,0,1,0,0,0,,0,2,0,2,0,0,0
1860,João Moutinho,74,39,34,27,13,30,106,28.3,76,48,8,40,34,36,2
1861,Samuel Moutoussamy,48,32,20,20,8,23,62,37.1,39,14,2,12,17,16,0
1862,Toni Moya,23,10,7,13,3,13,43,30.2,30,18,5,13,20,18,0
1863,Samuel Mráz,0,0,0,0,0,0,0,,0,1,0,1,0,0,0
1864,Nordi Mukiele,35,22,23,9,3,14,27,51.9,13,31,5,26,31,44,2
1865,Mert Müldür,52,35,43,7,2,27,49,55.1,22,25,6,19,24,44,1
1866,Florian Müller,0,0,0,0,0,0,1,0.0,1,1,0,1,0,13,2
1867,Thomas Müller,35,20,7,16,12,16,54,29.6,38,32,1,31,15,12,0
1868,Bali Mumba,1,1,1,0,0,0,0,,0,0,0,0,0,5,0
1869,Marshall Munetsi,34,17,21,11,2,17,39,43.6,22,39,13,26,43,72,2
1870,Iker Muniain,32,10,8,19,5,12,40,30.0,28,20,1,19,17,8,1
1871,Aihen Muñoz,28,17,14,13,1,18,29,62.1,11,11,1,10,17,34,0
1872,Luis Muriel,15,4,2,7,6,3,19,15.8,16,12,0,12,4,5,0
1873,Jeison Murillo,15,10,13,2,0,9,13,69.2,4,11,8,3,17,37,0
1874,Vedat Muriqi,1,0,1,0,0,0,5,0.0,5,0,0,0,0,2,0
1875,Vedat Muriqi,6,3,1,3,2,1,7,14.3,6,12,0,12,6,29,0
1876,Jacob Murphy,49,26,34,11,4,26,41,63.4,15,20,2,18,23,17,0
1877,Nicola Murru,22,17,10,11,1,8,13,61.5,5,17,3,14,7,20,1
1878,Yunus Musah,23,13,8,8,7,6,20,30.0,14,19,1,18,14,11,0
1879,Torben Müsel,0,0,0,0,0,0,0,,0,0,0,0,0,0,0
1880,Jamal Musiala,40,26,11,16,13,15,36,41.7,21,25,0,25,19,2,1
1881,Juan Musso,1,1,1,0,0,0,0,,0,0,0,0,0,17,1
1882,Shkodran Mustafi,9,6,6,3,0,5,9,55.6,4,6,3,3,15,40,0
1883,Junior Mwanga,5,2,4,1,0,3,3,100.0,0,1,0,1,0,1,0
1884,Enock Mwepu,22,12,10,10,2,5,27,18.5,22,20,2,18,12,19,0
1885,Vitaliy Mykolenko,25,15,15,7,3,12,21,57.1,9,15,2,13,16,37,0
1886,Joakim Mæhle,21,11,6,9,6,12,27,44.4,15,18,2,16,14,13,0
1887,Obite N'Dicka,60,34,29,27,4,44,59,74.6,15,46,20,26,48,137,0
1888,Kévin N'Doram,10,8,3,5,2,3,20,15.0,17,24,5,19,19,21,0
1889,Eric N'Jo,0,0,0,0,0,0,1,0.0,1,1,1,0,2,1,0
1890,Vital N'Simba,66,45,38,23,5,36,63,57.1,27,28,7,21,29,30,0
1891,Nacho,18,14,9,9,0,12,22,54.5,10,22,15,7,34,50,0
1892,Mickael Nade,57,35,37,18,2,23,38,60.5,15,29,15,14,60,84,0
1893,Marvelous Nakamba,32,19,18,14,0,12,34,35.3,22,14,4,10,12,17,1
1894,Nahitan Nández,39,21,16,15,8,18,33,54.5,15,16,1,15,9,15,1
1895,Nani,2,1,1,1,0,0,1,0.0,1,1,0,1,2,0,1
1896,Paul Nardi,1,0,1,0,0,1,2,50.0,1,0,0,0,0,10,2
1897,Nikolas Nartey,6,3,0,5,1,3,9,33.3,6,4,2,2,7,5,0
1898,Matija Nastasić,1,1,1,0,0,1,1,100.0,0,1,1,0,5,11,0
1899,Roberto Navarro,5,3,1,1,3,3,5,60.0,2,2,0,2,2,2,0
1900,Ximo Navarro,28,19,21,6,1,13,27,48.1,14,11,5,6,22,56,2
1901,Jesús Navas,18,13,11,5,2,9,17,52.9,8,15,2,13,17,26,1
1902,Keylor Navas,0,0,0,0,0,0,0,,0,0,0,0,0,5,1
1903,Papa Ndiaga Yade,15,10,8,7,0,8,18,44.4,10,4,1,3,10,9,0
1904,Wilfred Ndidi,60,32,32,27,1,22,55,40.0,33,36,8,28,42,54,1
1905,Tanguy Ndombele,10,7,3,5,2,1,8,12.5,7,5,0,5,1,1,0
1906,Tanguy Ndombele,25,14,5,17,3,12,19,63.2,7,8,3,5,3,6,2
1907,Dan Ndoye,0,0,0,0,0,0,2,0.0,2,4,0,4,0,0,0
1908,Paul Nebel,5,3,3,1,1,2,3,66.7,1,0,0,0,0,1,0
1909,Álvaro Negredo,5,3,1,4,0,3,6,50.0,3,11,5,6,2,23,0
1910,Reiss Nelson,1,0,0,0,1,0,1,0.0,1,1,0,1,0,0,0
1911,David Nemeth,3,2,2,1,0,1,3,33.3,2,5,1,4,6,11,1
1912,Ilija Nestorovski,0,0,0,0,0,0,3,0.0,3,0,0,0,0,4,0
1913,Neto,0,0,0,0,0,0,0,,0,0,0,0,0,2,1
1914,Pedro Neto,4,4,2,0,2,0,9,0.0,9,0,0,0,6,1,0
1915,Luca Netz,24,11,12,10,2,11,40,27.5,29,24,4,20,13,33,1
1916,Manuel Neuer,2,1,2,0,0,1,2,50.0,1,0,0,0,0,7,1
1917,Florian Neuhaus,55,28,24,26,5,27,64,42.2,37,38,6,32,31,19,4
1918,Carlos Neva,31,19,24,7,0,16,28,57.1,12,27,9,18,32,81,0
1919,Rúben Neves,68,37,23,41,4,24,87,27.6,63,39,5,34,41,49,3
1920,Neymar,29,19,5,12,12,12,36,33.3,24,9,1,8,4,2,1
1921,Yvan Neyou,29,13,14,12,3,9,27,33.3,18,8,3,5,23,13,0
1922,Jeremy Ngakia,31,18,23,5,3,11,26,42.3,15,11,4,7,12,32,0
1923,Jessic Ngankam,3,1,1,1,1,1,2,50.0,1,3,0,3,0,1,0
1924,Opa Nguette,21,14,9,6,6,5,14,35.7,9,13,3,10,2,9,0
1925,Aurélien Nguiamba,3,2,1,2,0,2,3,66.7,1,2,1,1,0,1,0
1926,Sikou Niakaté,8,7,8,0,0,4,11,36.4,7,5,3,2,27,34,0
1927,Moussa Niakhate,40,23,25,13,2,20,33,60.6,13,37,11,26,50,69,1
1928,Ibrahima Niane,1,1,0,1,0,0,5,0.0,5,6,1,5,3,16,0
1929,M'Baye Niang,4,0,0,2,2,0,4,0.0,4,9,1,8,1,4,0
1930,Tanguy Nianzou,11,7,7,3,1,7,11,63.6,4,7,2,5,7,17,0
1931,Cheikh Niasse,2,2,0,2,0,2,3,66.7,1,1,1,0,1,2,0
1932,Florian Niederlechner,6,5,1,3,2,4,13,30.8,9,9,0,9,4,7,0
1933,Håvard Nielsen,17,12,5,11,1,8,21,38.1,13,18,1,17,7,22,0
1934,Saúl Ñíguez,20,9,11,9,0,9,16,56.3,7,14,3,11,7,10,1
1935,Saúl Ñíguez,7,2,0,6,1,3,4,75.0,1,7,1,6,0,3,0
1936,Dimitris Nikolaou,39,26,29,7,3,22,34,64.7,12,48,24,24,49,132,1
1937,Joakim Nilsson,37,19,24,13,0,20,26,76.9,6,36,23,13,56,143,1
1938,Casimir Ninga,5,1,1,4,0,2,5,40.0,3,2,0,2,1,0,0
1939,Fernando Niño,10,4,3,2,5,2,12,16.7,10,9,2,7,3,15,0
1940,Eddie Nketiah,9,4,1,4,4,1,4,25.0,3,9,2,7,4,5,0
1941,Nicolas Nkoulou,1,0,0,1,0,0,0,,0,2,1,1,2,8,0
1942,Christopher Nkunku,23,10,10,11,2,9,35,25.7,26,23,2,21,15,15,0
1943,Felix Nmecha,3,1,1,1,1,0,2,0.0,2,2,0,2,7,6,0
1944,Lukas Nmecha,12,5,5,5,2,5,19,26.3,14,9,1,8,4,10,0
1945,Mark Noble,8,2,7,1,0,5,11,45.5,6,4,1,3,4,2,1
1946,Peru Nolaskoain,0,0,0,0,0,0,0,,0,0,0,0,0,0,0
1947,Nolito,25,15,14,7,4,13,47,27.7,34,20,1,19,9,5,0
1948,Arnaud Nordin,21,11,8,8,5,8,22,36.4,14,19,0,19,6,8,0
1949,Håvard Nordtveit,7,6,2,4,1,4,4,100.0,0,2,1,1,10,11,0
1950,Mathias Normann,34,21,19,14,1,17,46,37.0,29,17,8,9,19,43,1
1951,Connor Noß,1,0,0,1,0,0,1,0.0,1,1,1,0,0,0,0
1952,Hugo Novoa,4,4,2,0,2,2,7,28.6,5,2,0,2,1,0,0
1953,Soma Novothny,1,1,1,0,0,0,1,0.0,1,1,0,1,0,2,0
1954,Jean-Pierre Nsame,1,1,0,0,1,0,0,,0,0,0,0,0,1,0
1955,Randy Nteka,24,13,9,11,4,8,19,42.1,11,21,1,20,8,12,0
1956,Alexander Nübel,0,0,0,0,0,0,1,0.0,1,0,0,0,0,11,1
1957,Kasim Nuhu,0,0,0,0,0,0,1,0.0,1,0,0,0,0,1,0
1958,Unai Núñez,4,4,2,2,0,3,6,50.0,3,9,8,1,8,26,2
1959,Hans Nunoo Sarpei,16,11,9,7,0,10,14,71.4,4,8,5,3,14,21,0
1960,Bram Nuytinck,38,24,24,13,1,15,34,44.1,19,42,31,11,22,101,0
1961,Simeon Nwankwo,5,5,0,4,1,4,10,40.0,6,8,3,5,3,10,0
1962,Gerzino Nyamsi,35,21,24,9,2,20,27,74.1,7,25,16,9,25,90,1
1963,Allan Nyom,3,1,2,1,0,2,2,100.0,0,2,1,1,2,7,0
1964,M'Bala Nzola,2,2,0,0,2,1,6,16.7,5,8,0,8,0,13,0
1965,Christian Nørgaard,109,60,42,58,9,52,101,51.5,49,48,9,39,64,58,1
1966,Adam Obert,8,5,6,2,0,5,6,83.3,1,6,4,2,4,11,0
1967,Joel Obi,23,14,5,14,4,5,12,41.7,7,17,6,11,10,7,0
1968,Jan Oblak,0,0,0,0,0,0,0,,0,0,0,0,1,10,4
1969,Lucas Ocampos,45,24,23,18,4,23,55,41.8,32,35,1,34,9,24,1
1970,Bastian Oczipka,24,15,15,7,2,10,13,76.9,3,10,2,8,12,21,0
1971,Brian Oddei,0,0,0,0,0,0,0,,0,0,0,0,0,0,0
1972,Álvaro Odriozola,25,15,12,6,7,15,32,46.9,17,17,6,11,8,25,2
1973,Angelo Ogbonna,7,4,5,2,0,3,7,42.9,4,5,4,1,11,29,0
1974,Florent Ogier,31,17,18,12,1,17,31,54.8,14,41,27,14,37,89,0
1975,Stefano Okaka,0,0,0,0,0,0,0,,0,2,0,2,0,1,0
1976,David Okereke,16,10,4,9,3,3,20,15.0,17,19,3,16,10,20,0
1977,Masaya Okugawa,46,25,18,22,6,12,37,32.4,25,29,1,28,20,13,0
1978,Lucas Olaza,5,3,3,1,1,1,1,100.0,0,5,1,4,4,6,0
1979,Oier Olazábal,0,0,0,0,0,0,0,,0,0,0,0,0,0,0
1980,Mathias Olesen,0,0,0,0,0,0,0,,0,0,0,0,1,0,0
1981,Michael Olise,22,18,8,11,3,7,24,29.2,17,17,0,17,6,6,0
1982,Christian Oliva,2,2,2,0,0,1,4,25.0,3,0,0,0,0,0,0
1983,Brian Oliván,33,20,22,9,2,12,23,52.2,11,17,7,10,28,63,0
1984,Sérgio Oliveira,27,14,11,14,2,15,30,50.0,15,13,0,13,10,7,0
1985,Mathías Olivera,79,47,39,34,6,40,69,58.0,29,45,4,41,55,67,1
1986,Dani Olmo,14,6,5,7,2,5,18,27.8,13,5,1,4,4,1,0
1987,Robin Olsen,0,0,0,0,0,0,0,,0,0,0,0,0,0,0
1988,Warmed Omari,33,17,22,10,1,15,23,65.2,8,20,13,7,31,94,5
1989,Jonas Omlin,2,1,2,0,0,2,3,66.7,1,0,0,0,0,12,3
1990,Andrew Omobamidele,8,6,5,3,0,5,11,45.5,6,8,8,0,5,13,0
1991,Amadou Onana,48,31,17,27,4,18,25,72.0,7,10,3,7,30,19,0
1992,Jean Onana,70,49,33,33,4,35,86,40.7,51,37,5,32,36,23,1
1993,Karim Onisiwo,18,10,4,6,8,7,22,31.8,15,27,2,25,7,8,0
1994,Javier Ontiveros,0,0,0,0,0,0,2,0.0,2,0,0,0,1,0,1
1995,Tyler Onyango,0,0,0,0,0,0,0,,0,0,0,0,0,1,0
1996,Frank Onyeka,25,17,13,9,3,8,27,29.6,19,16,2,14,14,13,0
1997,Willi Orban,32,22,20,11,1,13,25,52.0,12,40,24,16,44,123,2
1998,Divock Origi,0,0,0,0,0,0,2,0.0,2,1,0,1,1,2,0
1999,Riccardo Orsolini,21,13,9,11,1,13,29,44.8,16,9,4,5,5,14,0
2000,Stefan Ortega,1,0,1,0,0,1,2,50.0,1,2,0,2,0,5,1
2001,Pedro Ortiz,0,0,0,0,0,0,0,,0,0,0,0,0,1,0
2002,Victor Osimhen,10,5,1,2,7,2,6,33.3,4,16,3,13,3,17,0
2003,Milutin Osmajić,1,1,0,1,0,0,0,,0,0,0,0,1,3,0
2004,David Ospina,0,0,0,0,0,0,0,,0,0,0,0,1,11,1
2005,Patrick Osterhage,9,6,3,5,1,3,7,42.9,4,7,1,6,11,8,0
2006,Tomáš Ostrák,1,0,0,0,1,1,3,33.3,2,0,0,0,1,0,0
2007,Otávio,36,23,13,21,2,16,39,41.0,23,9,3,6,18,11,0
2008,Paulo Otávio,14,10,7,4,3,8,15,53.3,7,11,6,5,4,9,0
2009,Dango Ouattara,21,15,9,11,1,11,23,47.8,12,10,1,9,14,15,1
2010,Remi Oudin,34,18,19,13,2,18,32,56.3,14,14,3,11,27,21,0
2011,Alexandre Oukidja,0,0,0,0,0,0,1,0.0,1,1,0,1,1,17,2
2012,Azzedine Ounahi,39,22,16,22,1,11,40,27.5,29,19,1,18,26,13,0
2013,Adam Ounas,6,1,0,3,3,3,7,42.9,4,3,0,3,2,3,0
2014,Jesús Owono,0,0,0,0,0,0,0,,0,0,0,0,0,1,0
2015,Reece Oxford,27,14,16,9,2,15,31,48.4,16,42,33,9,72,172,1
2016,Alex Oxlade-Chamberlain,15,11,2,8,5,3,14,21.4,11,12,2,10,6,5,0
2017,Mikel Oyarzabal,18,10,7,7,4,7,21,33.3,14,18,2,16,10,16,1
2018,Ambroise Oyongo,13,4,7,4,2,9,15,60.0,6,5,1,4,6,17,0
2019,Salih Özcan,42,30,14,23,5,22,51,43.1,29,37,5,32,51,35,1
2020,Levin Öztunalı,14,11,6,5,3,7,17,41.2,10,3,0,3,4,12,0
2021,Fernando Pacheco,2,1,2,0,0,2,2,100.0,0,0,0,0,0,18,1
2022,Jon Pacheco,6,4,4,2,0,3,3,100.0,0,6,4,2,6,18,0
2023,Gonçalo Paciência,4,2,2,1,1,1,3,33.3,2,2,0,2,1,4,0
2024,Daniele Padelli,0,0,0,0,0,0,0,,0,0,0,0,0,2,1
2025,Simone Pafundi,0,0,0,0,0,0,1,0.0,1,0,0,0,0,0,0
2026,Vincent Pajot,86,56,35,47,4,20,46,43.5,26,33,6,27,51,38,0
2027,Exequiel Palacios,30,19,12,14,4,15,38,39.5,23,20,1,19,28,11,2
2028,Helibelton Palacios,69,38,56,10,3,37,55,67.3,18,21,8,13,18,61,0
2029,Isaac Palazón Camacho,42,28,20,19,3,18,59,30.5,41,31,3,28,13,22,0
2030,Nicolas Pallois,51,33,40,11,0,34,59,57.6,25,40,19,21,53,116,1
2031,Cole Palmer,2,1,1,1,0,0,2,0.0,2,3,0,3,1,0,0
2032,Erik Palmer-Brown,37,22,29,8,0,20,26,76.9,6,26,18,8,34,87,1
2033,Emerson Palmieri,0,0,0,0,0,0,0,,0,0,0,0,0,0,0
2034,Emerson Palmieri,46,25,16,22,8,22,34,64.7,12,23,8,15,27,66,0
2035,Martin Palumbo,0,0,0,0,0,0,1,0.0,1,0,0,0,0,0,0
2036,Goran Pandev,2,0,1,0,1,0,9,0.0,9,3,1,2,2,0,0
2037,Ivor Pandur,0,0,0,0,0,0,0,,0,0,0,0,0,2,0
2038,Miloš Pantović,19,10,8,7,4,6,25,24.0,19,26,4,22,18,14,0
2039,Antonios Papadopoulos,0,0,0,0,0,0,0,,0,1,0,1,0,0,0
2040,Matondo-Merveille Papela,3,2,2,1,0,2,3,66.7,1,2,0,2,2,0,0
2041,Lucas Paquetá,68,38,24,26,18,17,51,33.3,34,43,5,38,9,22,0
2042,Rubén Pardo,0,0,0,0,0,0,0,,0,0,0,0,0,0,0
2043,Kevin Paredes,1,0,0,0,1,0,0,,0,1,0,1,0,0,0
2044,Leandro Paredes,23,13,9,11,3,12,24,50.0,12,10,6,4,10,5,2
2045,Daniel Parejo,43,29,15,15,13,20,52,38.5,32,32,7,25,29,19,1
2046,Fabiano Parisi,35,19,25,5,5,13,31,41.9,18,30,10,20,22,42,0
2047,Raúl Parra,2,1,2,0,0,1,3,33.3,2,0,0,0,0,5,0
2048,Thomas Partey,43,29,22,17,4,18,44,40.9,26,22,4,18,23,35,2
2049,Mario Pašalić,27,12,8,13,6,12,30,40.0,18,27,6,21,20,14,0
2050,Felix Passlack,13,9,8,4,1,6,12,50.0,6,5,1,4,4,7,0
2051,Javier Pastore,7,3,3,2,2,3,12,25.0,9,5,1,4,4,2,0
2052,Patric,21,15,17,4,0,9,20,45.0,11,22,11,11,12,44,2
2053,Rui Patrício,0,0,0,0,0,0,0,,0,1,0,1,0,10,3
2054,Paulinho,22,13,6,13,3,13,27,48.1,14,14,1,13,6,7,0
2055,Gabriel Paulista,21,12,16,5,0,14,20,70.0,6,18,12,6,39,88,0
2056,Benjamin Pavard,35,20,21,13,1,19,29,65.5,10,28,16,12,36,50,1
2057,Strahinja Pavlović,23,16,8,13,2,8,12,66.7,4,5,3,2,9,15,0
2058,Leonardo Pavoletti,10,6,2,5,3,3,9,33.3,6,9,5,4,2,12,0
2059,Dimitri Payet,16,8,4,10,2,7,31,22.6,24,9,0,9,9,3,0
2060,Mads Pedersen,28,21,8,15,5,12,27,44.4,15,13,4,9,15,30,0
2061,Alfonso Pedraza,34,16,17,12,5,10,28,35.7,18,12,3,9,31,32,0
2062,Pedri,20,12,9,8,3,7,20,35.0,13,13,0,13,5,7,1
2063,Pedro,36,23,8,19,9,16,47,34.0,31,18,2,16,6,8,0
2064,João Pedro,15,12,2,8,5,4,18,22.2,14,23,5,18,8,18,1
2065,Adrià Pedrosa,58,30,38,14,6,26,57,45.6,31,25,7,18,25,92,2
2066,Gianluca Pegolo,0,0,0,0,0,0,0,,0,0,0,0,0,0,1
2067,Peter Pekarík,45,29,33,11,1,32,46,69.6,14,28,10,18,29,58,0
2068,Pietro Pellegri,1,1,0,1,0,0,4,0.0,4,0,0,0,0,5,0
2069,Pietro Pellegri,2,2,0,1,1,0,1,0.0,1,0,0,0,0,1,0
2070,Lorenzo Pellegrini,35,14,10,17,8,16,60,26.7,44,29,1,28,27,20,0
2071,Luca Pellegrini,23,10,13,5,5,12,19,63.2,7,9,1,8,5,23,0
2072,Facundo Pellistri,9,5,4,3,2,1,10,10.0,9,13,2,11,6,7,0
2073,Federico Peluso,1,1,0,1,0,1,1,100.0,0,0,0,0,0,0,0
2074,Timothee Pembele,20,8,8,10,2,10,29,34.5,19,12,3,9,16,24,0
2075,Rubén Peña,2,0,1,1,0,2,6,33.3,4,1,0,1,5,2,0
2076,Philipp Pentke,0,0,0,0,0,0,0,,0,0,0,0,0,0,0
2077,Nicolas Pépé,8,5,3,5,0,3,9,33.3,6,9,1,8,8,2,0
2078,Ricardo Pepi,4,2,1,3,0,1,8,12.5,7,7,0,7,3,8,0
2079,Alberto Perea,19,9,7,9,3,6,20,30.0,14,15,1,14,9,4,0
2080,Brayann Pereira,1,1,1,0,0,1,1,100.0,0,0,0,0,0,1,0
2081,Danilo Pereira,33,17,10,20,3,14,28,50.0,14,19,10,9,37,29,1
2082,Mathias Pereira Lage,21,7,10,7,4,8,30,26.7,22,18,7,11,21,22,0
2083,Ricardo Pereira,37,20,19,13,5,21,40,52.5,19,13,1,12,17,39,0
2084,Gastón Pereiro,13,5,7,4,2,5,18,27.8,13,12,1,11,1,8,0
2085,Luan Peres Petroni,65,35,33,25,7,36,52,69.2,16,26,12,14,43,64,1
2086,Dor Peretz,27,18,8,16,3,13,25,52.0,12,8,4,4,8,11,0
2087,Roberto Pereyra,18,12,7,6,5,7,23,30.4,16,26,5,21,12,11,0
2088,Ayoze Pérez,4,2,0,3,1,0,13,0.0,13,11,1,10,2,5,0
2089,Carles Pérez,8,3,3,1,4,3,12,25.0,9,10,0,10,2,2,0
2090,Iñigo Pérez,3,2,2,1,0,2,4,50.0,2,1,0,1,0,3,0
2091,Juan Pérez,0,0,0,0,0,0,1,0.0,1,0,0,0,0,1,1
2092,Kike Pérez,8,6,1,3,4,0,10,0.0,10,6,1,5,3,4,0
2093,Lucas Pérez,4,1,2,1,1,3,10,30.0,7,2,0,2,3,4,0
2094,Lucas Pérez,3,3,2,1,0,0,10,0.0,10,3,1,2,0,1,0
2095,Nehuén Pérez,44,21,21,21,2,16,25,64.0,9,27,9,18,21,47,0
2096,Mattia Perin,0,0,0,0,0,0,0,,0,0,0,0,0,3,0
2097,Ivan Perišić,38,22,18,11,9,28,50,56.0,22,39,7,32,47,42,0
2098,Sonny Perkins,0,0,0,0,0,0,0,,0,0,0,0,0,0,0
2099,Diego Perotti,11,5,7,1,3,4,13,30.8,9,1,0,1,2,6,0
2100,Romain Perraud,34,22,18,14,2,16,29,55.2,13,24,6,18,17,42,0
2101,Lucas Perrin,43,32,24,17,2,26,45,57.8,19,28,11,17,42,67,0
2102,Mario Perrone,0,0,0,0,0,0,0,,0,0,0,0,0,0,0
2103,Pavao Pervan,0,0,0,0,0,0,0,,0,0,0,0,0,3,0
2104,Matteo Pessina,27,14,10,11,6,14,33,42.4,19,22,3,19,13,7,0
2105,Andrea Petagna,3,3,0,3,0,1,4,25.0,3,1,0,1,0,5,0
2106,Nils Petersen,5,3,2,3,0,1,13,7.7,12,7,0,7,2,17,0
2107,Danijel Petković,0,0,0,0,0,0,1,0.0,1,0,0,0,1,9,5
2108,Léo Pétrot,31,17,23,8,0,21,29,72.4,8,33,17,16,22,86,0
2109,Njegoš Petrović,24,11,4,19,1,8,14,57.1,6,16,4,12,9,11,0
2110,Jens Petter Hauge,14,5,6,7,1,7,23,30.4,16,7,0,7,3,5,0
2111,Alex Petxa,12,9,4,7,1,4,8,50.0,4,8,2,6,4,6,0
2112,Germán Pezzella,21,9,16,5,0,16,29,55.2,13,29,18,11,39,106,0
2113,Giuseppe Pezzella,28,13,15,7,6,8,18,44.4,10,13,5,8,9,16,0
2114,Immanuel Pherai,0,0,0,0,0,0,0,,0,0,0,0,0,0,0
2115,Maximilian Philipp,15,11,6,7,2,5,21,23.8,16,12,1,11,4,5,0
2116,Romain Philippoteaux,1,1,0,1,0,0,0,,0,0,0,0,0,0,0
2117,Kalvin Phillips,54,25,24,25,5,24,57,42.1,33,37,9,28,24,18,0
2118,Jaden Philogene Bidace,0,0,0,0,0,0,0,,0,0,0,0,0,0,0
2119,Jérôme Phojo,0,0,0,0,0,0,0,,0,0,0,0,0,1,0
2120,Krzysztof Piątek,5,4,1,1,3,2,3,66.7,1,6,0,6,2,8,0
2121,Krzysztof Piątek,2,2,0,1,1,0,1,0.0,1,0,0,0,0,6,0
2122,Pablo Piatti,9,4,5,3,1,3,8,37.5,5,5,1,4,2,3,0
2123,Cristiano Piccini,14,8,9,5,0,5,7,71.4,2,3,2,1,1,11,0
2124,Roberto Piccoli,1,1,0,1,0,0,0,,0,0,0,0,1,1,1
2125,Roberto Piccoli,2,0,0,0,2,0,2,0.0,2,1,0,1,0,0,0
2126,Jordan Pickford,1,1,1,0,0,0,1,0.0,1,1,0,1,1,14,1
2127,Jérémy Pied,0,0,0,0,0,0,0,,0,0,0,0,1,0,0
2128,Amos Pieper,58,29,38,19,1,32,51,62.7,19,37,23,14,50,132,1
2129,Ronaël Pierre-Gabriel,79,45,52,21,6,42,73,57.5,31,22,7,15,48,74,0
2130,Erik Pieters,28,15,15,11,2,17,28,60.7,11,18,7,11,10,38,0
2131,Tomás Pina Isla,28,16,13,11,4,14,29,48.3,15,12,3,9,22,23,0
2132,Andrea Pinamonti,11,6,0,7,4,2,18,11.1,16,24,3,21,7,23,0
2133,Orbelín Pineda,4,1,4,0,0,1,2,50.0,1,0,0,0,0,1,0
2134,Ethan Pinnock,51,35,37,12,2,25,38,65.8,13,30,11,19,44,154,1
2135,Yeremi Pino,32,14,14,8,10,10,24,41.7,14,33,4,29,6,12,1
2136,Carlo Pinsoglio,0,0,0,0,0,0,0,,0,0,0,0,0,0,0
2137,Riccardo Pinzi,0,0,0,0,0,0,0,,0,0,0,0,0,0,0
2138,Gerard Piqué,22,12,18,4,0,11,14,78.6,3,19,16,3,34,86,1
2139,Marko Pjaca,7,4,1,4,2,3,8,37.5,5,10,2,8,4,2,0
2140,Marvin Plattenhardt,25,11,18,6,1,15,27,55.6,12,18,3,15,17,52,0
2141,Alassane Pléa,18,14,6,9,3,7,20,35.0,13,9,1,8,4,9,0
2142,Tommaso Pobega,48,30,17,20,11,21,40,52.5,19,32,3,29,25,38,0
2143,Daniel Podence,18,11,10,5,3,4,17,23.5,13,8,1,7,10,1,0
2144,Suf Podgoreanu,2,0,1,1,0,1,4,25.0,3,2,0,2,1,3,0
2145,Paul Pogba,13,9,5,7,1,6,28,21.4,22,11,0,11,13,16,0
2146,Joel Pohjanpalo,0,0,0,0,0,0,0,,0,0,0,0,0,0,0
2147,Matteo Politano,24,12,8,11,5,15,54,27.8,39,11,2,9,13,5,0
2148,Julian Pollersbeck,0,0,0,0,0,0,0,,0,0,0,0,1,1,0
2149,Sebastian Polter,9,3,1,4,4,2,11,18.2,9,15,5,10,2,24,0
2150,Ezequiel Ponce,5,4,1,3,1,3,10,30.0,7,5,0,5,1,7,0
2151,Marin Pongračić,17,10,13,4,0,6,10,60.0,4,11,5,6,17,32,2
2152,Pere Pons,26,18,4,20,2,7,21,33.3,14,10,1,9,6,11,0
2153,Nick Pope,0,0,0,0,0,0,2,0.0,2,0,0,0,2,30,3
2154,Manolo Portanova,46,28,9,26,11,14,34,41.2,20,26,2,24,17,22,0
2155,Portu,16,7,2,6,8,3,19,15.8,16,21,3,18,7,8,0
2156,Stefan Posch,48,30,20,26,2,22,39,56.4,17,43,18,25,28,71,2
2157,Sergio Postigo,11,7,8,2,1,4,8,50.0,4,7,5,2,7,45,1
2158,Yussuf Poulsen,13,4,3,6,4,3,13,23.1,10,13,0,13,3,9,0
2159,Gaëtan Poussin,1,1,1,0,0,1,1,100.0,0,0,0,0,0,15,1
2160,Darío Poveda,2,0,1,0,1,0,5,0.0,5,7,1,6,1,1,0
2161,José Pozo,2,2,0,2,0,2,3,66.7,1,1,0,1,0,1,0
2162,Dennis Praet,19,10,6,8,5,8,22,36.4,14,12,1,11,3,4,0
2163,Mateusz Praszelik,0,0,0,0,0,0,0,,0,0,0,0,0,0,0
2164,Abdón Prats,2,2,1,0,1,1,5,20.0,4,5,0,5,1,6,0
2165,Sanjin Prcić,47,28,14,27,6,14,29,48.3,15,18,3,15,47,19,0
2166,Nicolas de Préville,17,8,7,8,2,3,19,15.8,16,12,4,8,5,11,0
2167,Isaac Price,0,0,0,0,0,0,0,,0,1,0,1,0,0,0
2168,Manuel Prietl,59,26,23,31,5,23,60,38.3,37,28,3,25,39,33,0
2169,Alejandro Primo,0,0,0,0,0,0,0,,0,0,0,0,0,0,0
2170,Grischa Prömel,36,22,14,17,5,22,52,42.3,30,18,3,15,23,22,0
2171,Nick Proschwitz,0,0,0,0,0,0,0,,0,0,0,0,0,0,0
2172,Ivan Provedel,0,0,0,0,0,0,1,0.0,1,0,0,0,2,10,2
2173,Javi Puado,24,14,18,5,1,12,37,32.4,25,18,2,16,11,24,0
2174,Pubill,12,6,10,2,0,4,8,50.0,4,7,2,5,4,8,2
2175,Antonio Puertas,34,20,18,12,4,17,44,38.6,27,33,3,30,11,36,0
2176,Riqui Puig,6,3,2,4,0,2,14,14.3,12,5,0,5,3,0,0
2177,Teemu Pukki,23,11,2,14,7,6,29,20.7,23,21,1,20,4,3,0
2178,Erick Pulgar,6,6,4,2,0,4,9,44.4,5,5,1,4,5,2,1
2179,Christian Pulisic,10,7,6,3,1,3,17,17.6,14,12,0,12,5,10,0
2180,Afimico Pululu,1,0,1,0,0,1,2,50.0,1,1,0,1,0,0,0
2181,Ignacio Pussetto,17,9,2,9,6,2,10,20.0,8,18,2,16,4,13,0
2182,Niklas Pyyhtiä,0,0,0,0,0,0,1,0.0,1,0,0,0,0,0,0
2183,Przemysław Płacheta,4,3,3,1,0,2,7,28.6,5,3,1,2,2,5,1
2184,Yacine Qasmi,0,0,0,0,0,0,0,,0,0,0,0,0,0,0
2185,Fabio Quagliarella,6,2,2,2,2,2,15,13.3,13,14,1,13,3,12,0
2186,Quini,73,34,48,21,4,42,79,53.2,37,28,10,18,36,62,0
2187,Dani Raba,1,0,0,1,0,1,2,50.0,1,2,0,2,0,2,0
2188,Dani Raba,2,2,1,0,1,2,3,66.7,1,0,0,0,1,0,0
2189,Adrien Rabiot,64,43,32,24,8,15,34,44.1,19,34,8,26,20,41,1
2190,Uroš Račić,32,18,9,19,4,12,33,36.4,21,16,6,10,16,21,0
2191,Nemanja Radoja,25,8,9,13,3,8,20,40.0,12,16,9,7,22,16,2
2192,Nemanja Radonjić,0,0,0,0,0,0,0,,0,0,0,0,0,0,0
2193,Ivan Radovanović,11,7,8,3,0,7,19,36.8,12,14,7,7,7,29,0
2194,Ionuț Radu,0,0,0,0,0,0,0,,0,0,0,0,0,0,1
2195,Ștefan Radu,9,6,3,6,0,5,9,55.6,4,7,2,5,5,15,0
2196,Boris Radunović,0,0,0,0,0,0,0,,0,0,0,0,0,0,0
2197,Sidney Raebiger,0,0,0,0,0,0,0,,0,0,0,0,0,0,0
2198,Rafinha,43,27,17,20,6,16,28,57.1,12,21,2,19,12,4,0
2199,Rafinha,14,8,3,9,2,7,11,63.6,4,3,0,3,4,0,0
2200,Antonio Raillo,16,7,10,4,2,5,6,83.3,1,17,14,3,18,81,0
2201,Antonio Raimondo,0,0,0,0,0,0,1,0.0,1,1,0,1,0,1,0
2202,Predrag Rajković,2,2,2,0,0,2,3,66.7,1,1,0,1,1,21,1
2203,Jesurun Rak Sakyi,0,0,0,0,0,0,1,0.0,1,3,0,3,1,0,0
2204,Ivan Rakitić,40,22,12,23,5,13,40,32.5,27,31,8,23,23,35,0
2205,Diant Ramaj,0,0,0,0,0,0,0,,0,0,0,0,0,3,0
2206,Jonás Ramalho,4,2,2,2,0,2,3,66.7,1,4,1,3,3,9,0
2207,Adil Rami,10,9,6,4,0,7,8,87.5,1,17,9,8,16,43,0
2208,Sandro Ramírez,7,3,1,3,3,1,12,8.3,11,14,3,11,2,3,0
2209,Guilherme Ramos,25,15,17,8,0,12,19,63.2,7,21,8,13,27,52,0
2210,Sergio Ramos,12,5,6,6,0,8,15,53.3,7,4,2,2,8,27,0
2211,Aaron Ramsdale,2,1,2,0,0,1,2,50.0,1,0,0,0,0,26,3
2212,Aaron Ramsey,0,0,0,0,0,0,0,,0,0,0,0,1,0,0
2213,Jacob Ramsey,67,44,31,28,8,30,69,43.5,39,36,7,29,24,28,0
2214,Luca Ranieri,38,21,23,11,4,19,33,57.6,14,18,8,10,22,67,0
2215,Andrea Ranocchia,8,4,5,1,2,1,3,33.3,2,4,3,1,4,16,0
2216,Raphinha,51,29,25,14,12,22,71,31.0,49,43,0,43,29,28,1
2217,Tobias Raschl,12,9,4,8,0,5,7,71.4,2,10,1,9,3,1,0
2218,Elba Rashani,40,21,15,21,4,17,55,30.9,38,34,3,31,11,20,0
2219,Marcus Rashford,6,5,1,4,1,2,13,15.4,11,10,1,9,5,5,1
2220,Milot Rashica,31,19,12,12,7,11,30,36.7,19,22,3,19,15,23,0
2221,Giacomo Raspadori,29,18,5,15,9,11,38,28.9,27,29,3,26,9,11,0
2222,Raúl,0,0,0,0,0,0,0,,0,0,0,0,0,0,0
2223,David Raum,52,29,30,10,12,30,64,46.9,34,38,5,33,27,39,1
2224,Nicola Ravaglia,0,0,0,0,0,0,0,,0,0,0,0,0,0,0
2225,David Raya,0,0,0,0,0,0,0,,0,1,0,1,0,10,1
2226,Ante Rebić,14,8,3,6,5,7,20,35.0,13,14,0,14,3,3,1
2227,Arkadiusz Reca,31,19,21,3,7,20,30,66.7,10,20,7,13,32,47,2
2228,Lluís Recasens,2,0,2,0,0,1,1,100.0,0,0,0,0,2,2,0
2229,Nathan Redmond,22,14,9,9,4,7,30,23.3,23,21,2,19,8,16,0
2230,Sergio Reguilón,40,24,15,18,7,22,43,51.2,21,20,8,12,31,45,1
2231,Manolo Reina,0,0,0,0,0,0,0,,0,0,0,0,1,6,2
2232,Pepe Reina,0,0,0,0,0,0,1,0.0,1,0,0,0,0,1,1
2233,Jeff Reine-Adélaïde,5,3,4,1,0,4,5,80.0,1,2,0,2,0,0,1
2234,Reinier,5,3,4,0,1,1,1,100.0,0,3,0,3,0,0,0
2235,Karim Rekik,11,8,4,6,1,2,9,22.2,7,11,6,5,9,19,0
2236,Álex Remiro,0,0,0,0,0,0,0,,0,0,0,0,1,24,2
2237,Panagiotis Retsos,0,0,0,0,0,0,2,0.0,2,0,0,0,2,3,0
2238,Panagiotis Retsos,0,0,0,0,0,0,0,,0,0,0,0,1,0,1
2239,Marco Reus,45,30,13,21,11,16,42,38.1,26,23,6,17,12,41,1
2240,Elvis Rexhbeçaj,41,20,17,19,5,19,40,47.5,21,41,6,35,27,15,0
2241,Gio Reyna,7,4,2,4,1,3,9,33.3,6,6,0,6,1,3,0
2242,Bryan Reynolds,0,0,0,0,0,0,1,0.0,1,0,0,0,0,1,0
2243,Nico Ribaudo,15,6,9,5,1,11,34,32.4,23,14,2,12,7,3,0
2244,Tiago Ribeiro,0,0,0,0,0,0,0,,0,0,0,0,0,0,0
2245,Franck Ribéry,17,10,6,6,5,8,13,61.5,5,12,0,12,3,1,0
2246,Samuele Ricci,8,4,4,2,2,2,5,40.0,3,7,1,6,14,9,0
2247,Samuele Ricci,33,19,17,13,3,20,34,58.8,14,24,5,19,31,18,0
2248,Declan Rice,80,42,45,32,3,38,71,53.5,33,45,21,24,63,52,1
2249,Chris Richards,26,15,10,15,1,11,18,61.1,7,21,9,12,22,50,1
2250,Chris Richards,0,0,0,0,0,0,0,,0,1,0,1,0,0,0
2251,Omar Richards,19,12,11,5,3,11,16,68.8,5,7,1,6,4,7,0
2252,Taylor Richards,1,0,0,1,0,1,2,50.0,1,0,0,0,0,0,0
2253,Richarlison,40,23,18,15,7,15,31,48.4,16,42,4,38,12,34,0
2254,Marco Richter,30,16,14,10,6,13,36,36.1,23,30,4,26,16,24,0
2255,Diego Rico,41,20,19,17,5,22,45,48.9,23,29,4,25,30,54,0
2256,Sergio Rico,0,0,0,0,0,0,0,,0,0,0,0,0,5,2
2257,Sergio Rico,0,0,0,0,0,0,0,,0,0,0,0,0,1,0
2258,Jaïro Riedewald,1,1,0,1,0,1,2,50.0,1,1,0,1,1,2,0
2259,Manuel Riemann,1,0,1,0,0,1,4,25.0,3,0,0,0,1,12,3
2260,Tomás Rincón,2,2,2,0,0,0,3,0.0,3,3,1,2,2,4,0
2261,Tomás Rincón,22,13,9,10,3,13,34,38.2,21,15,2,13,18,11,0
2262,Luis Rioja,28,15,11,10,7,14,58,24.1,44,22,1,21,25,20,0
2263,Renaud Ripart,38,21,18,15,5,18,50,36.0,32,21,1,20,19,21,1
2264,Mihailo Ristić,44,32,26,16,2,25,43,58.1,18,16,6,10,17,48,0
2265,Matt Ritchie,22,15,10,10,2,10,27,37.0,17,10,2,8,13,26,0
2266,Maxence Rivera,0,0,0,0,0,0,0,,0,0,0,0,0,0,0
2267,Rober,36,20,27,7,2,23,39,59.0,16,25,15,10,30,90,1
2268,Sergi Roberto,5,1,2,3,0,3,5,60.0,2,2,0,2,4,6,0
2269,Connor Roberts,20,13,10,7,3,10,15,66.7,5,25,5,20,22,62,1
2270,Patrick Roberts,0,0,0,0,0,0,0,,0,0,0,0,0,0,0
2271,Tyler Roberts,16,7,6,7,3,9,16,56.3,7,11,1,10,5,11,0
2272,Andrew Robertson,36,21,16,15,5,20,35,57.1,15,24,3,21,23,61,0
2273,Marc Roca,9,7,2,4,3,2,8,25.0,6,6,0,6,6,4,0
2274,Rubén Rochina,21,13,7,8,6,8,28,28.6,20,11,1,10,6,5,1
2275,Cimo Röcker,0,0,0,0,0,0,0,,0,0,0,0,2,0,0
2276,Enzo Roco,36,20,24,11,1,15,24,62.5,9,38,27,11,28,110,3
2277,Stian Rode Gregersen,39,26,23,12,4,18,33,54.5,15,26,16,10,38,103,2
2278,Sebastian Rode,15,7,5,8,2,5,17,29.4,12,11,1,10,13,8,0
2279,Joe Rodon,0,0,0,0,0,0,0,,0,2,1,1,0,7,0
2280,Rodri,72,43,24,38,10,32,59,54.2,27,28,5,23,28,45,0
2281,Rodri,10,7,4,5,1,5,22,22.7,17,11,0,11,3,4,0
2282,Rodrigo,20,9,7,6,7,4,32,12.5,28,12,0,12,11,27,1
2283,Gerson Rodrigues,12,9,2,6,4,1,17,5.9,16,8,1,7,0,2,0
2284,Kévin Rodrigues,15,11,8,7,0,6,10,60.0,4,10,1,9,7,6,0
2285,Ángel Rodríguez,15,9,6,7,2,4,21,19.0,17,15,1,14,3,13,0
2286,Óscar Rodríguez Arnaiz,16,11,6,8,2,4,12,33.3,8,7,1,6,11,6,0
2287,Óscar Rodríguez Arnaiz,4,3,1,3,0,2,3,66.7,1,2,0,2,5,7,1
2288,Dani Rodríguez,53,31,20,24,9,15,46,32.6,31,28,3,25,20,27,0
2289,Guido Rodríguez,97,53,46,45,6,54,98,55.1,44,55,12,43,31,56,0
2290,Jay Rodriguez,20,12,8,8,4,4,14,28.6,10,19,1,18,4,12,0
2291,Ricardo Rodríguez,36,21,11,23,2,18,33,54.5,15,22,8,14,41,48,1
2292,Rodrygo,18,14,7,4,7,3,18,16.7,15,21,0,21,11,3,0
2293,Mads Roerslev,23,12,19,2,2,14,32,43.8,18,14,5,9,16,29,0
2294,Marko Rog,5,3,1,2,2,1,8,12.5,7,6,1,5,1,3,0
2295,Rogério,21,13,12,5,4,15,22,68.2,7,20,8,12,18,42,1
2296,Alessio Romagnoli,24,14,14,10,0,14,18,77.8,4,21,12,9,19,45,0
2297,Simone Romagnoli,28,12,14,12,2,15,20,75.0,5,34,28,6,9,86,0
2298,Leo Román,0,0,0,0,0,0,0,,0,0,0,0,0,2,0
2299,Cristian Romero,62,39,39,21,2,22,34,64.7,12,46,21,25,33,74,1
2300,Iván Romero,2,2,0,2,0,0,0,,0,1,0,1,2,0,0
2301,Luka Romero,2,1,0,1,1,0,2,0.0,2,0,0,0,1,0,0
2302,Sergio Romero,2,2,2,0,0,2,2,100.0,0,0,0,0,1,10,0
2303,Oriol Romeu,77,39,25,45,7,28,73,38.4,45,39,8,31,51,43,0
2304,Cristiano Ronaldo,8,6,1,5,2,2,6,33.3,4,8,0,8,2,29,0
2305,Cristiano Ronaldo,1,0,0,1,0,1,1,100.0,0,0,0,0,0,0,0
2306,Salomón Rondón,6,1,1,2,3,4,14,28.6,10,5,0,5,0,10,0
2307,Valentin Rongier,77,51,36,36,5,28,60,46.7,32,26,5,21,33,14,0
2308,Marten de Roon,69,42,33,29,7,34,62,54.8,28,36,2,34,45,41,0
2309,Unai Ropero,0,0,0,0,0,0,0,,0,0,0,0,1,0,0
2310,Pablo Rosario,59,37,18,32,9,26,66,39.4,40,33,7,26,38,43,0
2311,Romario Rösch,0,0,0,0,0,0,0,,0,0,0,0,0,0,0
2312,Danny Rose,16,10,11,4,1,10,24,41.7,14,8,5,3,14,11,1
2313,Francesco Rossi,0,0,0,0,0,0,0,,0,0,0,0,0,0,0
2314,Tom Rothe,4,3,2,2,0,3,6,50.0,3,2,0,2,2,3,0
2315,Jérôme Roussillon,14,9,8,6,0,10,16,62.5,6,24,5,19,14,34,2
2316,Nicolò Rovella,37,26,16,14,7,15,40,37.5,25,21,1,20,20,20,0
2317,Jon Rowe,3,2,2,1,0,2,3,66.7,1,7,0,7,3,1,0
2318,Amir Rrahmani,21,11,15,5,1,15,19,78.9,4,36,25,11,19,89,0
2319,Ruan,7,4,7,0,0,3,4,75.0,1,6,5,1,2,24,1
2320,Rubén,6,1,4,2,0,4,7,57.1,3,0,0,0,2,4,0
2321,John Ruddy,0,0,0,0,0,0,0,,0,0,0,0,0,3,0
2322,Antonio Rüdiger,48,28,29,15,4,36,48,75.0,12,20,11,9,28,91,1
2323,Sebastian Rudy,22,12,9,13,0,11,21,52.4,10,8,3,5,11,8,1
2324,Daniele Rugani,8,5,4,4,0,4,7,57.1,3,9,4,5,11,47,0
2325,Matteo Ruggeri,8,4,5,2,1,7,10,70.0,3,6,1,5,2,25,0
2326,Mário Rui,68,43,32,28,8,39,84,46.4,45,31,7,24,40,50,0
2327,Aitor Ruibal,21,15,13,3,5,10,34,29.4,24,8,0,8,8,6,0
2328,Isma Ruiz,3,1,3,0,0,1,9,11.1,8,5,2,3,3,2,0
2329,Fabián Ruiz Peña,55,33,22,29,4,29,67,43.3,38,34,1,33,22,32,0
2330,Víctor Ruiz,11,9,7,2,2,6,9,66.7,3,18,13,5,29,71,1
2331,Gerónimo Rulli,0,0,0,0,0,0,4,0.0,4,0,0,0,1,15,5
2332,Lukas Rupp,9,4,5,3,1,4,15,26.7,11,11,1,10,9,7,0
2333,Alessandro Russo,1,0,1,0,0,0,1,0.0,1,0,0,0,0,1,0
2334,Franco Russo,19,10,10,9,0,13,31,41.9,18,14,9,5,27,73,1
2335,Georginio Rutter,18,13,4,8,6,6,17,35.3,11,29,1,28,6,11,1
2336,Mathew Ryan,0,0,0,0,0,0,0,,0,0,0,0,0,2,0
2337,Julian Ryerson,27,15,11,12,4,17,25,68.0,8,12,4,8,16,32,0
2338,Frederik Rønnow,0,0,0,0,0,0,0,,0,0,0,0,0,1,0
2339,José Sá,2,1,2,0,0,2,4,50.0,2,0,0,0,2,19,5
2340,Roli Pereira de Sa,12,4,3,5,4,3,20,15.0,17,6,0,6,6,3,0
2341,Youssouf Sabaly,12,10,11,0,1,7,13,53.8,6,11,4,7,13,16,1
2342,Mathys Saban,4,2,2,2,0,1,1,100.0,0,1,0,1,0,0,0
2343,Stefano Sabelli,6,3,3,2,1,3,9,33.3,6,5,1,4,3,12,0
2344,Abdelhamid Sabiri,34,18,10,15,9,7,25,28.0,18,10,2,8,7,3,0
2345,Marcel Sabitzer,2,1,1,1,0,1,1,100.0,0,0,0,0,1,0,0
2346,Marcel Sabitzer,18,7,8,8,2,9,19,47.4,10,7,0,7,9,10,1
2347,Falaye Sacko,15,10,14,1,0,13,16,81.3,3,11,7,4,4,18,2
2348,Alexis Saelemaekers,43,22,12,17,14,15,51,29.4,36,19,0,19,15,8,0
2349,Rafiki Said,4,3,1,2,1,3,4,75.0,1,2,0,2,0,0,0
2350,Wesley Saïd,10,5,1,8,1,1,9,11.1,8,4,0,4,2,0,0
2351,Allan Saint-Maximin,13,8,6,4,3,3,17,17.6,14,13,2,11,11,3,0
2352,Romain Saïss,40,27,28,11,1,19,33,57.6,14,41,21,20,58,158,2
2353,Bukayo Saka,40,21,12,17,11,13,39,33.3,26,28,2,26,22,23,0
2354,Mamadou Sakho,34,22,26,8,0,16,26,61.5,10,41,34,7,41,134,4
2355,Bakary Sako,0,0,0,0,0,0,1,0.0,1,3,1,2,0,0,0
2356,Jacopo Sala,22,11,10,10,2,13,30,43.3,17,6,0,6,14,11,0
2357,Mohamed Salah,17,8,5,9,3,6,19,31.6,13,7,1,6,6,5,0
2358,Eddie Salcedo,1,1,0,0,1,0,1,0.0,1,2,1,1,0,7,1
2359,William Saliba,54,32,36,16,2,27,35,77.1,8,24,16,8,48,85,0
2360,Romain Salin,0,0,0,0,0,0,0,,0,0,0,0,0,0,0
2361,Mohammed Salisu,80,47,54,22,4,40,65,61.5,25,49,26,23,78,158,4
2362,Roland Sallai,22,16,8,11,3,7,23,30.4,16,12,0,12,11,12,0
2363,Yoann Salmier,58,33,44,11,3,26,34,76.5,8,30,14,16,40,94,0
2364,Salvi,20,10,9,8,3,8,20,40.0,12,17,2,15,6,11,0
2365,Lazar Samardzic,13,9,4,7,2,7,26,26.9,19,6,0,6,2,2,0
2366,Diadie Samassékou,41,26,14,21,6,21,44,47.7,23,27,11,16,28,26,0
2367,Mama Samba Baldé,40,28,16,14,10,8,26,30.8,18,32,1,31,5,9,0
2368,Albert Sambi Lokonga,22,18,11,9,2,12,14,85.7,2,12,7,5,13,12,4
2369,Junior Sambia,22,13,12,7,3,13,22,59.1,9,22,3,19,21,31,0
2370,Luigi Samele,0,0,0,0,0,0,0,,0,0,0,0,0,1,0
2371,Fede San Emeterio,16,5,5,8,3,5,15,33.3,10,5,0,5,8,6,0
2372,Antonio Sanabria,3,2,0,1,2,1,4,25.0,3,11,4,7,2,10,0
2373,Oihan Sancet,12,7,2,8,2,5,20,25.0,15,2,0,2,5,13,0
2374,Renato Sanches,19,7,8,10,1,9,26,34.6,17,14,3,11,14,7,0
2375,Alexis Sánchez,9,8,0,6,3,2,11,18.2,9,4,0,4,2,3,0
2376,Antonio Sánchez,53,24,29,17,7,19,49,38.8,30,32,2,30,32,32,1
2377,Davinson Sánchez,41,22,25,14,2,19,28,67.9,9,24,16,8,30,54,3
2378,Germán Sánchez,27,19,18,9,0,11,20,55.0,9,19,16,3,28,137,0
2379,Manu Sánchez,72,34,41,22,9,43,79,54.4,36,28,3,25,18,43,0
2380,Robert Sánchez,2,1,2,0,0,1,1,100.0,0,1,0,1,0,11,4
2381,Jadon Sancho,14,8,9,4,1,8,22,36.4,14,19,0,19,15,5,3
2382,Philippe Sandler,0,0,0,0,0,0,0,,0,1,1,0,3,6,0
2383,Alex Sandro,27,16,15,9,3,11,25,44.0,14,17,6,11,27,40,0
2384,Leroy Sané,28,16,5,19,4,9,24,37.5,15,18,0,18,12,2,1
2385,Oier Sanjurjo,10,6,3,7,0,2,19,10.5,17,8,3,5,1,9,0
2386,Mohamed Sankoh,0,0,0,0,0,0,0,,0,0,0,0,0,0,0
2387,Morgan Sanson,12,8,7,2,3,3,7,42.9,4,13,0,13,10,2,1
2388,Nicola Sansone,13,7,5,6,2,3,15,20.0,12,1,0,1,4,2,0
2389,Baptiste Santamaria,52,27,15,31,6,24,44,54.5,20,33,12,21,33,42,0
2390,Baptiste Santamaria,0,0,0,0,0,0,1,0.0,1,0,0,0,1,1,0
2391,Federico Santander,2,1,1,1,0,1,1,100.0,0,0,0,0,0,0,0
2392,Jesús Santiago,2,2,1,1,0,0,2,0.0,2,1,0,1,0,1,0
2393,Samir Santos,24,11,18,6,0,8,19,42.1,11,21,11,10,43,85,3
2394,Samir Santos,36,16,22,13,1,15,25,60.0,10,21,7,14,42,62,0
2395,Sergio Santos,0,0,0,0,0,0,0,,0,0,0,0,0,0,0
2396,Alvaro Sanz,0,0,0,0,0,0,1,0.0,1,0,0,0,0,0,0
2397,Riccardo Saponara,10,2,1,6,3,6,16,37.5,10,5,0,5,1,3,0
2398,Pablo Sarabia,0,0,0,0,0,0,1,0.0,1,0,0,0,0,0,0
2399,Marcelo Saracchi,8,5,6,1,1,2,4,50.0,2,3,0,3,4,7,1
2400,Josh Sargent,26,14,15,7,4,14,39,35.9,25,29,2,27,11,18,2
2401,Jeremy Sarmiento,1,1,0,0,1,0,2,0.0,2,2,0,2,0,0,0
2402,Bouna Sarr,4,4,2,1,1,4,5,80.0,1,2,1,1,6,1,0
2403,Ismaila Sarr,12,7,4,3,5,5,19,26.3,14,10,1,9,9,10,0
2404,Malang Sarr,14,7,10,2,2,7,12,58.3,5,6,3,3,11,20,0
2405,Joan Sastre Vanrell,6,3,5,0,1,3,4,75.0,1,3,0,3,2,10,0
2406,Giacomo Satalino,0,0,0,0,0,0,0,,0,0,0,0,0,0,0
2407,Martin Satriano,1,0,0,0,1,1,1,100.0,0,0,0,0,0,0,0
2408,Martin Satriano,5,2,1,1,3,2,7,28.6,5,8,0,8,2,3,0
2409,Téji Savanier,46,27,18,19,9,21,59,35.6,38,23,1,22,25,12,1
2410,Esteban Saveljich,18,11,11,7,0,9,15,60.0,6,20,12,8,16,69,0
2411,Stefan Savić,46,20,25,20,1,29,43,67.4,14,19,12,7,37,102,1
2412,Joe Scally,40,30,21,14,5,17,41,41.5,24,27,4,23,22,38,0
2413,Giorgio Scalvini,22,11,13,8,1,9,19,47.4,10,12,1,11,22,16,0
2414,Gianluca Scamacca,19,14,2,5,12,5,21,23.8,16,16,1,15,5,22,1
2415,Dane Scarlett,0,0,0,0,0,0,0,,0,0,0,0,0,0,0
2416,Kevin Schade,9,7,6,2,1,3,10,30.0,7,15,3,12,3,16,0
2417,András Schäfer,4,1,3,1,0,0,5,0.0,5,7,1,6,2,4,0
2418,Fabian Schär,16,11,11,3,2,8,16,50.0,8,27,18,9,32,95,2
2419,Louis Schaub,16,10,7,7,2,11,20,55.0,9,17,3,14,3,3,0
2420,Andrea Schiavone,14,8,5,9,0,10,23,43.5,13,13,3,10,8,12,0
2421,Patrik Schick,5,2,2,2,1,1,9,11.1,8,6,1,5,3,28,0
2422,Kingsley Schindler,1,0,0,0,1,1,5,20.0,4,5,1,4,5,5,0
2423,Xaver Schlager,43,20,20,20,3,20,49,40.8,29,25,2,23,9,14,0
2424,Keven Schlotterbeck,11,5,6,5,0,5,6,83.3,1,7,4,3,11,24,1
2425,Nico Schlotterbeck,72,43,36,34,2,33,48,68.8,15,41,32,9,56,154,1
2426,Jeffrey Schlupp,46,25,16,23,7,24,50,48.0,26,39,9,30,18,32,0
2427,Kasper Schmeichel,0,0,0,0,0,0,2,0.0,2,0,0,0,1,15,2
2428,Jonathan Schmid,12,6,6,3,3,5,7,71.4,2,7,1,6,6,15,0
2429,Benno Schmitz,57,37,21,27,9,42,86,48.8,44,44,8,36,39,39,0
2430,David Schnegg,2,0,1,1,0,1,3,33.3,2,4,0,4,3,6,0
2431,Morgan Schneiderlin,21,12,9,11,1,6,13,46.2,7,8,2,6,20,18,0
2432,Alessandro Schöpf,40,22,19,16,5,14,30,46.7,16,31,5,26,30,21,1
2433,Jerdy Schouten,25,17,10,12,3,9,22,40.9,13,22,5,17,33,29,1
2434,Nico Schulz,21,12,9,7,5,9,21,42.9,12,8,1,7,11,8,0
2435,Marvin Schwäbe,0,0,0,0,0,0,0,,0,0,0,0,0,8,1
2436,Alexander Schwolow,0,0,0,0,0,0,1,0.0,1,0,0,0,2,18,3
2437,Valentino Scotta,0,0,0,0,0,0,0,,0,0,0,0,0,0,0
2438,Demba Seck,2,1,0,2,0,0,0,,0,0,0,0,0,0,0
2439,Aleksandar Sedlar,5,3,4,1,0,3,5,60.0,2,4,4,0,5,19,0
2440,Paul Seguin,50,31,15,32,3,26,56,46.4,30,27,3,24,19,30,1
2441,Alidu Seidu,34,20,20,13,1,16,27,59.3,11,25,11,14,34,49,1
2442,Davie Selke,5,4,1,3,1,1,3,33.3,2,6,1,5,1,11,0
2443,Matz Sels,1,1,1,0,0,0,0,,0,0,0,0,1,22,0
2444,Ken Sema,16,6,11,4,1,9,20,45.0,11,10,0,10,5,11,0
2445,Nélson Semedo,58,39,39,17,2,25,49,51.0,24,23,4,19,21,64,1
2446,Lion Semić,0,0,0,0,0,0,0,,0,0,0,0,0,0,0
2447,Adrian Šemper,0,0,0,0,0,0,0,,0,0,0,0,0,0,0
2448,Stefano Sensi,18,9,10,6,2,10,23,43.5,13,2,0,2,6,4,0
2449,Stefano Sensi,4,3,1,3,0,2,4,50.0,2,2,0,2,0,2,0
2450,Luigi Sepe,0,0,0,0,0,0,0,,0,0,0,0,1,3,0
2451,Suat Serdar,64,30,24,29,11,25,55,45.5,30,32,3,29,20,14,0
2452,Laurens Serpe,1,0,1,0,0,1,2,50.0,1,0,0,0,0,1,0
2453,Janni Serra,4,2,2,0,2,2,7,28.6,5,8,3,5,5,19,0
2454,Javier Serrano,3,1,0,3,0,2,4,50.0,2,0,0,0,3,2,0
2455,Nicolás Serrano,9,6,3,5,1,3,10,30.0,7,5,1,4,2,3,0
2456,Zidan Sertdemir,2,2,2,0,0,0,0,,0,0,0,0,0,0,0
2457,Ryan Sessegnon,25,19,14,7,4,11,22,50.0,11,18,3,15,7,26,0
2458,Nils Seufert,3,2,1,1,1,0,1,0.0,1,0,0,0,0,0,0
2459,Salva Sevilla,18,12,8,8,2,6,17,35.3,11,12,6,6,14,11,0
2460,Stephan El Shaarawy,13,8,4,9,0,4,6,66.7,2,10,2,8,11,8,0
2461,Jamie Shackleton,27,16,19,7,1,13,25,52.0,12,11,7,4,8,12,1
2462,Xherdan Shaqiri,7,3,0,5,2,2,10,20.0,8,2,0,2,2,2,0
2463,Luke Shaw,21,13,9,9,3,12,21,57.1,9,22,11,11,9,22,2
2464,Jonjo Shelvey,30,17,12,18,0,14,34,41.2,20,22,7,15,22,20,2
2465,Aimar Sher,2,1,1,1,0,0,1,0.0,1,1,0,1,3,1,0
2466,Eldor Shomurodov,5,4,0,4,1,1,10,10.0,9,8,0,8,2,5,0
2467,Shola Shoretire,0,0,0,0,0,0,0,,0,0,0,0,0,0,0
2468,Mahame Siby,0,0,0,0,0,0,0,,0,0,0,0,1,2,0
2469,Aboubakar Sidibé,0,0,0,0,0,0,0,,0,0,0,0,0,0,0
2470,Alassane Sidibe,1,1,1,0,0,0,0,,0,0,0,0,0,0,0
2471,Djibril Sidibé,24,13,13,8,3,9,24,37.5,15,10,1,9,16,13,0
2472,Kaj Sierhuis,1,1,1,0,0,1,3,33.3,2,0,0,0,0,1,0
2473,Francisco Sierralta,7,3,7,0,0,5,8,62.5,3,7,2,5,6,35,0
2474,Arnór Sigurðsson,1,1,0,1,0,1,2,50.0,1,2,0,2,1,0,0
2475,Kiliann Sildillia,7,3,3,4,0,3,6,50.0,3,1,0,1,2,7,1
2476,Adrien Silva,24,12,14,5,5,9,33,27.3,24,15,5,10,23,23,0
2477,André Silva,13,9,2,3,8,4,13,30.8,9,20,2,18,2,15,0
2478,Bernardo Silva,57,29,19,19,19,31,67,46.3,36,24,2,22,20,19,0
2479,Caio Henrique Oliveira Silva,53,30,31,18,4,28,59,47.5,31,30,6,24,27,37,3
2480,David Silva,28,17,10,11,7,3,20,15.0,17,13,3,10,7,12,0
2481,Fábio Silva,3,2,0,2,1,0,8,0.0,8,2,0,2,1,1,0
2482,Gabriel Silva,12,7,7,2,3,9,13,69.2,4,9,3,6,18,13,0
2483,Jonathan Silva,10,8,4,4,2,7,12,58.3,5,4,0,4,3,7,0
2484,Rui Silva,1,0,1,0,0,1,2,50.0,1,0,0,0,1,11,1
2485,Thiago Silva,32,21,19,12,1,11,22,50.0,11,54,31,23,44,100,0
2486,Marco Silvestri,0,0,0,0,0,0,1,0.0,1,0,0,0,1,11,1
2487,Mohamed Simakan,48,27,25,21,2,27,41,65.9,14,22,11,11,40,46,1
2488,Giovanni Simeone,27,15,6,12,9,9,39,23.1,30,37,3,34,6,23,0
2489,Giovanni Simeone,0,0,0,0,0,0,0,,0,0,0,0,0,0,0
2490,Giuliano Simeone,0,0,0,0,0,0,0,,0,0,0,0,0,0,0
2491,Ellis Simms,0,0,0,0,0,0,0,,0,1,1,0,0,1,0
2492,Moses Simon,17,11,6,5,6,11,23,47.8,12,14,3,11,12,5,0
2493,Unai Simón,0,0,0,0,0,0,0,,0,0,0,0,1,5,1
2494,Xavi Simons,1,1,0,1,0,1,2,50.0,1,3,0,3,0,0,0
2495,Wilfried Singo,55,35,24,24,7,24,34,70.6,10,26,6,20,23,47,0
2496,Daley Sinkgraven,6,2,4,0,2,3,7,42.9,4,3,1,2,3,6,0
2497,Tobias Sippel,0,0,0,0,0,0,0,,0,0,0,0,0,0,0
2498,Hugo Siquet,0,0,0,0,0,0,0,,0,0,0,0,0,0,0
2499,Salvatore Sirigu,1,1,1,0,0,1,2,50.0,1,0,0,0,0,19,2
2500,Issouf Sissokho,17,8,2,13,2,8,17,47.1,9,8,1,7,7,0,0
2501,Ibrahima Sissoko,47,23,18,20,9,19,46,41.3,27,32,11,21,35,31,0
2502,Moussa Sissoko,53,27,27,20,6,28,42,66.7,14,42,13,29,30,64,0
2503,Nelson Sissoko,2,0,2,0,0,1,1,100.0,0,0,0,0,0,2,0
2504,Sambou Sissoko,12,6,6,4,2,6,8,75.0,2,2,0,2,2,7,0
2505,Antonio Sivera,0,0,0,0,0,0,1,0.0,1,0,0,0,0,0,0
2506,Ellyes Skhiri,55,33,25,26,4,22,41,53.7,19,41,7,34,37,35,1
2507,Oliver Skipp,33,19,14,18,1,15,31,48.4,16,19,7,12,12,10,1
2508,Leo Skiri Østigård,16,9,8,7,1,9,11,81.8,2,17,10,7,8,55,1
2509,Łukasz Skorupski,0,0,0,0,0,0,1,0.0,1,0,0,0,0,17,0
2510,Andreas Skov Olsen,12,10,4,4,4,5,11,45.5,6,9,1,8,3,11,0
2511,Robert Skov,3,2,1,1,1,2,9,22.2,7,2,0,2,3,3,0
2512,Milan Škriniar,47,27,26,17,4,24,42,57.1,18,36,25,11,25,90,1
2513,Islam Slimani,3,2,0,1,2,1,6,16.7,5,4,0,4,2,5,0
2514,William Smallbone,4,4,2,2,0,1,3,33.3,2,4,0,4,2,0,0
2515,Chris Smalling,36,23,28,8,0,18,25,72.0,7,32,24,8,26,92,1
2516,Emile Smith Rowe,14,7,7,7,0,4,20,20.0,16,18,1,17,15,10,1
2517,Cédric Soares,38,26,23,9,6,16,25,64.0,9,18,7,11,16,31,1
2518,Danilo Soares,109,71,61,39,9,56,84,66.7,28,63,9,54,62,65,2
2519,Rubén Sobrino,1,1,1,0,0,1,1,100.0,0,1,0,1,2,0,0
2520,Rubén Sobrino,28,17,11,10,7,5,35,14.3,30,21,1,20,21,18,0
2521,Alex Sola,1,1,1,0,0,1,3,33.3,2,1,0,1,2,3,0
2522,Augusto Solari,24,12,9,12,3,12,32,37.5,20,14,4,10,7,10,1
2523,Roberto Soldado,3,1,0,1,2,1,3,33.3,2,4,0,4,1,7,0
2524,Carlos Soler,29,19,10,15,4,11,37,29.7,26,19,4,15,14,28,0
2525,Yann Sommer,0,0,0,0,0,0,2,0.0,2,0,0,0,3,8,3
2526,Son,28,18,16,7,5,17,34,50.0,17,11,5,6,19,33,1
2527,Brandon Soppy,20,9,8,10,2,11,16,68.8,5,10,2,8,5,9,1
2528,David Soria,1,0,1,0,0,1,2,50.0,1,0,0,0,0,22,2
2529,Roberto Soriano,57,30,27,22,8,17,56,30.4,39,37,3,34,22,32,0
2530,Alberto Soro,12,10,3,6,3,1,7,14.3,6,21,2,19,3,4,0
2531,Borna Sosa,22,12,14,5,3,12,26,46.2,14,30,3,27,26,61,0
2532,Hugo Sotelo,0,0,0,0,0,0,0,,0,0,0,0,0,0,0
2533,Florian Sotoca,31,19,7,20,4,12,51,23.5,39,31,4,27,25,41,0
2534,Riccardo Sottil,9,4,4,4,1,3,9,33.3,6,3,0,3,1,2,0
2535,Tomáš Souček,66,32,27,33,6,28,65,43.1,37,34,13,21,52,98,1
2536,Matìas Soulé,0,0,0,0,0,0,1,0.0,1,0,0,0,0,0,0
2537,Sambou Soumano,4,1,1,2,1,2,2,100.0,0,3,0,3,1,7,0
2538,Adama Soumaoro,15,5,5,8,2,4,9,44.4,5,22,16,6,34,95,0
2539,Boubakary Soumaré,19,13,10,8,1,8,17,47.1,9,13,1,12,14,18,0
2540,Arnaud Souquet,56,35,30,17,9,32,65,49.2,33,21,7,14,34,60,1
2541,Djibril Sow,57,33,28,25,4,22,60,36.7,38,35,8,27,50,20,1
2542,Saidou Sow,28,17,21,6,1,16,21,76.2,5,15,5,10,23,34,0
2543,Çağlar Söyüncü,47,30,32,12,3,26,42,61.9,16,44,27,17,32,115,1
2544,Leonardo Spinazzola,0,0,0,0,0,0,1,0.0,1,4,1,3,0,3,0
2545,Marco Sportiello,0,0,0,0,0,0,0,,0,0,0,0,0,2,0
2546,Tony Springett,2,1,1,1,0,1,4,25.0,3,0,0,0,0,2,0
2547,Jerry St. Juste,13,9,7,6,0,7,8,87.5,1,7,3,4,14,14,0
2548,Anton Stach,28,19,14,13,1,15,38,39.5,23,24,5,19,51,25,0
2549,Kostas Stafylidis,37,27,22,13,2,20,26,76.9,6,19,6,13,31,43,0
2550,Luca Stanga,1,0,0,1,0,0,0,,0,0,0,0,0,0,0
2551,Josip Stanišić,21,10,7,12,2,12,18,66.7,6,7,0,7,11,10,2
2552,Niklas Stark,28,16,18,10,0,12,17,70.6,5,27,17,10,36,122,2
2553,Jason Steele,0,0,0,0,0,0,0,,0,0,0,0,0,0,0
2554,Jed Steer,0,0,0,0,0,0,0,,0,0,0,0,0,0,0
2555,Renato Steffen,20,16,10,10,0,9,16,56.3,7,7,0,7,13,14,0
2556,Zack Steffen,0,0,0,0,0,0,0,,0,0,0,0,0,2,0
2557,Calvin Stengs,16,7,6,9,1,7,20,35.0,13,10,0,10,8,6,0
2558,Pascal Stenzel,24,11,15,5,4,17,33,51.5,16,13,3,10,11,25,0
2559,Dale Stephens,4,1,0,3,1,3,8,37.5,5,4,1,3,1,1,0
2560,Jack Stephens,19,12,13,5,1,6,16,37.5,10,12,7,5,19,42,0
2561,Raheem Sterling,23,10,3,11,9,10,23,43.5,13,12,0,12,12,3,0
2562,Finley Stevens,3,1,0,3,0,1,1,100.0,0,0,0,0,0,0,0
2563,Angelo Stiller,30,17,11,15,4,9,23,39.1,14,32,6,26,9,16,2
2564,Lars Stindl,23,15,6,14,3,9,33,27.3,24,28,2,26,10,14,0
2565,Riccardo Stivanello,1,1,1,0,0,1,1,100.0,0,2,2,0,0,6,0
2566,Kevin Stöger,10,5,5,5,0,4,10,40.0,6,6,0,6,5,1,1
2567,Petar Stojanović,96,63,55,32,9,59,114,51.8,55,39,13,26,27,65,1
2568,John Stones,5,3,3,2,0,2,3,66.7,1,3,3,0,11,27,1
2569,Thomas Strakosha,0,0,0,0,0,0,0,,0,0,0,0,0,7,2
2570,Stefan Strandberg,13,8,10,3,0,8,11,72.7,3,15,13,2,9,49,0
2571,Dávid Strelec,4,4,1,2,1,2,9,22.2,7,8,1,7,2,1,0
2572,Tobias Strobl,8,3,3,5,0,3,11,27.3,8,7,2,5,7,3,0
2573,Kevin Strootman,8,4,2,4,2,5,12,41.7,7,11,2,9,10,15,0
2574,Pascal Struijk,61,39,34,23,4,30,50,60.0,20,35,23,12,33,60,2
2575,Jens Stryger Larsen,5,2,3,1,1,2,3,66.7,1,2,0,2,4,17,0
2576,Leo Štulac,13,6,5,6,2,7,19,36.8,12,6,2,4,8,15,0
2577,Stefano Sturaro,43,26,16,16,11,22,48,45.8,26,25,1,24,15,29,2
2578,Damián Suárez,74,47,34,30,10,42,91,46.2,49,46,5,41,31,30,0
2579,Denis Suárez,61,29,20,33,8,25,82,30.5,57,32,4,28,16,11,0
2580,Luis Suárez,8,5,2,4,2,2,10,20.0,8,8,1,7,1,14,0
2581,Mario Suárez,9,4,7,2,0,3,9,33.3,6,6,4,2,7,37,1
2582,Isaac Success,5,2,0,3,2,1,5,20.0,4,2,0,2,2,6,0
2583,Niklas Süle,29,23,21,7,1,18,24,75.0,6,16,12,4,28,49,0
2584,Kamaldeen Sulemana,23,12,7,9,7,10,17,58.8,7,10,1,9,4,5,0
2585,Crysencio Summerville,5,3,1,1,3,2,3,66.7,1,2,0,2,2,0,0
2586,Vladyslav Supriaha,0,0,0,0,0,0,1,0.0,1,0,0,0,0,0,0
2587,Suso,4,3,1,3,0,3,13,23.1,10,4,0,4,0,0,0
2588,Bosko Sutalo,20,13,11,6,3,8,16,50.0,8,10,5,5,17,39,0
2589,Mattias Svanberg,39,15,15,16,8,16,54,29.6,38,31,9,22,28,34,0
2590,Michael Svoboda,33,17,26,6,1,18,32,56.3,14,27,15,12,10,61,5
2591,Abdoulaye Sylla,4,4,2,1,1,2,4,50.0,2,5,3,2,1,3,0
2592,Mamadou Sylla,2,2,0,1,1,0,1,0.0,1,0,0,0,1,5,0
2593,Mamadou Sylla,1,1,1,0,0,0,1,0.0,1,2,0,2,4,3,0
2594,Ádám Szalai,3,2,0,2,1,0,2,0.0,2,2,0,2,0,0,0
2595,Wojciech Szczęsny,1,1,1,0,0,1,2,50.0,1,0,0,0,0,8,1
2596,Dominik Szoboszlai,17,12,5,9,3,8,27,29.6,19,30,3,27,10,15,0
2597,Jakob Sørensen,22,11,6,14,2,10,20,50.0,10,7,3,4,10,19,0
2598,Alexander Sørloth,20,7,4,10,6,7,17,41.2,10,14,1,13,4,15,0
2599,Tachi,6,3,3,3,0,5,7,71.4,2,4,3,1,1,9,0
2600,Jonathan Tah,25,18,19,5,1,17,33,51.5,16,31,20,11,43,156,0
2601,Waniss Taibi,8,7,4,4,0,2,4,50.0,2,0,0,0,1,1,0
2602,Flavien Tait,28,19,13,9,6,13,40,32.5,27,15,4,11,19,13,1
2603,Adrien Tameze,52,29,24,21,7,20,59,33.9,39,40,5,35,52,41,0
2604,Japhet Tanganga,14,8,7,6,1,9,19,47.4,10,13,5,8,9,31,0
2605,Renato Tapia,50,31,15,31,4,20,50,40.0,30,21,5,16,28,43,0
2606,Edmond Tapsoba,35,17,24,10,1,20,32,62.5,12,27,15,12,29,72,1
2607,Florian Tardieu,58,25,31,21,6,31,71,43.7,40,31,9,22,42,38,0
2608,Matt Targett,34,18,28,5,1,24,45,53.3,21,16,9,7,23,35,0
2609,Matt Targett,41,26,26,14,1,24,37,64.9,13,15,4,11,25,39,1
2610,Oussama Targhalline,0,0,0,0,0,0,0,,0,0,0,0,0,0,0
2611,James Tarkowski,65,45,47,17,1,33,47,70.2,14,75,61,14,48,186,4
2612,Ciprian Tătărușanu,0,0,0,0,0,0,1,0.0,1,0,0,0,0,2,1
2613,Niklas Tauer,16,9,9,7,0,9,14,64.3,5,6,2,4,9,14,0
2614,Nuno Tavares,21,14,10,7,4,8,18,44.4,10,15,5,10,9,33,1
2615,Charlie Taylor,45,26,31,11,3,26,44,59.1,18,42,20,22,58,95,2
2616,Loum Tchaouna,3,1,1,2,0,1,5,20.0,4,0,0,0,2,0,0
2617,Warren Tchimbembé,1,1,0,1,0,0,1,0.0,1,2,1,1,2,2,0
2618,Aurélien Tchouaméni,86,45,33,49,4,29,55,52.7,26,39,7,32,101,34,0
2619,Mathys Tel,2,1,1,1,0,0,0,,0,0,0,0,1,2,0
2620,Jordan Tell,5,5,0,3,2,1,4,25.0,3,3,0,3,0,1,0
2621,Nathan Tella,13,9,5,7,1,6,17,35.3,11,13,0,13,6,9,0
2622,Alex Telles,48,27,35,9,4,27,43,62.8,16,17,4,13,26,45,0
2623,Cristian Tello,17,11,6,7,4,13,31,41.9,18,9,0,9,10,6,0
2624,Nahuel Tenaglia,42,27,30,9,3,24,37,64.9,13,10,2,8,26,42,0
2625,Marc Tenas,1,1,1,0,0,1,1,100.0,0,1,0,1,0,0,1
2626,Marc-André ter Stegen,0,0,0,0,0,0,1,0.0,1,0,0,0,1,13,5
2627,Filippo Terracciano,0,0,0,0,0,0,0,,0,0,0,0,0,1,0
2628,Pietro Terracciano,0,0,0,0,0,0,4,0.0,4,0,0,0,2,20,1
2629,Martin Terrier,55,33,22,16,17,25,43,58.1,18,29,3,26,18,17,0
2630,Aleksa Terzić,8,5,3,3,2,4,7,57.1,3,7,0,7,4,5,0
2631,Robert Tesche,6,4,4,1,1,5,7,71.4,2,6,2,4,5,5,1
2632,Tanner Tessmann,11,5,4,6,1,5,14,35.7,9,19,9,10,5,22,0
2633,Tetê,10,5,4,5,1,3,13,23.1,10,4,0,4,3,1,0
2634,Cedric Teuchert,3,2,3,0,0,2,6,33.3,4,1,0,1,0,0,0
2635,Arthur Theate,33,19,26,3,4,14,31,45.2,17,29,16,13,42,69,0
2636,Jan Thielmann,24,16,6,12,6,8,23,34.8,15,23,2,21,10,11,0
2637,Sada Thioub,0,0,0,0,0,0,0,,0,0,0,0,0,0,0
2638,Sada Thioub,13,8,5,8,0,6,14,42.9,8,9,0,9,10,8,0
2639,Luke Thomas,50,31,33,13,4,28,65,43.1,37,35,14,21,40,55,0
2640,Romain Thomas,49,37,28,21,0,30,57,52.6,27,35,19,16,44,126,0
2641,Adrien Thomasson,64,31,18,27,19,30,93,32.3,63,56,4,52,29,16,1
2642,Erik Thommy,2,0,0,2,0,1,2,50.0,1,3,0,3,4,0,0
2643,Dominic Thompson,1,0,1,0,0,0,1,0.0,1,2,2,0,2,3,0
2644,Morten Thorsby,46,26,15,23,8,28,56,50.0,28,37,12,25,25,39,0
2645,Thuler,21,12,17,4,0,8,15,53.3,7,9,7,2,9,30,0
2646,Khéphren Thuram,33,19,11,18,4,17,35,48.6,18,31,11,20,28,19,0
2647,Marcus Thuram,6,5,0,5,1,1,4,25.0,3,5,0,5,5,5,0
2648,Alexis Tibidi,7,3,1,3,3,3,4,75.0,1,4,0,4,3,2,0
2649,Cheikh Tidiane Sabaly,6,3,1,4,1,2,2,100.0,0,1,0,1,0,1,0
2650,Youri Tielemans,74,38,23,45,6,42,100,42.0,58,47,13,34,21,41,3
2651,Kieran Tierney,18,14,11,7,0,10,11,90.9,1,23,5,18,15,54,0
2652,Steffen Tigges,4,3,1,2,1,2,3,66.7,1,3,1,2,0,3,0
2653,Malik Tillman,2,1,0,1,1,0,1,0.0,1,5,1,4,2,1,0
2654,Timmy Tillman,43,26,17,18,8,19,42,45.2,23,33,4,29,12,26,0
2655,David Timor,1,1,1,0,0,0,3,0.0,3,3,2,1,1,4,1
2656,Mircea Ţîrlea,0,0,0,0,0,0,0,,0,0,0,0,0,1,0
2657,Jean-Clair Todibo,59,37,43,15,1,39,60,65.0,21,45,21,24,51,130,2
2658,Umut Tohumcu,0,0,0,0,0,0,0,,0,0,0,0,0,0,0
2659,Karl Toko Ekambi,13,7,4,6,3,4,21,19.0,17,26,0,26,20,5,0
2660,Corentin Tolisso,11,5,1,9,1,7,17,41.2,10,5,1,4,9,10,0
2661,Jeremy Toljan,18,10,12,4,2,13,20,65.0,7,12,5,7,12,41,0
2662,Rafael Tolói,38,15,12,15,11,24,39,61.5,15,23,11,12,26,35,0
2663,Raúl de Tomás,15,11,6,7,2,6,17,35.3,11,12,3,9,6,42,1
2664,Tiago Tomás,8,4,0,7,1,0,6,0.0,6,3,0,3,4,1,0
2665,Takehiro Tomiyasu,35,17,19,13,3,21,32,65.6,11,22,3,19,24,64,2
2666,Takehiro Tomiyasu,0,0,0,0,0,0,0,,0,1,0,1,1,0,0
2667,James Tomkins,8,3,6,2,0,6,8,75.0,2,8,8,0,4,18,0
2668,Fikayo Tomori,73,44,36,34,3,18,26,69.2,8,37,23,14,45,84,1
2669,Sandro Tonali,54,37,23,25,6,21,41,51.2,20,26,8,18,34,19,0
2670,Lorenzo Tonelli,17,9,11,4,2,6,13,46.2,7,14,8,6,19,28,2
2671,Ivan Toney,33,21,5,20,8,12,38,31.6,26,16,2,14,14,44,1
2672,Ernesto Torregrossa,2,1,1,0,1,1,2,50.0,1,0,0,0,0,1,0
2673,Lucas Torreira,37,29,13,21,3,18,40,45.0,22,18,1,17,26,18,0
2674,Raúl Torrente,31,21,18,11,2,16,29,55.2,13,14,9,5,12,69,0
2675,Ferrán Torres,2,2,0,1,1,0,3,0.0,3,2,0,2,0,1,0
2676,Ferrán Torres,10,5,3,4,3,3,7,42.9,4,12,3,9,6,7,0
2677,Óliver Torres,22,12,8,7,7,8,25,32.0,17,10,1,9,6,4,0
2678,Pau Torres,32,19,23,7,2,18,25,72.0,7,32,23,9,19,105,2
2679,Roberto Torres,7,4,3,1,3,3,15,20.0,12,8,0,8,8,4,0
2680,Lucas Torró,71,40,25,38,8,29,57,50.9,28,32,11,21,47,55,0
2681,Jordan Torunarigha,4,1,1,3,0,4,5,80.0,1,4,2,2,17,30,0
2682,Cenk Tosun,0,0,0,0,0,0,0,,0,0,0,0,0,0,0
2683,Abdoulaye Touré,12,4,3,8,1,5,11,45.5,6,6,1,5,4,6,0
2684,Almamy Touré,12,9,8,3,1,4,17,23.5,13,10,3,7,5,19,0
2685,Lucas Tousart,42,25,15,22,5,10,34,29.4,24,30,6,24,35,55,0
2686,Yoann Touzghar,5,2,1,3,1,1,3,33.3,2,3,1,2,3,8,0
2687,Andros Townsend,31,17,15,6,10,15,40,37.5,25,28,2,26,14,6,1
2688,Adama Traoré,8,3,6,0,2,3,7,42.9,4,4,1,3,2,1,0
2689,Adama Traoré,4,2,0,3,1,3,5,60.0,2,2,0,2,4,3,1
2690,Amadou Traore,0,0,0,0,0,0,0,,0,0,0,0,0,0,0
2691,Bertrand Traoré,3,3,0,1,2,1,2,50.0,1,0,0,0,0,1,0
2692,Boubacar Traoré,43,26,18,23,2,10,39,25.6,29,29,5,24,25,11,1
2693,Charles Traore,16,12,10,4,2,2,13,15.4,11,11,4,7,15,30,0
2694,Hamari Traoré,63,36,25,26,12,41,59,69.5,18,29,8,21,37,81,1
2695,Ismaël Traoré,28,17,16,11,1,13,28,46.4,15,25,17,8,44,122,1
2696,Kevin Trapp,0,0,0,0,0,0,1,0.0,1,0,0,0,1,13,2
2697,Miguel Trauco,25,18,16,8,1,12,22,54.5,10,13,4,9,23,17,0
2698,Óscar Trejo,42,24,14,18,10,15,50,30.0,35,26,1,25,13,11,0
2699,Trézéguet,0,0,0,0,0,0,0,,0,0,0,0,0,0,0
2700,Manu Trigueros,45,25,16,18,11,23,66,34.8,43,19,3,16,13,17,0
2701,Simone Trimboli,2,1,2,0,0,2,2,100.0,0,0,0,0,2,0,0
2702,Christopher Trimmel,49,30,25,19,5,26,45,57.8,19,20,3,17,34,75,0
2703,Francisco Trincão,28,15,9,13,6,3,19,15.8,16,17,1,16,12,1,1
2704,Kieran Trippier,17,10,8,8,1,10,16,62.5,6,10,3,7,10,10,0
2705,Kieran Trippier,22,12,12,5,5,12,21,57.1,9,12,1,11,10,11,0
2706,William Troost-Ekong,18,9,11,6,1,10,15,66.7,5,24,14,10,7,82,1
2707,Leandro Trossard,34,20,12,9,13,4,31,12.9,27,33,4,29,15,10,0
2708,Adrien Truffert,29,21,17,9,3,11,24,45.8,13,25,5,20,19,30,0
2709,Philipp Tschauner,0,0,0,0,0,0,0,,0,0,0,0,0,0,0
2710,Kostas Tsimikas,27,12,12,8,7,12,16,75.0,4,6,2,4,10,22,2
2711,Axel Tuanzebe,5,3,3,2,0,2,5,40.0,3,5,4,1,5,12,1
2712,Axel Tuanzebe,0,0,0,0,0,0,0,,0,1,1,0,0,0,0
2713,Ozan Tufan,3,2,1,1,1,1,5,20.0,4,2,0,2,2,4,0
2714,Beñat Turrientes,0,0,0,0,0,0,4,0.0,4,1,0,1,2,2,0
2715,Tuta,46,28,20,22,4,26,47,55.3,21,43,15,28,41,76,1
2716,Christos Tzolis,5,3,3,1,1,2,9,22.2,7,3,0,3,1,1,0
2717,Destiny Udogie,64,40,30,27,7,33,60,55.0,27,39,6,33,27,42,0
2718,Matthieu Udol,23,14,11,10,2,12,18,66.7,6,20,7,13,31,29,1
2719,Ike Ugbo,3,1,0,1,2,0,1,0.0,1,4,1,3,2,1,0
2720,Lesley Ugochukwu,13,9,5,5,3,9,19,47.4,10,7,2,5,4,2,0
2721,Hwang Ui-jo,10,4,4,4,2,4,13,30.8,9,9,1,8,5,18,0
2722,Anthony Ujah,0,0,0,0,0,0,0,,0,0,0,0,0,0,0
2723,Maximilian Ullmann,0,0,0,0,0,0,1,0.0,1,4,0,4,2,7,0
2724,Sven Ulreich,0,0,0,0,0,0,0,,0,0,0,0,0,1,0
2725,Samuel Umtiti,2,2,2,0,0,1,2,50.0,1,1,1,0,0,4,0
2726,Enes Ünal,37,22,2,18,17,5,42,11.9,37,25,5,20,5,36,0
2727,Cengiz Ünder,18,13,5,6,7,5,18,27.8,13,13,2,11,14,9,0
2728,Dayot Upamecano,66,42,42,21,3,24,36,66.7,12,20,10,10,32,71,6
2729,Benjamin Uphoff,0,0,0,0,0,0,0,,0,0,0,0,0,2,2
2730,Kacper Urbanski,3,2,1,2,0,2,2,100.0,0,2,0,2,0,0,0
2731,Jere Uronen,28,15,15,10,3,14,24,58.3,10,12,3,9,16,21,0
2732,Mark Uth,32,20,9,14,9,15,49,30.6,34,27,1,26,14,13,0
2733,Myrto Uzuni,7,4,6,1,0,0,2,0.0,2,13,1,12,10,7,0
2734,Antonio Vacca,36,20,24,10,2,14,36,38.9,22,16,8,8,20,16,0
2735,Álvaro Vadillo,1,1,1,0,0,1,2,50.0,1,0,0,0,0,1,0
2736,Óscar Valentín,102,53,46,51,5,44,105,41.9,61,56,10,46,39,43,0
2737,Germán Valera,3,2,3,0,0,1,1,100.0,0,0,0,0,0,1,0
2738,Yan Valery,8,6,4,3,1,4,9,44.4,5,6,3,3,6,19,1
2739,Martin Valjent,31,19,18,12,1,13,24,54.2,11,34,26,8,31,173,1
2740,Jesús Vallejo,7,5,7,0,0,5,6,83.3,1,9,8,1,6,16,0
2741,Manu Vallejo,8,2,1,4,3,4,13,30.8,9,7,0,7,0,4,0
2742,Manu Vallejo,2,1,1,1,0,0,1,0.0,1,0,0,0,0,1,0
2743,Federico Valverde,36,16,11,16,9,12,31,38.7,19,23,5,18,24,12,0
2744,Virgil van Dijk,16,10,11,5,0,11,16,68.8,5,21,14,7,31,109,0
2745,Vanderson,35,19,10,19,6,15,23,65.2,8,17,4,13,13,12,0
2746,Zinho Vanheusden,18,6,12,5,1,8,14,57.1,6,19,14,5,23,42,0
2747,Jonathan Varane,0,0,0,0,0,0,0,,0,0,0,0,0,0,0
2748,Raphaël Varane,28,19,21,6,1,10,22,45.5,12,18,9,9,18,82,1
2749,Jamie Vardy,6,5,0,4,2,1,7,14.3,6,9,0,9,1,17,0
2750,Ruben Vargas,28,21,7,14,7,11,30,36.7,19,9,1,8,16,13,0
2751,Sebastian Vasiliadis,31,17,12,15,4,15,42,35.7,27,15,2,13,25,31,1
2752,Johan Vásquez,79,46,44,32,3,48,75,64.0,27,32,10,22,42,85,0
2753,Denis Vavro,0,0,0,0,0,0,0,,0,0,0,0,0,0,0
2754,José Luis García Vayá,46,27,10,31,5,16,41,39.0,25,24,5,19,38,30,0
2755,Jesus Vazquez,24,13,10,8,6,10,22,45.5,12,16,3,13,9,19,0
2756,Kevin Vázquez,34,24,12,13,9,14,28,50.0,14,20,7,13,36,34,0
2757,Lucas Vázquez,43,22,24,9,10,17,35,48.6,18,25,7,18,20,41,1
2758,Matías Vecino,7,5,2,3,2,3,9,33.3,6,10,1,9,4,7,0
2759,Gabriel Veiga,5,4,0,4,1,3,12,25.0,9,2,0,2,4,1,0
2760,Miguel Veloso,23,15,4,17,2,10,16,62.5,6,18,5,13,11,18,1
2761,Joël Veltman,74,48,47,21,6,21,53,39.6,32,46,16,30,45,89,0
2762,Micky van de Ven,4,4,3,1,0,0,1,0.0,1,4,1,3,2,8,0
2763,Unai Vencedor Paris,26,11,11,9,6,8,42,19.0,34,31,13,18,19,22,0
2764,Lorenzo Venuti,25,10,13,10,2,14,24,58.3,10,13,4,9,5,27,0
2765,Daniele Verde,11,4,8,2,1,9,20,45.0,11,17,2,15,18,8,0
2766,Simone Verdi,1,1,0,1,0,0,0,,0,0,0,0,0,0,0
2767,Simone Verdi,12,8,5,2,5,9,20,45.0,11,4,0,4,3,1,0
2768,Gonzalo Verdú,19,9,15,4,0,8,16,50.0,8,20,14,6,13,59,1
2769,Jordan Veretout,34,25,20,12,2,15,39,38.5,24,12,1,11,27,22,1
2770,Edoardo Vergani,2,2,2,0,0,0,0,,0,2,2,0,0,2,0
2771,Vincent Vermeij,0,0,0,0,0,0,0,,0,1,0,1,0,0,0
2772,Marco Verratti,60,40,16,30,14,32,64,50.0,32,36,10,26,18,14,2
2773,Valerio Verre,7,5,1,4,2,4,9,44.4,5,7,0,7,0,5,0
2774,Valerio Verre,4,2,3,1,0,2,7,28.6,5,2,0,2,1,0,0
2775,Freddie Veseli,7,2,4,3,0,5,6,83.3,1,10,5,5,4,19,0
2776,Mikel Vesga,27,14,7,18,2,11,31,35.5,20,16,5,11,20,34,2
2777,Jannik Vestergaard,15,10,12,3,0,8,15,53.3,7,10,8,2,7,36,0
2778,Rúben Vezo,41,29,28,12,1,26,41,63.4,15,41,25,16,36,105,1
2779,Guglielmo Vicario,1,1,1,0,0,1,1,100.0,0,1,0,1,1,21,1
2780,Aleix Vidal,31,25,17,9,5,19,39,48.7,20,19,6,13,25,35,2
2781,Arturo Vidal,26,10,16,9,1,9,26,34.6,17,13,5,8,7,7,1
2782,Nacho Vidal,83,47,49,25,9,39,77,50.6,38,32,14,18,58,79,0
2783,Gabriel Vidovic,0,0,0,0,0,0,0,,0,0,0,0,0,0,0
2784,Ronaldo Vieira,10,6,6,4,0,5,10,50.0,5,5,2,3,6,5,1
2785,Nick Viergever,32,23,25,7,0,24,34,70.6,10,31,22,9,37,119,1
2786,Luca Vignali,1,1,0,1,0,0,3,0.0,3,0,0,0,1,1,0
2787,Emanuel Vignato,12,7,5,7,0,6,13,46.2,7,2,0,2,2,5,0
2788,Dídac Vilà,7,5,2,5,0,4,9,44.4,5,2,1,1,3,8,0
2789,Tonny Vilhena,16,6,7,8,1,7,21,33.3,14,10,2,8,8,17,0
2790,Daniel Villahermosa,0,0,0,0,0,0,0,,0,0,0,0,0,1,0
2791,Asier Villalibre,4,3,2,1,1,1,2,50.0,1,3,1,2,1,7,0
2792,Gonzalo Villar,5,3,4,1,0,2,5,40.0,3,4,1,3,1,1,0
2793,Matías Viña,46,30,27,14,5,29,59,49.2,30,26,3,23,25,33,0
2794,Nicolas Viola,2,2,1,1,0,1,2,50.0,1,1,1,0,0,1,0
2795,Mattia Viti,28,16,16,9,3,15,24,62.5,9,28,25,3,29,69,1
2796,Vitolo,3,2,1,1,1,2,5,40.0,3,3,0,3,1,1,0
2797,Daniel Vivian,32,21,24,7,1,17,24,70.8,7,20,15,5,26,107,1
2798,Dušan Vlahović,5,0,0,2,3,2,11,18.2,9,6,2,4,1,16,0
2799,Dušan Vlahović,0,0,0,0,0,0,4,0.0,4,3,0,3,0,7,0
2800,Nikola Vlašić,11,7,4,6,1,5,20,25.0,15,4,0,4,2,1,0
2801,Andreas Voglsammer,14,9,8,3,3,6,14,42.9,8,9,2,7,2,7,0
2802,Kevin Vogt,21,12,15,6,0,11,21,52.4,10,18,7,11,13,101,1
2803,Mërgim Vojvoda,38,23,23,11,4,20,36,55.6,16,27,8,19,20,51,0
2804,Kevin Volland,24,10,2,18,4,6,31,19.4,25,20,0,20,3,9,0
2805,Cristian Volpato,1,1,0,0,1,1,1,100.0,0,0,0,0,0,0,0
2806,Aster Vranckx,34,13,14,16,4,14,26,53.8,12,19,7,12,13,16,0
2807,Stefan de Vrij,38,29,22,16,0,12,17,70.6,5,17,8,9,32,52,0
2808,Šime Vrsaljko,27,17,14,12,1,12,20,60.0,8,10,1,9,12,30,0
2809,Nikola Vukčević,3,2,2,1,0,0,1,0.0,1,2,0,2,2,1,0
2810,Matěj Vydra,12,7,3,4,5,3,7,42.9,4,5,1,4,0,9,0
2811,Elye Wahi,18,10,9,6,3,6,16,37.5,10,7,0,7,4,4,0
2812,Walace,83,49,37,38,8,50,113,44.2,63,51,5,46,54,32,1
2813,Theo Walcott,4,2,2,0,2,1,5,20.0,4,3,0,3,5,2,0
2814,Luca Waldschmidt,9,1,3,5,1,5,13,38.5,8,5,0,5,8,3,0
2815,Kyle Walker,15,6,7,7,1,8,17,47.1,9,14,4,10,14,16,1
2816,Kyle Walker-Peters,57,33,28,21,8,26,38,68.4,12,29,8,21,37,53,1
2817,Sebastian Walukiewicz,9,5,7,2,0,3,5,60.0,2,5,2,3,7,14,0
2818,Aaron Wan-Bissaka,49,36,25,18,6,14,20,70.0,6,24,14,10,34,41,2
2819,Paul Wanner,2,2,0,2,0,1,1,100.0,0,0,0,0,0,0,0
2820,Danny Ward,0,0,0,0,0,0,0,,0,0,0,0,0,1,0
2821,Joel Ward,44,26,30,11,3,30,57,52.6,27,24,11,13,32,107,1
2822,James Ward-Prowse,41,24,12,24,5,19,70,27.1,51,43,15,28,40,45,1
2823,Magnus Warming,1,1,0,1,0,0,0,,0,2,0,2,0,0,0
2824,Daniel Wass,0,0,0,0,0,0,0,,0,0,0,0,0,3,0
2825,Daniel Wass,23,13,6,14,3,8,31,25.8,23,13,2,11,13,19,0
2826,Ollie Watkins,17,13,2,7,8,2,15,13.3,13,25,3,22,12,27,0
2827,Timothy Weah,19,7,8,8,3,10,20,50.0,10,16,1,15,10,7,0
2828,Adam Webster,26,8,17,7,2,13,20,65.0,7,25,17,8,17,66,2
2829,Wout Weghorst,17,9,3,9,5,6,19,31.6,13,16,5,11,6,13,0
2830,Wout Weghorst,13,7,3,3,7,7,17,41.2,10,10,3,7,2,11,1
2831,Noah Weißhaupt,1,1,1,0,0,1,2,50.0,1,2,0,2,1,1,1
2832,Danny Welbeck,14,7,2,8,4,3,10,30.0,7,18,2,16,5,18,0
2833,Timo Werner,8,4,3,3,2,2,20,10.0,18,9,0,9,2,4,0
2834,Ashley Westwood,21,12,8,12,1,10,31,32.3,21,21,9,12,30,16,1
2835,Ben White,44,23,30,8,6,28,45,62.2,17,42,24,18,42,102,0
2836,Silvan Widmer,60,28,32,20,8,36,61,59.0,25,44,16,28,43,59,2
2837,Georginio Wijnaldum,15,9,2,12,1,11,19,57.9,8,13,3,10,9,7,0
2838,Jetro Willems,30,15,18,10,2,15,26,57.7,11,15,3,12,14,42,0
2839,Brandon Williams,55,37,35,18,2,36,64,56.3,28,26,6,20,44,50,0
2840,Iñaki Williams,14,5,1,6,7,5,17,29.4,12,18,3,15,3,20,0
2841,Neco Williams,0,0,0,0,0,0,0,,0,0,0,0,0,0,0
2842,Nico Williams,20,10,6,11,3,10,31,32.3,21,18,2,16,5,9,0
2843,Joe Willock,64,37,30,28,6,29,68,42.6,39,37,6,31,21,10,1
2844,Callum Wilson,9,8,1,5,3,1,4,25.0,3,7,2,5,3,10,0
2845,Patrick Wimmer,53,31,13,31,9,22,61,36.1,39,30,1,29,27,13,0
2846,Jonas Wind,10,6,1,7,2,1,4,25.0,3,8,3,5,6,13,0
2847,Marten Winkler,0,0,0,0,0,0,0,,0,0,0,0,0,0,0
2848,Harry Winks,15,10,4,9,2,8,21,38.1,13,14,3,11,16,10,2
2849,Frederik Winther,7,2,7,0,0,5,6,83.3,1,4,1,3,8,21,0
2850,Florian Wirtz,25,10,6,16,3,10,28,35.7,18,12,1,11,13,4,0
2851,Yoane Wissa,12,6,5,4,3,1,16,6.3,15,12,5,7,8,6,0
2852,Axel Witsel,42,27,12,23,7,18,30,60.0,12,24,9,15,27,38,0
2853,Hannes Wolf,23,12,4,13,6,10,20,50.0,10,10,0,10,2,1,0
2854,Marius Wolf,26,10,13,9,4,12,24,50.0,12,14,1,13,13,8,0
2855,Luca Wollschläger,1,1,0,1,0,0,1,0.0,1,0,0,0,0,0,0
2856,Jeong Woo-yeong,15,9,6,7,2,5,15,33.3,10,8,1,7,7,11,0
2857,Chris Wood,7,5,0,3,4,3,10,30.0,7,13,4,9,0,3,0
2858,Chris Wood,2,0,1,1,0,1,2,50.0,1,5,2,3,2,9,0
2859,Freddie Woodman,0,0,0,0,0,0,0,,0,0,0,0,0,0,1
2860,Christopher Wooh,29,11,20,8,1,11,18,61.1,7,21,14,7,21,40,1
2861,Joscha Wosz,0,0,0,0,0,0,0,,0,0,0,0,0,0,0
2862,Xeka,47,27,18,24,5,27,56,48.2,29,23,3,20,24,26,1
2863,Granit Xhaka,32,18,16,12,4,16,41,39.0,25,21,6,15,21,31,0
2864,Sekou Yansané,0,0,0,0,0,0,1,0.0,1,0,0,0,0,1,0
2865,Andriy Yarmolenko,4,2,2,2,0,2,8,25.0,6,4,2,2,0,2,0
2866,Yusuf Yazıcı,10,5,3,6,1,1,9,11.1,8,4,0,4,2,1,0
2867,Kelvin Yeboah,14,7,5,7,2,9,19,47.4,10,22,1,21,1,7,0
2868,Gerard Yepes,1,0,0,1,0,1,1,100.0,0,1,0,1,0,0,0
2869,Burak Yılmaz,7,2,0,2,5,2,17,11.8,15,8,1,7,2,11,0
2870,Okay Yokuşlu,9,8,6,2,1,5,5,100.0,0,7,5,2,5,17,0
2871,Okay Yokuşlu,4,1,2,1,1,2,3,66.7,1,2,1,1,2,6,0
2872,Leny Yoro,1,0,0,1,0,0,0,,0,1,0,1,0,0,0
2873,Maya Yoshida,17,10,8,9,0,8,15,53.3,7,27,20,7,28,72,1
2874,Ashley Young,18,6,9,6,3,11,16,68.8,5,10,4,6,13,25,1
2875,Nathan Young-Coombes,0,0,0,0,0,0,0,,0,0,0,0,0,0,0
2876,Zaydou Youssouf,48,26,21,25,2,14,34,41.2,20,11,3,8,17,13,0
2877,Mattia Zaccagni,3,1,1,0,2,1,2,50.0,1,1,0,1,4,0,0
2878,Mattia Zaccagni,33,16,10,13,10,11,19,57.9,8,17,2,15,20,5,0
2879,Dan-Axel Zagadou,13,7,11,1,1,7,10,70.0,3,14,4,10,15,38,2
2880,Wilfried Zaha,40,20,14,15,11,10,31,32.3,21,28,0,28,5,5,0
2881,Denis Zakaria,11,7,3,6,2,3,11,27.3,8,16,3,13,11,7,0
2882,Denis Zakaria,23,14,9,10,4,12,35,34.3,23,25,5,20,19,22,1
2883,Joseba Zaldúa,31,22,20,8,3,16,22,72.7,6,14,4,10,13,35,0
2884,Nicola Zalewski,32,19,17,11,4,21,35,60.0,14,18,1,17,16,4,0
2885,Andre-Frank Zambo Anguissa,50,26,24,17,9,25,51,49.0,26,31,5,26,24,33,1
2886,Nicolò Zaniolo,24,15,0,15,9,6,28,21.4,22,19,0,19,7,6,0
2887,Alessandro Zanoli,10,7,6,3,1,3,5,60.0,2,2,1,1,4,16,0
2888,Mattia Zanotti,1,0,1,0,0,0,1,0.0,1,0,0,0,0,0,0
2889,Duván Zapata,6,2,0,4,2,4,8,50.0,4,8,1,7,3,5,0
2890,Gabriele Zappa,21,9,12,6,3,6,24,25.0,18,15,5,10,14,28,0
2891,Davide Zappacosta,32,22,12,13,7,19,37,51.4,18,32,2,30,12,22,0
2892,Oier Zarraga,13,5,4,7,2,3,28,10.7,25,17,10,7,19,10,0
2893,Simone Zaza,2,2,1,1,0,1,1,100.0,0,3,0,3,0,3,0
2894,Akim Zedadka,72,44,34,29,9,37,71,52.1,34,32,8,24,58,48,0
2895,Deyovaisio Zeefuik,11,10,6,4,1,6,12,50.0,6,12,4,8,11,21,1
2896,Marvin Zeegelaar,15,11,6,8,1,5,14,35.7,9,12,4,8,12,22,1
2897,Arber Zeneli,1,0,0,0,1,1,5,20.0,4,0,0,0,1,1,0
2898,Robin Zentner,2,2,2,0,0,2,2,100.0,0,0,0,0,2,21,1
2899,Andi Zeqiri,14,7,3,5,6,3,12,25.0,9,10,1,9,2,12,0
2900,Mehdi Zerkane,0,0,0,0,0,0,1,0.0,1,1,1,0,2,0,0
2901,Edon Zhegrova,14,5,2,8,4,5,6,83.3,1,4,1,3,2,2,0
2902,Luca Zidane,0,0,0,0,0,0,1,0.0,1,0,0,0,0,1,1
2903,Piotr Zieliński,19,12,5,9,5,6,21,28.6,15,13,2,11,8,4,0
2904,David Zima,20,12,8,11,1,9,20,45.0,11,15,13,2,23,42,0
2905,Christoph Zimmermann,6,3,5,1,0,3,4,75.0,1,0,0,0,1,4,0
2906,Oleksandr Zinchenko,20,14,7,10,3,11,20,55.0,9,11,3,8,14,15,1
2907,Hakim Ziyech,19,10,5,12,2,10,36,27.8,26,11,1,10,10,10,0
2908,Jeroen Zoet,1,0,1,0,0,1,1,100.0,0,0,0,0,0,4,0
2909,Simon Zoller,4,2,2,1,1,1,3,33.3,2,3,0,3,4,2,0
2910,Nadir Zortea,21,15,9,7,5,11,19,57.9,8,14,2,12,7,33,0
2911,Tanguy Zoukrou,1,0,1,0,0,1,2,50.0,1,0,0,0,0,2,0
2912,Kurt Zouma,11,6,8,3,0,4,7,57.1,3,31,26,5,34,132,0
2913,Petar Zovko,0,0,0,0,0,0,0,,0,0,0,0,0,1,0
2914,Igor Zubeldia,20,10,12,8,0,12,18,66.7,6,16,6,10,27,53,0
2915,Martín Zubimendi,52,25,19,30,3,22,44,50.0,22,30,13,17,49,48,1
2916,Szymon Żurkowski,58,33,24,21,13,29,68,42.6,39,43,10,33,35,32,1
2917,Martin Ødegaard,49,21,6,24,19,22,61,36.1,39,18,1,17,11,11,1
2918,Milan Đurić,1,1,0,1,0,1,3,33.3,2,6,1,5,2,32,0
2919,Filip Đuričić,13,10,7,1,5,5,13,38.5,8,7,1,6,4,1,0
