,Player,Tkl,TklW,Def 3rd,Mid 3rd,Att 3rd,TklDribblers,Att,Tkl%,Lost,Blocks,Sh,Pass,Int,Clr,Err
0,Patrick van Aanholt,47,32,29,15,3,16,34,47.1,18,24,5,19,47,64,2
1,Rolando Aarons,4,4,3,1,0,4,6,66.7,2,3,0,3,1,0,0
2,Rolando Aarons,13,8,4,4,5,1,7,14.3,6,3,1,2,2,0,0
3,Ignazio Abate,20,17,10,9,1,6,11,54.5,5,22,2,20,8,29,0
4,Aymen Abdennour,7,3,5,2,0,4,7,57.1,3,5,5,0,4,20,0
5,Aly Abeid,2,1,1,1,0,0,1,0.0,1,1,0,1,3,3,0
6,Mehdi Abeid,23,15,8,14,1,8,32,25.0,24,11,6,5,18,25,2
7,David Abraham,40,32,29,10,1,27,36,75.0,9,29,15,14,40,141,1
8,Tammy Abraham,10,8,1,7,2,1,13,7.7,12,8,1,7,1,11,0
9,Amir Abrashi,35,32,15,18,2,16,23,69.6,7,22,5,17,19,20,0
10,Francesco Acerbi,51,32,26,22,3,22,36,61.1,14,42,21,21,88,255,1
11,Afriyie Acquah,8,6,2,6,0,1,7,14.3,6,8,1,7,16,10,2
12,Charlie Adam,9,5,2,5,2,5,17,29.4,12,2,0,2,9,11,2
13,Antonio Adán,1,0,1,0,0,1,1,100.0,0,1,0,1,0,11,2
14,Aday,17,15,11,4,2,6,17,35.3,11,19,3,16,25,52,1
15,Khaled Adénon,38,24,26,12,0,15,32,46.9,17,42,26,16,65,221,1
16,Claud Adjapong,35,26,24,5,6,11,13,84.6,2,16,3,13,23,37,0
17,René Adler,1,1,1,0,0,1,1,100.0,0,0,0,0,0,8,1
18,Yacine Adli,0,0,0,0,0,0,0,,0,0,0,0,0,0,0
19,Ali Adnan Kadhim,54,35,35,14,5,29,50,58.0,21,31,6,25,41,90,0
20,Adrián,2,1,2,0,0,1,4,25.0,3,1,0,1,0,15,1
21,Aritz Aduriz,11,8,2,6,3,1,6,16.7,5,6,0,6,3,18,0
22,Ibrahim Afellay,3,3,0,3,0,1,2,50.0,1,1,0,1,1,1,0
23,Benik Afobe,4,3,1,2,1,1,6,16.7,5,4,0,4,0,6,0
24,Martin Agirregabiria,50,33,31,17,2,32,50,64.0,18,13,7,6,41,66,0
25,Imanol Agirretxe,0,0,0,0,0,0,1,0.0,1,0,0,0,0,2,0
26,Sergio Agüero,9,6,2,6,1,2,17,11.8,15,12,1,11,6,3,0
27,Ruben Aguilar,91,50,37,41,13,36,71,50.7,35,25,3,22,37,90,0
28,Matías Aguirregaray,26,20,12,12,2,12,32,37.5,20,13,1,12,24,25,0
29,Jean-Eudes Aholou,70,34,32,37,1,17,55,30.9,38,29,7,22,75,58,1
30,Ailton,8,5,3,5,0,4,8,50.0,4,5,0,5,2,5,0
31,Youssef Aït Bennasser,47,28,17,27,3,15,64,23.4,49,35,2,33,32,30,0
32,Arlind Ajeti,42,23,25,14,3,18,30,60.0,12,27,15,12,34,82,0
33,Manuel Akanji,22,15,14,8,0,15,17,88.2,2,11,4,7,7,43,2
34,Nathan Aké,53,32,34,16,3,22,40,55.0,18,47,24,23,48,246,2
35,Ager Aketxe,1,1,1,0,0,1,2,50.0,1,1,0,1,1,0,0
36,Chadrac Akolo,20,14,3,12,5,6,14,42.9,8,19,0,19,5,5,0
37,Kevin Akpoguma,47,39,29,16,2,24,35,68.6,11,18,4,14,22,60,1
38,David Alaba,23,14,11,9,3,14,20,70.0,6,21,6,15,10,23,0
39,Lucas Alario,16,10,2,12,2,3,8,37.5,5,17,4,13,4,16,0
40,David Alba,1,1,1,0,0,1,1,100.0,0,0,0,0,0,7,1
41,Jordi Alba,63,42,35,22,6,26,52,50.0,26,34,5,29,68,67,1
42,Raúl Albentosa,13,6,9,4,0,7,20,35.0,13,26,19,7,26,92,1
43,Luis Alberto,39,28,8,23,8,10,44,22.7,34,30,2,28,16,7,0
44,Raúl Albiol,29,19,15,14,0,13,19,68.4,6,18,13,5,32,129,1
45,Miiko Albornoz,24,20,17,4,3,11,16,68.8,5,15,2,13,5,23,0
46,Marc Albrighton,52,33,16,29,7,16,52,30.8,36,32,4,28,27,34,0
47,Paco Alcácer,4,3,0,2,2,0,6,0.0,6,5,0,5,11,3,0
48,Pedro Alcalá,9,5,5,4,0,1,3,33.3,2,7,3,4,14,41,0
49,Thiago Alcántara,45,35,11,25,9,15,26,57.7,11,22,3,19,27,6,1
50,David Alcibiade,9,5,5,3,1,2,4,50.0,2,5,3,2,7,8,0
51,Toby Alderweireld,19,13,7,11,1,8,15,53.3,7,11,5,6,4,55,0
52,Steve Aldo One,1,0,0,1,0,0,0,,0,0,0,0,0,7,0
53,Álex Alegría,8,5,1,3,4,2,6,33.3,4,7,0,7,4,9,0
54,Iván Alejo,20,16,4,9,7,1,10,10.0,9,9,0,9,5,1,0
55,Alexander,14,11,2,11,1,2,12,16.7,10,11,0,11,22,4,0
56,Trent Alexander-Arnold,37,25,23,9,5,22,36,61.1,14,20,5,15,28,46,1
57,Alexis,33,24,24,7,2,20,45,44.4,25,28,14,14,30,114,3
58,Alisson,1,0,1,0,0,0,1,0.0,1,0,0,0,2,22,4
59,Allan,107,68,24,65,18,36,104,34.6,68,52,3,49,28,16,0
60,Joe Allen,96,62,41,43,12,27,87,31.0,60,43,9,34,58,68,1
61,Dele Alli,46,30,15,21,10,8,34,23.5,26,33,7,26,19,22,1
62,Júnior Alonso,58,31,36,22,0,28,50,56.0,22,26,16,10,56,153,1
63,José Alonso Lara,0,0,0,0,0,0,0,,0,0,0,0,0,0,0
64,Marcos Alonso,51,33,30,18,3,23,44,52.3,21,36,5,31,47,76,1
65,Ricky Álvarez,4,2,1,3,0,1,4,25.0,3,5,0,5,2,3,0
66,Sergio Álvarez,0,0,0,0,0,0,1,0.0,1,1,0,1,0,11,1
67,Yeray Álvarez,12,7,8,4,0,6,9,66.7,3,8,2,6,11,18,0
68,Dani Alves,80,57,45,27,8,33,58,56.9,25,24,3,21,28,21,0
69,Ibrahim Amadou,43,29,24,19,0,14,27,51.9,13,30,13,17,41,70,3
70,Eloi Amagat,0,0,0,0,0,0,1,0.0,1,0,0,0,0,0,0
71,Morgan Amalfitano,8,5,3,3,2,2,5,40.0,3,6,0,6,4,7,0
72,Romain Amalfitano,59,37,18,38,3,25,69,36.2,44,29,7,22,85,35,2
73,Daniel Amartey,8,4,7,1,0,3,7,42.9,4,7,3,4,7,21,1
74,Jordi Amat,32,23,15,16,1,11,24,45.8,13,14,4,10,38,77,2
75,Amath,78,53,32,28,18,24,89,27.0,65,36,3,33,33,20,0
76,Jordan Amavi,52,35,32,12,8,23,56,41.1,33,28,11,17,45,86,1
77,Stephan Ambrosius,0,0,0,0,0,0,0,,0,2,1,1,1,4,0
78,Kelvin Amian,59,43,45,10,4,22,31,71.0,9,25,7,18,45,127,1
79,Nadiem Amiri,39,26,13,21,5,19,42,45.2,23,33,4,29,17,7,0
80,Ethan Ampadu,1,1,0,1,0,0,0,,0,0,0,0,0,2,0
81,Nordin Amrabat,6,3,1,5,0,1,3,33.3,2,1,0,1,0,2,0
82,Nordin Amrabat,19,10,5,10,4,5,17,29.4,12,13,0,13,5,2,0
83,Jon Ander Serantes,0,0,0,0,0,0,0,,0,0,0,0,0,0,1
84,Joachim Andersen,8,3,6,2,0,4,4,100.0,0,6,4,2,9,41,1
85,Felipe Anderson,34,21,7,11,16,6,35,17.1,29,17,0,17,11,8,1
86,Florin Andone,9,7,4,4,1,4,17,23.5,13,9,2,7,3,12,0
87,Nícolas Andrade,2,1,2,0,0,1,4,25.0,3,2,0,2,2,16,7
88,Benjamin André,93,54,36,50,7,43,113,38.1,70,56,4,52,57,96,1
89,Marco Andreolli,25,17,20,4,1,12,20,60.0,8,24,17,7,30,139,0
90,Yoann Andreu,48,30,40,6,2,16,39,41.0,23,23,5,18,37,75,1
91,Miguel Ángel Guerrero,7,5,0,2,5,1,11,9.1,10,11,0,11,9,16,0
92,José Ángel,61,44,36,19,6,38,58,65.5,20,31,1,30,38,76,0
93,Miguel Ángel Moyá,0,0,0,0,0,0,1,0.0,1,0,0,0,2,7,0
94,Miguel Ángel Rubio,0,0,0,0,0,0,0,,0,0,0,0,0,1,0
95,Gabriele Angella,15,13,11,3,1,8,11,72.7,3,11,9,2,21,66,0
96,Cristian Ansaldi,49,33,25,20,4,14,37,37.8,23,23,5,18,20,61,0
97,Luca Antei,19,14,12,7,0,6,11,54.5,5,10,8,2,26,35,0
98,Mirco Antenucci,16,13,6,8,2,0,21,0.0,21,14,0,14,11,15,0
99,Waldemar Anton,65,49,39,21,5,41,65,63.1,24,56,27,29,39,112,3
100,Luca Antonelli,1,1,0,0,1,0,2,0.0,2,1,0,1,1,8,0
101,Michail Antonio,15,9,7,6,2,4,14,28.6,10,14,0,14,13,16,0
102,Mirko Antonucci,0,0,0,0,0,0,0,,0,0,0,0,0,0,0
103,Vitorino Antunes,58,44,42,14,2,38,74,51.4,36,31,3,28,58,89,1
104,Dennis Aogo,35,26,17,18,0,14,22,63.6,8,27,3,24,29,27,1
105,Houssem Aouar,66,42,22,39,5,20,66,30.3,46,30,0,30,39,34,0
106,Alberto Aquilani,33,19,13,17,3,11,31,35.5,20,20,4,16,23,23,0
107,Mauro Arambarri,56,41,19,30,7,14,47,29.8,33,26,3,23,25,36,0
108,Guilherme Arana,4,2,3,1,0,1,1,100.0,0,0,0,0,5,8,0
109,Charles Aránguiz,75,61,17,50,8,33,62,53.2,29,46,5,41,48,27,2
110,Luiz Araújo,41,31,23,17,1,10,47,21.3,37,24,0,24,16,11,1
111,Sergio Araujo,3,2,0,0,3,1,1,100.0,0,0,0,0,0,0,0
112,Anaitz Arbilla,38,30,24,12,2,21,40,52.5,19,21,10,11,78,108,2
113,Alphonse Areola,0,0,0,0,0,0,1,0.0,1,0,0,0,0,7,4
114,Scott Arfield,36,26,20,13,3,19,44,43.2,25,22,1,21,11,24,0
115,Samuel Armenteros,4,2,1,3,0,0,3,0.0,3,1,1,0,1,3,0
116,Yoël Armougom,2,1,0,1,1,1,1,100.0,0,1,1,0,1,2,1
117,José Arnaiz,1,1,0,1,0,0,0,,0,0,0,0,0,0,0
118,Marko Arnautović,21,16,9,8,4,7,19,36.8,12,20,3,17,13,35,0
119,Maximilian Arnold,51,41,23,23,5,25,57,43.9,32,31,4,27,28,34,0
120,Jann-Fiete Arp,7,5,0,3,4,1,7,14.3,6,6,0,6,2,7,0
121,Alejandro Arribas,2,2,1,1,0,1,5,20.0,4,5,3,2,6,8,0
122,Kepa Arrizabalaga,0,0,0,0,0,0,2,0.0,2,0,0,0,2,6,2
123,Harry Arter,19,16,10,7,2,6,23,26.1,17,18,5,13,9,6,0
124,Aythami Artiles,2,2,2,0,0,0,1,0.0,1,2,1,1,2,19,0
125,Kwadwo Asamoah,28,21,12,14,2,15,23,65.2,8,11,0,11,18,30,0
126,Takuma Asano,7,5,3,3,1,2,8,25.0,6,7,0,7,3,2,0
127,Santiago Ascacíbar,91,65,41,43,7,41,74,55.4,33,45,10,35,47,38,1
128,Sergio Asenjo,2,2,2,0,0,1,5,20.0,4,0,0,0,0,11,2
129,Marco Asensio,26,17,7,13,6,11,26,42.3,15,15,0,15,9,2,0
130,Iago Aspas,26,22,10,10,6,5,34,14.7,29,15,1,14,23,11,1
131,Benoît Assou-Ekotto,12,9,5,6,1,5,15,33.3,10,7,4,3,46,21,0
132,Simon Asta,2,1,2,0,0,2,2,100.0,0,1,0,1,0,0,0
133,Davide Astori,47,31,33,13,1,18,29,62.1,11,29,17,12,51,131,2
134,Christian Atsu,17,16,10,7,0,7,20,35.0,13,35,5,30,13,27,1
135,Pierre-Emerick Aubameyang,5,4,3,2,0,1,7,14.3,6,14,1,13,3,7,0
136,Pierre-Emerick Aubameyang,5,5,1,1,3,2,8,25.0,6,16,1,15,3,1,0
137,Jean-Kévin Augustin,16,11,4,11,1,3,7,42.9,4,17,1,16,4,4,0
138,Ludwig Augustinsson,45,34,22,20,3,22,32,68.8,10,25,3,22,39,53,0
139,Yann Aurel Bisseck,2,2,2,0,0,1,1,100.0,0,1,1,0,3,8,0
140,Serge Aurier,48,27,27,13,8,11,31,35.5,20,20,1,19,31,54,1
141,Charlie Austin,7,5,1,3,3,3,10,30.0,7,15,3,12,1,10,0
142,Danilo Avelar,41,33,27,9,5,14,45,31.1,31,16,7,9,37,83,1
143,Felipe Avenatti,6,4,1,5,0,1,2,50.0,1,7,1,6,1,6,0
144,Durel Avounou,16,11,6,9,1,5,17,29.4,12,12,1,11,10,25,0
145,Chidozie Awaziem,43,30,33,10,0,28,40,70.0,12,18,11,7,16,97,0
146,André Ayew,19,14,6,10,3,6,19,31.6,13,5,0,5,4,3,0
147,André Ayew,15,10,3,10,2,2,13,15.4,11,13,1,12,5,8,0
148,Jordan Ayew,82,60,20,35,27,15,54,27.8,39,43,3,40,24,20,1
149,Karim Azamoum,84,57,41,37,6,27,68,39.7,41,30,11,19,26,61,3
150,César Azpilicueta,80,59,47,26,7,27,54,50.0,27,48,22,26,54,135,1
151,Ludovic Baal,41,27,29,8,4,13,35,37.1,22,13,2,11,15,37,1
152,Khouma Babacar,4,4,3,0,1,2,4,50.0,2,0,0,0,2,5,0
153,Khouma Babacar,10,6,2,4,4,2,6,33.3,4,8,0,8,3,1,0
154,Carlos Bacca,10,2,2,4,4,1,12,8.3,11,16,1,15,8,16,0
155,Milan Badelj,71,41,26,38,7,28,71,39.4,43,48,2,46,71,52,3
156,Holger Badstuber,44,32,29,14,1,22,39,56.4,17,27,14,13,41,111,4
157,Dylan Bahamboula,0,0,0,0,0,0,0,,0,0,0,0,0,0,0
158,Farès Bahlouli,10,8,4,3,3,2,7,28.6,5,7,0,7,1,1,0
159,Stéphane Bahoken,16,11,3,8,5,4,22,18.2,18,18,1,17,9,1,0
160,Daniel Baier,83,62,38,40,5,46,83,55.4,37,26,5,21,57,41,1
161,Leon Bailey,16,12,7,4,5,8,13,61.5,5,28,0,28,15,6,0
162,Eric Bailly,17,10,10,5,2,5,12,41.7,7,11,6,5,25,58,1
163,Leighton Baines,25,13,18,3,4,9,14,64.3,5,18,6,12,25,56,0
164,Riad Bajić,0,0,0,0,0,0,0,,0,0,0,0,0,3,0
165,Marvin Bakalorz,44,25,19,23,2,22,37,59.5,15,38,7,31,20,46,1
166,Cédric Bakambu,10,7,3,6,1,1,7,14.3,6,9,1,8,3,27,0
167,Tiemoué Bakayoko,64,41,25,32,7,16,48,33.3,32,23,6,17,37,38,4
168,Zakaria Bakkali,12,10,7,4,1,4,14,28.6,10,5,0,5,4,6,0
169,Ridle Baku,3,3,1,1,1,0,1,0.0,1,3,0,3,3,2,0
170,Keita Baldé,12,8,5,6,1,1,11,9.1,10,10,1,9,6,5,0
171,Sam Baldock,0,0,0,0,0,0,0,,0,0,0,0,0,0,0
172,Gareth Bale,19,13,7,8,4,3,14,21.4,11,13,1,12,12,18,0
173,Mikel Balenziaga,34,24,17,13,4,15,27,55.6,12,24,5,19,17,61,0
174,Andrija Balić,18,9,5,12,1,8,27,29.6,19,6,3,3,16,13,0
175,Iván Balliu,34,22,22,6,6,12,28,42.9,16,23,9,14,27,64,1
176,Fodé Ballo-Touré,50,36,29,16,5,21,47,44.7,26,27,2,25,28,47,1
177,Florent Balmont,14,9,4,9,1,4,25,16.0,21,15,1,14,8,5,0
178,Leon Balogun,39,32,27,11,1,22,31,71.0,9,21,9,12,32,64,0
179,Mario Balotelli,7,4,1,3,3,0,6,0.0,6,9,2,7,8,26,0
180,Abdoulaye Bamba,29,22,23,6,0,16,30,53.3,14,8,1,7,11,52,0
181,Jonathan Bamba,30,21,18,11,1,12,61,19.7,49,30,4,26,19,17,0
182,Yacine Bammou,18,11,6,10,2,4,14,28.6,10,16,4,12,6,9,0
183,Éver Banega,71,53,25,37,9,22,63,34.9,41,23,1,22,12,17,3
184,Mattia Bani,28,20,22,6,0,11,26,42.3,15,19,10,9,27,111,0
185,Beni Baningime,6,2,1,2,3,0,4,0.0,4,5,1,4,2,2,0
186,Léo Baptistão,54,34,12,28,14,13,52,25.0,39,22,1,21,23,25,0
187,Sekou Baradji,0,0,0,0,0,0,0,,0,0,0,0,1,0,0
188,Antonín Barák,58,38,22,27,9,21,58,36.2,37,34,2,32,18,26,1
189,Andrea Barberis,80,44,33,42,5,16,68,23.5,52,52,5,47,58,67,1
190,Mariano Barbosa,0,0,0,0,0,0,0,,0,0,0,0,1,4,0
191,Enis Bardhi,39,26,14,16,9,10,38,26.3,28,11,0,11,16,7,0
192,Phil Bardsley,17,16,9,7,1,4,11,36.4,7,22,6,16,22,77,0
193,Nicolò Barella,92,69,37,43,12,25,78,32.1,53,48,6,42,45,53,0
194,Philipp Bargfrede,60,45,29,30,1,33,55,60.0,22,35,12,23,47,52,0
195,Ross Barkley,0,0,0,0,0,0,1,0.0,1,3,1,2,0,2,0
196,Aymen Barkok,11,11,6,4,1,5,7,71.4,2,8,2,6,2,3,0
197,Ashley Barnes,21,14,1,14,6,5,29,17.2,24,26,5,21,2,19,0
198,Harvey Barnes,0,0,0,0,0,0,0,,0,0,0,0,0,0,0
199,Antonio Barragán,59,42,40,11,8,24,36,66.7,12,22,5,17,24,66,0
200,Antonio Barreca,9,8,3,5,1,4,4,100.0,0,3,0,3,5,16,0
201,Édgar Barreto,67,42,23,32,12,18,70,25.7,52,45,2,43,21,29,3
202,Barri,1,0,0,1,0,0,4,0.0,4,1,1,0,1,3,0
203,Musa Barrow,5,2,1,3,1,2,4,50.0,2,2,0,2,1,2,0
204,Gareth Barry,35,19,17,14,4,15,45,33.3,30,19,11,8,14,34,0
205,Fin Bartels,12,9,4,3,5,4,12,33.3,8,5,1,4,7,1,1
206,Kyle Bartley,3,2,3,0,0,2,2,100.0,0,6,6,0,4,21,0
207,Marc Bartra,38,28,30,8,0,21,39,53.8,18,19,10,9,32,97,1
208,Marc Bartra,28,19,16,12,0,15,24,62.5,9,14,2,12,28,43,1
209,Andrea Barzagli,26,15,14,11,1,9,16,56.3,7,14,7,7,17,46,0
210,Daniele Baselli,63,33,23,36,4,20,56,35.7,36,29,5,24,57,40,1
211,Nicolas Basin,9,7,5,3,1,4,9,44.4,5,6,3,3,8,14,0
212,Dušan Basta,9,7,4,3,2,6,14,42.9,8,10,3,7,13,15,0
213,Gil Bastião Dias,49,31,28,15,6,19,48,39.6,29,23,0,23,19,12,1
214,Gil Bastião Dias,1,1,0,1,0,0,0,,0,0,0,0,0,0,0
215,Samuel Bastien,17,13,7,8,2,7,23,30.4,16,23,2,21,18,25,0
216,Borja Bastón,9,7,1,6,2,1,13,7.7,12,7,0,7,3,5,0
217,Alessandro Bastoni,2,2,2,0,0,1,1,100.0,0,0,0,0,1,3,0
218,Bastos,33,24,19,13,1,19,30,63.3,11,13,8,5,24,67,0
219,Michy Batshuayi,5,4,2,3,0,1,3,33.3,2,0,0,0,1,3,0
220,Michy Batshuayi,8,6,1,4,3,2,4,50.0,2,4,0,4,0,5,0
221,Moritz Bauer,24,17,17,7,0,10,26,38.5,16,9,1,8,12,48,0
222,Robert Bauer,31,25,21,9,1,15,25,60.0,10,8,2,6,21,25,2
223,Oliver Baumann,0,0,0,0,0,0,2,0.0,2,0,0,0,1,15,6
224,Timo Baumgartl,87,71,55,29,3,56,75,74.7,19,50,21,29,34,132,1
225,Julian Baumgartlinger,47,37,21,21,5,14,29,48.3,15,25,2,23,18,23,0
226,Jon Bautista,0,0,0,0,0,0,1,0.0,1,2,0,2,0,0,0
227,Paul Baysse,25,16,21,3,1,10,17,58.8,7,10,6,4,20,84,0
228,Paul Baysse,4,2,3,1,0,1,5,20.0,4,4,3,1,7,38,1
229,Noah Joel Sarenren Bazee,0,0,0,0,0,0,0,,0,3,0,3,0,3,0
230,Hervé Bazile,21,15,9,7,5,5,15,33.3,10,22,0,22,15,8,0
231,Riechedly Bazoer,8,7,5,2,1,2,4,50.0,2,2,1,1,8,4,1
232,Enrico Bearzotti,3,2,2,0,1,1,4,25.0,3,3,1,2,4,18,0
233,Claudio Beauvue,5,3,2,2,1,1,12,8.3,11,7,0,7,2,16,0
234,Bebé,9,7,1,4,4,3,8,37.5,5,5,0,5,3,1,0
235,Ihlas Bebou,37,29,15,17,5,14,27,51.9,13,34,3,31,24,27,0
236,Andreas Beck,46,29,27,16,3,21,31,67.7,10,32,2,30,19,46,1
237,Henri Bedimo,0,0,0,0,0,0,1,0.0,1,0,0,0,1,1,0
238,Jan Bednarek,6,3,6,0,0,3,6,50.0,3,2,1,1,5,27,0
239,Asmir Begović,0,0,0,0,0,0,2,0.0,2,0,0,0,2,16,7
240,Valon Behrami,63,46,30,27,6,8,44,18.2,36,47,15,32,22,19,0
241,Vid Belec,0,0,0,0,0,0,0,,0,0,0,0,1,6,1
242,Vid Belec,0,0,0,0,0,0,0,,0,0,0,0,0,1,0
243,Ishak Belfodil,7,6,2,3,2,0,3,0.0,3,10,1,9,1,9,0
244,Stefan Bell,36,25,23,13,0,27,39,69.2,12,35,18,17,46,123,2
245,Karim Bellarabi,22,17,10,9,3,10,19,52.6,9,26,1,25,13,5,0
246,Héctor Bellerín,57,43,36,12,9,25,52,48.1,27,42,8,34,23,89,4
247,François Bellugou,48,33,23,21,4,21,49,42.9,28,20,6,14,28,45,0
248,Andrea Belotti,32,23,9,15,8,3,30,10.0,27,14,1,13,6,19,1
249,Chaouki Ben Saada,11,8,5,3,3,2,11,18.2,9,3,0,3,2,3,0
250,Wissam Ben Yedder,12,8,2,5,5,1,2,50.0,1,10,0,10,5,2,0
251,Diego Benaglio,0,0,0,0,0,0,0,,0,0,0,0,0,0,0
252,Ahmad Benali,19,10,8,10,1,5,27,18.5,22,14,1,13,8,15,0
253,Yohan Benalouane,7,3,6,1,0,4,6,66.7,2,1,1,0,1,4,0
254,Marco Benassi,54,38,18,22,14,17,52,32.7,35,52,2,50,28,36,0
255,Medhi Benatia,28,21,20,6,2,8,15,53.3,7,18,13,5,43,89,1
256,Lars Bender,63,52,26,32,5,35,53,66.0,18,34,7,27,28,40,0
257,Sven Bender,51,37,33,18,0,26,34,76.5,8,49,21,28,50,123,1
258,László Bénes,0,0,0,0,0,0,1,0.0,1,2,1,1,1,2,0
259,Nicolas Benezet,38,30,18,16,4,11,37,29.7,26,8,2,6,12,7,0
260,Marcel Benger,0,0,0,0,0,0,0,,0,0,0,0,0,0,0
261,Walter Benítez,0,0,0,0,0,0,2,0.0,2,0,0,0,0,5,3
262,Charlison Benschop,4,4,1,3,0,3,8,37.5,5,1,0,1,2,2,0
263,Ramy Bensebaini,56,39,31,21,4,26,55,47.3,29,24,16,8,37,177,1
264,Nabil Bentaleb,25,22,7,17,1,8,23,34.8,15,18,6,12,23,27,2
265,Rodrigo Bentancur,18,11,10,7,1,2,16,12.5,14,5,1,4,3,14,0
266,Christian Benteke,11,4,3,7,1,2,17,11.8,15,15,3,12,3,44,0
267,Karim Benzema,14,8,2,6,6,3,20,15.0,17,18,0,18,8,19,0
268,Yassine Benzia,62,41,21,31,10,17,62,27.4,45,31,4,27,28,14,0
269,Saido Berahino,2,2,0,1,1,0,1,0.0,1,4,1,3,1,2,0
270,Domenico Berardi,31,17,9,16,6,11,65,16.9,54,23,0,23,17,14,1
271,Yuri Berchiche,39,27,21,11,7,12,25,48.0,13,15,2,13,24,53,0
272,Álex Berenguer,18,15,7,8,3,5,17,29.4,12,22,3,19,10,13,0
273,Bartosz Bereszyński,63,47,30,28,5,31,53,58.5,22,33,8,25,30,98,2
274,Jóhann Berg Guðmundsson,43,27,16,19,8,20,47,42.6,27,21,1,20,34,43,0
275,Markel Bergara,35,22,17,17,1,7,25,28.0,18,10,3,7,23,20,0
276,Emil Berggreen,2,2,0,0,2,1,4,25.0,3,7,1,6,1,10,0
277,Robert Berić,6,4,1,3,2,1,16,6.3,15,9,1,8,5,4,0
278,Kévin Bérigaud,4,3,1,1,2,2,6,33.3,4,1,0,1,0,1,0
279,Etrit Berisha,1,1,1,0,0,1,1,100.0,0,0,0,0,1,5,3
280,Federico Bernardeschi,8,5,4,3,1,1,7,14.3,6,9,0,9,11,18,1
281,Bernardo,43,30,18,22,3,29,40,72.5,11,30,6,24,18,81,0
282,Juan Bernat,25,19,13,8,4,11,18,61.1,7,11,1,10,10,9,1
283,Andrea Bertolacci,85,53,40,38,7,21,63,33.3,42,46,12,34,46,37,1
284,Ryan Bertrand,48,35,27,17,4,19,31,61.3,12,28,9,19,44,74,0
285,Muhamed Bešić,1,1,1,0,0,1,3,33.3,2,2,2,0,0,1,0
286,Daniel Bessa,26,19,9,15,2,8,29,27.6,21,12,2,10,14,8,1
287,Daniel Bessa,6,6,2,2,2,0,1,0.0,1,7,0,7,3,6,0
288,Vincent Bessat,41,27,23,16,2,22,48,45.8,26,19,1,18,18,18,0
289,Quentin Beunardeau,0,0,0,0,0,0,0,,0,0,0,0,0,0,0
290,Matteo Bianchetti,3,1,3,0,0,1,3,33.3,2,3,2,1,2,8,0
291,Ermin Bičakčić,17,15,8,8,1,8,12,66.7,4,4,2,2,9,26,0
292,Pedro Bigas,14,9,10,4,0,7,13,53.8,6,18,11,7,16,41,2
293,Lucas Biglia,59,36,28,26,5,22,61,36.1,39,49,12,37,28,51,1
294,Philip Billing,25,16,11,11,3,8,22,36.4,14,17,1,16,18,19,0
295,Jean-Claude Billong,9,7,5,4,0,5,8,62.5,3,4,3,1,6,17,0
296,Davide Biondini,4,4,2,2,0,1,2,50.0,1,1,0,1,3,1,0
297,Cristiano Biraghi,74,48,33,32,9,36,58,62.1,22,42,5,37,43,103,2
298,Mame Biram Diouf,48,36,26,15,7,8,21,38.1,13,22,0,22,14,76,1
299,Davide Biraschi,33,25,13,19,1,18,25,72.0,7,19,10,9,38,78,0
300,Valter Birsa,28,14,7,18,3,7,54,13.0,47,22,2,20,24,20,1
301,Milan Biševac,7,5,5,1,1,5,7,71.4,2,2,0,2,5,43,0
302,Yves Bissouma,67,50,30,32,5,19,39,48.7,20,13,2,11,31,31,1
303,Leonardo Bittencourt,49,42,17,21,11,19,43,44.2,24,26,0,26,17,11,1
304,Albano Bizzarri,2,2,2,0,0,2,2,100.0,0,0,0,0,1,12,4
305,Rubén Blanco,0,0,0,0,0,0,2,0.0,2,1,0,1,3,16,1
306,Ludovic Blas,23,14,10,12,1,7,36,19.4,29,15,3,12,19,9,1
307,Pablo de Blasis,39,23,19,11,9,16,33,48.5,17,33,0,33,10,34,0
308,Jérémy Blayac,5,3,0,3,2,2,9,22.2,7,7,2,5,1,11,0
309,Alexis Blin,57,37,23,30,4,22,69,31.9,47,27,6,21,31,31,0
310,Daley Blind,6,4,3,2,1,2,7,28.6,5,3,0,3,7,14,0
311,Danny Blum,0,0,0,0,0,0,0,,0,0,0,0,1,0,0
312,Emmanuel Boateng,4,3,0,0,4,0,6,0.0,6,8,1,7,5,17,0
313,Jérôme Boateng,26,18,18,7,1,19,32,59.4,13,20,12,8,21,52,1
314,Kevin-Prince Boateng,34,22,10,22,2,11,36,30.6,25,29,6,23,23,43,1
315,Raúl Bobadilla,7,6,1,3,3,4,8,50.0,4,6,0,6,0,1,0
316,Yann Bodiger,3,1,0,3,0,1,6,16.7,5,0,0,0,2,3,0
317,Mathieu Bodmer,6,3,5,1,0,5,6,83.3,1,6,3,3,1,15,0
318,Jeremie Boga,0,0,0,0,0,0,0,,0,0,0,0,0,0,0
319,Quentin Boisgard,2,2,0,2,0,0,3,0.0,3,2,0,2,0,1,0
320,Yannick Bolasie,8,7,4,1,3,2,7,28.6,5,5,0,5,4,8,0
321,Deian Boldor,3,2,3,0,0,2,3,66.7,1,5,2,3,3,11,0
322,Giacomo Bonaventura,31,20,7,19,5,9,45,20.0,36,31,6,25,33,17,0
323,Federico Bonazzoli,1,0,0,1,0,0,0,,0,3,0,3,0,0,0
324,Federico Bonazzoli,0,0,0,0,0,0,0,,0,0,0,0,0,0,0
325,Daniele Bonera,16,11,8,7,1,10,15,66.7,5,17,12,5,12,72,0
326,Gaëtan Bong,39,32,25,11,3,15,26,57.7,11,24,6,18,40,81,1
327,Kevin Bonifazi,11,7,6,5,0,4,6,66.7,2,7,5,2,13,15,0
328,Landry Bonnefoi,0,0,0,0,0,0,0,,0,0,0,0,0,2,0
329,Leonardo Bonucci,30,21,22,7,1,11,18,61.1,7,31,22,9,51,132,0
330,Wilfried Bony,5,4,2,2,1,1,5,20.0,4,4,1,3,2,15,0
331,Celso Borges,61,39,34,22,5,15,47,31.9,32,39,7,32,34,36,0
332,Fabio Borini,38,23,12,18,8,16,37,43.2,21,32,6,26,13,43,0
333,Marco Borriello,4,2,2,1,1,0,1,0.0,1,1,0,1,1,6,0
334,Gabriel Boschilia,4,1,1,2,1,1,4,25.0,3,1,0,1,0,0,0
335,Ryad Boudebouz,32,18,6,21,5,6,26,23.1,20,18,1,17,7,8,0
336,Jean-Christophe Bouet,0,0,0,0,0,0,0,,0,0,0,0,0,0,0
337,Sofiane Boufal,37,24,12,14,11,12,35,34.3,23,20,1,19,6,6,0
338,Arnold Bouka Moutou,8,5,6,0,2,6,8,75.0,2,4,1,3,4,5,0
339,Farid Boulaya,5,1,4,1,0,3,6,50.0,3,1,0,1,1,2,0
340,Yassine Bounou,1,1,1,0,0,0,2,0.0,2,0,0,0,4,14,0
341,Emmanuel Bourgaud,17,11,5,9,3,10,23,43.5,13,5,0,5,6,11,0
342,Benjamin Bourigeaud,55,30,18,30,7,20,93,21.5,73,48,4,44,45,29,0
343,Eneko Bóveda,24,16,13,10,1,8,13,61.5,5,18,7,11,16,36,2
344,Eneko Bóveda,12,11,7,4,1,5,11,45.5,6,3,0,3,14,14,0
345,Lucas Boyé,9,8,5,3,1,1,3,33.3,2,5,0,5,2,2,0
346,Lucas Boyé,12,8,3,7,2,3,10,30.0,7,5,0,5,6,4,0
347,Robbie Brady,32,21,14,17,1,8,28,28.6,20,17,3,14,7,29,0
348,Martin Braithwaite,6,4,0,4,2,1,6,16.7,5,6,2,4,0,3,0
349,Brandon,10,9,3,4,3,1,11,9.1,10,11,1,10,5,1,0
350,Julian Brandt,24,18,11,9,4,11,29,37.9,18,23,1,22,16,12,1
351,Darko Brašanac,32,17,11,17,4,13,33,39.4,20,14,3,11,14,12,0
352,Claudio Bravo,0,0,0,0,0,0,1,0.0,1,0,0,0,0,0,0
353,Josip Brekalo,15,12,6,7,2,6,12,50.0,6,17,0,17,4,3,0
354,Josip Brekalo,20,12,7,8,5,6,8,75.0,2,8,2,6,3,1,0
355,Jimmy Briand,33,21,13,15,5,4,42,9.5,38,17,2,15,12,51,0
356,Enrico Brignola,28,21,17,10,1,12,38,31.6,26,13,0,13,6,7,0
357,Alberto Brignoli,0,0,0,0,0,0,0,,0,0,0,0,0,15,3
358,Miguel Britos,15,11,10,5,0,6,11,54.5,5,9,1,8,12,45,1
359,Leon Britton,6,5,0,5,1,5,8,62.5,3,3,1,2,1,1,0
360,Petar Brlek,9,7,4,5,0,3,7,42.9,4,0,0,0,1,3,0
361,John Brooks,20,13,15,4,1,16,22,72.7,6,11,5,6,10,46,0
362,Daniel Brosinski,45,35,21,18,6,22,44,50.0,22,46,11,35,24,75,2
363,Izzy Brown,3,3,2,1,0,1,7,14.3,6,3,0,3,1,3,0
364,Marcelo Brozović,60,43,21,31,8,19,63,30.2,44,30,7,23,18,18,0
365,Bruma,18,16,7,7,4,9,18,50.0,9,28,2,26,12,11,0
366,Jeffrey Bruma,13,11,13,0,0,6,14,42.9,8,17,12,5,14,43,2
367,Bruno,30,17,21,6,3,14,22,63.6,8,17,11,6,38,76,0
368,Chris Brunt,41,24,19,21,1,11,31,35.5,20,28,4,24,22,45,1
369,Jacob Bruun Larsen,0,0,0,0,0,0,0,,0,1,0,1,1,2,0
370,Jacob Bruun Larsen,1,1,1,0,0,1,2,50.0,1,0,0,0,0,0,0
371,Marcel Büchel,37,21,15,21,1,13,48,27.1,35,35,6,29,45,46,1
372,Ante Budimir,28,20,4,16,8,2,20,10.0,18,20,3,17,7,27,0
373,Alberto Bueno,3,2,2,1,0,2,11,18.2,9,2,0,2,1,2,0
374,Gianluigi Buffon,0,0,0,0,0,0,0,,0,0,0,0,0,11,2
375,Onur Bulut,0,0,0,0,0,0,1,0.0,1,0,0,0,0,0,0
376,Alessandro Buongiorno,0,0,0,0,0,0,0,,0,0,0,0,0,1,0
377,Nicolás Burdisso,20,11,13,7,0,7,11,63.6,4,23,14,9,30,124,3
378,Guido Burgstaller,14,9,0,10,4,4,14,28.6,10,28,3,25,10,9,0
379,Burgui,10,5,2,4,4,2,6,33.3,4,5,0,5,7,1,0
380,Oliver Burke,6,4,3,2,1,4,12,33.3,8,3,0,3,7,3,0
381,Roman Bürki,1,1,1,0,0,1,3,33.3,2,1,0,1,0,10,4
382,Patrick Burner,18,12,13,5,0,7,20,35.0,13,6,0,6,13,23,0
383,Dženis Burnić,9,6,2,5,2,4,10,40.0,6,2,0,2,4,3,0
384,Sergio Busquets,88,48,27,46,15,39,79,49.4,40,37,10,27,51,15,1
385,Unai Bustinza,36,21,25,8,3,21,38,55.3,17,17,9,8,47,64,0
386,Ludovic Butelle,0,0,0,0,0,0,0,,0,0,0,0,1,10,2
387,Jack Butland,1,1,1,0,0,1,1,100.0,0,1,0,1,1,26,1
388,Sam Byram,9,5,6,3,0,4,9,44.4,5,6,2,4,9,16,0
389,Jakub Błaszczykowski,12,8,8,2,2,6,13,46.2,7,11,3,8,5,3,0
390,Erick Cabaco,25,14,21,4,0,14,20,70.0,6,10,8,2,17,71,2
391,Willy Caballero,0,0,0,0,0,0,0,,0,0,0,0,0,3,0
392,Yohan Cabaye,70,44,39,28,3,24,97,24.7,73,47,4,43,79,29,4
393,Rémy Cabella,7,4,2,2,3,2,4,50.0,2,0,0,0,1,0,0
394,Rémy Cabella,58,39,29,22,7,17,73,23.3,56,31,0,31,14,4,2
395,Gustavo Cabral,29,21,14,15,0,14,38,36.8,24,22,11,11,43,106,2
396,Leandro Cabrera,8,5,8,0,0,0,3,0.0,3,5,2,3,6,33,0
397,Leandro Cabrera,19,10,12,7,0,7,17,41.2,10,9,5,4,22,37,0
398,Fabrizio Cacciatore,34,27,20,9,5,15,30,50.0,15,33,11,22,38,99,3
399,Martín Cáceres,16,11,14,1,1,7,18,38.9,11,9,5,4,19,41,1
400,Martín Cáceres,12,7,9,2,1,10,14,71.4,4,4,4,0,4,13,0
401,Cafú,9,7,3,4,2,3,11,27.3,8,3,1,2,12,13,0
402,Jonathan Cafu,16,9,7,6,3,5,13,38.5,8,6,1,5,10,1,0
403,Gary Cahill,29,21,15,9,5,10,21,47.6,11,21,14,7,27,127,1
404,Yannick Cahuzac,39,28,20,19,0,15,26,57.7,11,29,10,19,30,42,0
405,Felipe Caicedo,11,10,3,5,3,2,7,28.6,5,6,0,6,1,4,0
406,Caiuby,53,40,20,27,6,17,42,40.5,25,36,1,35,15,42,2
407,Cala,21,14,16,5,0,13,27,48.1,14,21,10,11,39,124,0
408,Davide Calabria,64,50,33,24,7,21,41,51.2,20,19,4,15,33,82,1
409,Mattia Caldara,39,26,15,24,0,13,33,39.4,20,31,18,13,41,113,1
410,Carlos Calderón,1,1,0,0,1,0,0,,0,0,0,0,0,0,0
411,Luca Caldirola,1,0,0,1,0,1,1,100.0,0,1,0,1,3,3,0
412,Hakan Çalhanoğlu,37,27,11,18,8,8,31,25.8,23,29,2,27,22,15,0
413,Fabrizio Caligara,0,0,0,0,0,0,0,,0,1,1,0,1,1,0
414,Daniel Caligiuri,100,66,48,43,9,49,94,52.1,45,59,4,55,67,71,0
415,José Callejón,33,27,15,14,4,10,47,21.3,37,42,5,37,22,31,0
416,Jonathan Calleri,24,16,5,10,9,4,23,17.4,19,15,2,13,7,35,0
417,Simone Calvano,13,12,4,9,0,3,16,18.8,13,10,4,6,15,14,1
418,Dominic Calvert-Lewin,15,8,5,3,7,2,15,13.3,13,13,1,12,10,23,1
419,Ignacio Camacho,27,21,10,16,1,9,23,39.1,14,14,5,9,41,43,0
420,Abdoul Camara,6,4,2,3,1,3,11,27.3,8,7,1,6,7,4,0
421,Souleymane Camara,6,4,0,5,1,0,3,0.0,3,3,1,2,2,15,0
422,Víctor Camarasa,20,15,8,10,2,3,13,23.1,10,8,0,8,15,13,0
423,Geoff Cameron,34,21,20,12,2,11,27,40.7,16,28,8,20,36,68,0
424,José Campaña,57,36,25,27,5,19,58,32.8,39,31,10,21,45,37,0
425,Joel Campbell,6,2,3,3,0,3,6,50.0,3,2,0,2,0,0,0
426,Tyrese Campbell,2,1,0,2,0,1,1,100.0,0,1,1,0,1,0,0
427,Emre Can,67,54,32,29,6,18,43,41.9,25,32,4,28,28,37,1
428,Sergio Canales,30,24,6,18,6,9,32,28.1,23,25,0,25,11,3,0
429,João Cancelo,42,29,27,11,4,17,42,40.5,25,15,2,13,35,51,0
430,João Cancelo,1,1,0,1,0,1,1,100.0,0,1,0,1,2,0,0
431,Antonio Candreva,12,7,7,5,0,8,39,20.5,31,20,2,18,22,24,0
432,Paolo Cannavaro,17,9,11,5,1,8,20,40.0,12,17,13,4,27,94,1
433,Ander Capa,57,38,34,14,9,25,38,65.8,13,21,2,19,52,50,1
434,Pierrick Capelle,50,37,29,17,4,16,70,22.9,54,29,0,29,34,26,0
435,Leonardo Capezzi,8,4,5,3,0,4,6,66.7,2,6,0,6,0,3,0
436,Étienne Capoue,43,26,15,25,3,19,47,40.4,28,21,1,20,43,38,0
437,Elio Capradossi,1,0,1,0,0,0,0,,0,2,2,0,2,13,0
438,Gianluca Caprari,19,11,2,11,6,0,10,0.0,10,25,2,23,5,3,0
439,Marco Capuano,20,10,14,6,0,5,15,33.3,10,19,13,6,28,93,0
440,Marco Capuano,13,9,6,7,0,4,8,50.0,4,7,2,5,6,23,1
441,Antonio Caracciolo,52,34,41,8,3,17,30,56.7,13,64,44,20,39,203,0
442,Yoan Cardinale,0,0,0,0,0,0,0,,0,0,0,0,0,0,3
443,Diego Carlos,70,42,51,15,4,28,38,73.7,10,50,29,21,29,155,3
444,Lionel Carole,12,6,7,5,0,5,7,71.4,2,6,3,3,6,29,0
445,Yannick Carrasco,17,13,7,5,5,3,8,37.5,5,9,0,9,4,3,0
446,Michael Carrick,1,1,0,1,0,0,1,0.0,1,2,0,2,1,3,0
447,Daniel Carriço,7,7,6,1,0,4,7,57.1,3,6,3,3,10,22,0
448,André Carrillo,31,24,16,12,3,8,33,24.2,25,7,0,7,15,16,0
449,Guido Carrillo,5,1,0,3,2,0,1,0.0,1,4,0,4,0,5,0
450,Guido Carrillo,3,1,0,2,1,0,4,0.0,4,3,1,2,0,8,0
451,Thomas Carrique,1,0,0,1,0,1,3,33.3,2,0,0,0,2,3,0
452,Andy Carroll,3,3,2,0,1,0,1,0.0,1,3,2,1,2,15,0
453,Tom Carroll,53,33,22,23,8,14,53,26.4,39,37,8,29,29,18,1
454,Federico Cartabia,37,23,15,15,7,11,30,36.7,19,15,0,15,18,10,0
455,Dani Carvajal,59,40,27,22,10,22,38,57.9,16,33,15,18,38,42,2
456,Casemiro,109,78,64,39,6,42,84,50.0,42,56,11,45,63,49,3
457,Kiko Casilla,1,0,1,0,0,1,1,100.0,0,0,0,0,2,6,2
458,Francesco Cassata,12,7,6,5,1,2,10,20.0,8,3,0,3,5,0,0
459,Timothy Castagne,54,37,32,14,8,13,27,48.1,14,25,4,21,26,48,0
460,Leandro Castán,24,15,16,8,0,15,20,75.0,5,16,10,6,23,48,1
461,Koen Casteels,2,1,2,0,0,2,2,100.0,0,0,0,0,1,16,1
462,Dani Castellano,46,29,29,16,1,25,48,52.1,23,28,7,21,42,64,1
463,Javi Castellano,47,27,20,25,2,20,37,54.1,17,23,6,17,38,16,1
464,Samu Castillejo,41,28,22,10,9,13,62,21.0,49,39,5,34,22,37,0
465,Chory Castro,37,24,15,14,8,11,32,34.4,21,21,2,19,23,13,0
466,Gonzalo Castro,26,18,7,18,1,5,22,22.7,17,23,3,20,10,13,1
467,Jonny Castro,102,78,60,31,11,43,91,47.3,48,48,8,40,93,92,1
468,Lucas Castro,54,40,14,29,11,16,43,37.2,27,39,7,32,38,35,0
469,Rubén Castro,1,1,0,0,1,0,0,,0,0,0,0,0,2,0
470,Danilo Cataldi,33,25,12,19,2,5,28,17.9,23,18,5,13,37,20,1
471,Craig Cathcart,8,5,5,3,0,4,5,80.0,1,8,6,2,3,38,0
472,Edinson Cavani,15,9,5,4,6,2,16,12.5,14,10,1,9,5,22,0
473,Marijan Ćavar,0,0,0,0,0,0,3,0.0,3,0,0,0,0,0,0
474,Dani Ceballos,8,7,3,2,3,4,16,25.0,12,6,0,6,5,1,0
475,Federico Ceccherini,35,21,28,4,3,13,25,52.0,12,39,21,18,83,276,1
476,Emanuel Cecchini,3,1,2,1,0,2,3,66.7,1,0,0,0,2,2,0
477,Petr Čech,1,1,1,0,0,1,1,100.0,0,0,0,0,0,23,7
478,Ricardo Centurión,0,0,0,0,0,0,0,,0,0,0,0,0,0,0
479,Luca Ceppitelli,45,33,31,12,2,16,34,47.1,18,33,21,12,50,156,0
480,Fabio Ceravolo,0,0,0,0,0,0,1,0.0,1,1,0,1,0,0,0
481,Alessio Cerci,15,10,7,3,5,4,16,25.0,12,4,0,4,4,8,0
482,Boštjan Cesar,4,3,3,1,0,3,4,75.0,1,6,4,2,3,40,0
483,Damir Ceter,2,1,0,2,0,0,0,,0,3,0,3,0,1,0
484,Nacer Chadli,1,0,1,0,0,1,4,25.0,3,0,0,0,0,4,0
485,Fouad Chafik,58,49,31,19,8,20,35,57.1,15,17,1,16,33,46,1
486,Nathaniel Chalobah,9,6,2,6,1,2,5,40.0,3,6,5,1,6,6,0
487,Calum Chambers,17,10,10,6,1,5,14,35.7,9,14,11,3,18,47,0
488,Nereo Champagne,0,0,0,0,0,0,0,,0,0,0,0,0,3,0
489,Timothy Chandler,27,21,11,13,3,11,17,64.7,6,15,0,15,33,52,0
490,Kwon Chang-hoon,37,22,10,18,9,11,35,31.4,24,32,1,31,24,30,0
491,Charles,11,8,2,5,4,1,8,12.5,7,7,0,7,7,10,0
492,Charly Charrier,1,0,1,0,0,0,2,0.0,2,1,0,1,2,0,0
493,Pape Cheikh Diop,0,0,0,0,0,0,0,,0,0,0,0,0,0,0
494,Chema,20,13,14,6,0,9,18,50.0,9,43,27,16,30,110,1
495,Denis Cheryshev,27,16,12,10,5,6,23,26.1,17,18,1,17,13,10,0
496,Raman Chibsah,20,13,10,7,3,4,14,28.6,10,13,2,11,4,16,0
497,Leandro Chichizola,2,0,2,0,0,2,6,33.3,4,0,0,0,4,29,3
498,Giorgio Chiellini,28,19,17,10,1,7,15,46.7,8,21,14,7,47,142,3
499,Federico Chiesa,62,41,22,22,18,16,54,29.6,38,34,1,33,18,16,0
500,Ben Chilwell,36,26,21,10,5,15,32,46.9,17,31,4,27,28,71,3
501,Vlad Chiricheș,8,4,7,1,0,2,5,40.0,3,2,1,1,16,19,1
502,Hamza Choudhury,9,5,6,3,0,2,10,20.0,8,12,1,11,8,4,0
503,Andreas Christensen,26,13,23,3,0,10,15,66.7,5,25,17,8,39,109,5
504,Chuca,1,0,1,0,0,1,3,33.3,2,1,1,0,1,1,1
505,Lee Chung-yong,2,0,0,1,1,0,0,,0,3,0,3,2,0,1
506,Amato Ciciretti,14,8,5,6,3,2,11,18.2,9,9,0,9,6,4,0
507,Cifu,2,1,0,1,1,1,5,20.0,4,1,1,0,2,2,0
508,Luca Cigarini,42,30,16,25,1,18,64,28.1,46,32,5,27,42,27,1
509,Per Ciljan Skjelbred,89,66,33,54,2,42,64,65.6,22,31,6,25,45,23,0
510,Jasper Cillessen,0,0,0,0,0,0,0,,0,0,0,0,0,0,0
511,Thiago Cionek,28,21,18,6,4,11,20,55.0,9,19,9,10,35,99,0
512,Saliou Ciss,3,2,1,1,1,2,5,40.0,3,0,0,0,2,1,0
513,Karamoko Cissé,1,1,1,0,0,0,0,,0,0,0,0,0,0,0
514,Issa Cissokho,31,23,22,9,0,18,32,56.3,14,18,8,10,34,87,1
515,Ciaran Clark,25,17,17,8,0,11,21,52.4,10,15,10,5,17,144,1
516,Christian Clemens,12,11,6,5,1,4,13,30.8,9,8,0,8,4,7,0
517,Tom Cleverley,48,26,25,16,7,21,52,40.4,31,11,1,10,25,21,0
518,Sam Clucas,34,19,21,11,2,10,29,34.5,19,31,7,24,29,34,1
519,Nathaniel Clyne,3,1,2,1,0,0,1,0.0,1,2,1,1,0,3,0
520,Marcus Coco,40,28,17,13,10,7,35,20.0,28,22,3,19,15,9,0
521,Massimo Coda,12,9,3,4,5,2,13,15.4,11,7,2,5,6,11,0
522,Isaac Cofie,13,10,3,9,1,7,15,46.7,8,9,3,6,10,7,0
523,Renaud Cohade,143,86,63,71,9,46,119,38.7,73,70,10,60,53,91,0
524,Coke,35,23,26,7,2,18,39,46.2,21,17,5,12,34,46,0
525,Coke,0,0,0,0,0,0,0,,0,0,0,0,0,0,0
526,Emre Çolak,24,19,4,14,6,7,28,25.0,21,7,1,6,7,5,1
527,Séamus Coleman,14,14,9,3,2,6,11,54.5,5,16,12,4,10,29,2
528,James Collins,15,9,11,4,0,8,11,72.7,3,13,10,3,16,120,1
529,Racine Coly,15,12,9,5,1,9,19,47.4,10,5,2,3,15,18,0
530,Kingsley Coman,11,10,2,6,3,5,10,50.0,5,6,0,6,7,1,0
531,Marvin Compper,2,2,0,2,0,2,3,66.7,1,2,2,0,0,8,0
532,Alois Confais,8,6,7,1,0,3,9,33.3,6,7,4,3,4,15,1
533,Daniel Congré,62,46,36,24,2,31,59,52.5,28,29,16,13,56,124,2
534,Andrea Consigli,0,0,0,0,0,0,2,0.0,2,0,0,0,0,27,6
535,Diego Contento,3,0,1,2,0,1,1,100.0,0,2,1,1,1,9,0
536,Andrea Conti,4,2,1,3,0,2,3,66.7,1,3,0,3,1,5,0
537,Lewis Cook,67,35,37,30,0,26,69,37.7,43,33,12,21,35,25,2
538,Steve Cook,37,19,28,7,2,19,29,65.5,10,63,45,18,54,232,4
539,Duje Čop,1,1,0,0,1,0,1,0.0,1,1,0,1,0,0,0
540,Francis Coquelin,5,4,2,3,0,1,3,33.3,2,1,0,1,3,2,0
541,Francis Coquelin,18,14,11,6,1,9,16,56.3,7,9,2,7,20,23,0
542,Sébastien Corchia,18,13,7,8,3,9,16,56.3,7,18,4,14,16,20,0
543,Alex Cordaz,0,0,0,0,0,0,0,,0,0,0,0,2,16,4
544,Iñigo Córdoba,44,30,18,21,5,16,58,27.6,42,31,0,31,21,9,0
545,Jhon Córdoba,13,10,0,11,2,1,5,20.0,4,6,2,4,1,9,0
546,Sergio Córdova,5,5,0,2,3,3,4,75.0,1,12,2,10,0,6,0
547,Jérémy Cordoval,20,16,12,7,1,9,14,64.3,5,12,2,10,9,35,0
548,Benjamin Corgnet,28,19,5,16,7,6,28,21.4,22,18,1,17,11,11,0
549,Jack Cork,60,44,25,27,8,20,62,32.3,42,36,15,21,41,86,1
550,Andreas Cornelius,9,5,3,3,3,1,7,14.3,6,7,0,7,2,7,0
551,Maxwel Cornet,17,12,6,9,2,3,25,12.0,22,11,1,10,14,14,0
552,Quentin Cornette,11,8,5,3,3,3,13,23.1,10,7,0,7,3,5,0
553,Ángel Correa,41,29,12,16,13,8,57,14.0,49,30,1,29,25,17,0
554,Joaquín Correa,15,10,7,6,2,8,29,27.6,21,15,1,14,2,12,0
555,Andrea Cossu,1,0,0,0,1,0,2,0.0,2,2,0,2,3,2,0
556,Andrea Costa,19,14,13,6,0,9,19,47.4,10,21,15,6,37,78,2
557,Danny da Costa,41,34,17,14,10,24,28,85.7,4,21,4,17,13,47,0
558,Diego Costa,17,11,2,10,5,4,15,26.7,11,14,4,10,5,3,0
559,Douglas Costa,17,14,10,5,2,8,25,32.0,17,15,0,15,7,7,0
560,Filippo Costa,19,12,7,7,5,7,17,41.2,10,23,6,17,22,50,0
561,Jaume Costa,67,43,39,22,6,33,51,64.7,18,30,8,22,46,97,0
562,Angelo da Costa Júnior,0,0,0,0,0,0,0,,0,0,0,0,0,2,0
563,Nuno da Costa,50,32,12,29,9,7,35,20.0,28,21,0,21,19,9,0
564,Benoît Costil,0,0,0,0,0,0,2,0.0,2,0,0,0,3,13,4
565,Kalifa Coulibaly,6,6,3,1,2,2,4,50.0,2,0,0,0,0,6,0
566,Lassana Coulibaly,26,17,13,10,3,10,35,28.6,25,15,1,14,8,10,0
567,Thibaut Courtois,0,0,0,0,0,0,0,,0,0,0,0,0,8,1
568,Philippe Coutinho,17,14,4,10,3,3,21,14.3,18,10,0,10,10,5,1
569,Philippe Coutinho,27,14,8,14,5,9,32,28.1,23,14,0,14,6,4,0
570,Nicolas Cozza,21,11,12,8,1,7,16,43.8,9,5,2,3,13,12,0
571,Alessio Cragno,0,0,0,0,0,0,0,,0,1,0,1,0,12,0
572,Martin Cranie,3,2,2,1,0,0,1,0.0,1,3,3,0,1,10,0
573,Michele Cremonesi,4,2,2,2,0,1,4,25.0,3,5,3,2,7,28,0
574,Aaron Cresswell,34,21,12,20,2,19,30,63.3,11,42,17,25,44,117,1
575,Lorenzo Crisetig,18,14,8,9,1,7,24,29.2,17,8,2,6,13,16,1
576,Bryan Cristante,66,50,21,32,13,18,59,30.5,41,43,6,37,23,27,0
577,Sebastián Cristóforo,16,12,6,8,2,9,19,47.4,10,4,0,4,4,6,0
578,Enzo Crivelli,13,9,2,6,5,1,5,20.0,4,4,0,4,2,6,0
579,Enzo Crivelli,4,2,2,1,1,1,5,20.0,4,1,0,1,2,2,0
580,Giovanni Crociata,9,6,3,4,2,1,4,25.0,3,7,0,7,4,3,0
581,Luca Crosta,0,0,0,0,0,0,0,,0,0,0,0,0,1,0
582,Peter Crouch,2,0,0,1,1,0,12,0.0,12,7,4,3,1,31,0
583,Juan Cruz,2,2,0,2,0,0,0,,0,0,0,0,0,0,0
584,Juan Cuadrado,28,19,17,9,2,11,27,40.7,16,14,0,14,19,14,1
585,Iván Cuéllar,4,3,4,0,0,3,4,75.0,1,0,0,0,3,22,6
586,Mickaël Cuisance,31,20,16,11,4,19,29,65.5,10,22,4,18,10,10,1
587,Josh Cullen,0,0,0,0,0,0,1,0.0,1,1,1,0,2,0,0
588,Patrick Cutrone,11,10,2,7,2,1,10,10.0,9,11,1,10,3,12,0
589,Wylan Cyprien,9,7,4,4,1,2,11,18.2,9,7,1,6,11,7,2
590,Marco D'Alessandro,31,22,15,9,7,8,24,33.3,16,12,1,11,10,8,1
591,Danilo D'Ambrosio,82,64,38,35,9,30,59,50.8,29,31,7,24,45,68,1
592,Damien Da Silva,52,35,40,12,0,20,33,60.6,13,45,25,20,36,184,2
593,Kouadio-Yves Dabila,20,11,14,4,2,6,10,60.0,4,14,6,8,10,46,0
594,Bryan Dabo,17,11,6,10,1,6,15,40.0,9,13,1,12,15,24,1
595,Bryan Dabo,25,16,12,10,3,7,29,24.1,22,12,1,11,11,22,0
596,Mahmoud Dahoud,38,23,11,21,6,13,30,43.3,17,18,2,16,12,7,0
597,Dario Dainelli,19,14,14,4,1,10,21,47.6,11,27,22,5,46,126,0
598,Felipe dal Belo,51,34,32,16,3,25,49,51.0,24,42,24,18,48,157,1
599,Charlie Daniels,48,34,32,12,4,22,41,53.7,19,34,7,27,31,114,0
600,Danilo,43,29,25,12,6,19,35,54.3,16,15,6,9,19,33,0
601,Scott Dann,10,5,8,2,0,7,17,41.2,10,17,14,3,23,98,1
602,Kevin Danso,18,12,13,5,0,12,16,75.0,4,21,14,7,20,63,1
603,Dante,43,28,32,10,1,21,36,58.3,15,44,25,19,47,130,2
604,Romain Danzé,12,7,3,4,5,8,13,61.5,5,11,2,9,3,34,0
605,Andrea Danzi,11,6,7,4,0,5,13,38.5,8,3,0,3,5,5,1
606,Stéphane Darbion,19,14,13,4,2,5,40,12.5,35,21,2,19,20,17,0
607,Palkó Dárdai,0,0,0,0,0,0,0,,0,0,0,0,0,1,0
608,Sergi Darder,64,43,29,28,7,19,62,30.6,43,31,5,26,52,48,1
609,Sergi Darder,9,3,1,5,3,1,7,14.3,6,0,0,0,3,3,0
610,Vladimír Darida,38,28,11,18,9,11,26,42.3,15,22,4,18,24,23,0
611,Karl Darlow,0,0,0,0,0,0,0,,0,0,0,0,0,3,4
612,Matteo Darmian,16,14,7,7,2,6,19,31.6,13,5,3,2,7,23,0
613,Ben Davies,47,33,13,21,13,25,48,52.1,23,24,5,19,28,70,1
614,Tom Davies,30,20,14,11,5,12,54,22.2,42,19,5,14,24,21,0
615,Steven Davis,30,21,10,17,3,11,30,36.7,19,22,6,16,15,24,1
616,Salem Al-Dawsari,1,0,0,1,0,1,1,100.0,0,1,0,1,0,0,0
617,Craig Dawson,38,28,25,7,6,13,36,36.1,23,39,26,13,52,140,0
618,Kevin De Bruyne,62,43,23,25,14,23,80,28.8,57,45,2,43,25,14,2
619,Sebastien De Maio,26,17,15,11,0,10,25,40.0,15,35,18,17,36,147,0
620,Rodrigo De Paul,31,18,10,17,4,4,32,12.5,28,34,1,33,16,8,0
621,Daniele De Rossi,23,13,12,9,2,9,33,27.3,24,18,13,5,43,45,2
622,Mattia De Sciglio,22,17,7,13,2,9,13,69.2,4,12,2,10,14,32,0
623,Lorenzo De Silvestri,39,25,19,13,7,16,26,61.5,10,47,10,37,27,165,0
624,Lucas Deaux,62,45,21,37,4,20,67,29.9,47,41,6,35,32,19,0
625,Mathieu Debuchy,34,25,22,8,4,17,30,56.7,13,16,10,6,27,73,0
626,Troy Deeney,15,11,3,8,4,3,11,27.3,8,14,1,13,5,20,0
627,Jermain Defoe,12,9,2,6,4,2,10,20.0,8,10,0,10,4,1,0
628,Steven Defour,33,22,12,18,3,10,46,21.7,36,35,7,28,46,25,0
629,Grégoire Defrel,8,3,1,1,6,2,8,25.0,6,5,0,5,3,6,0
630,Alessandro Deiola,9,7,5,3,1,6,13,46.2,7,8,0,8,4,12,0
631,Lorenzo Del Pinto,23,17,10,10,3,7,25,28.0,18,13,4,9,16,7,2
632,Damien Delaney,2,1,2,0,0,1,1,100.0,0,5,4,1,3,7,0
633,Thomas Delaney,79,61,27,46,6,36,53,67.9,17,37,12,25,43,74,4
634,Jonathan Delaplace,10,8,1,8,1,3,10,30.0,7,13,5,8,8,8,0
635,Cristian Dell'Orco,4,1,1,2,1,1,3,33.3,2,5,1,4,10,19,0
636,Andy Delort,20,13,2,9,9,4,19,21.1,15,10,0,10,12,22,0
637,Fabian Delph,46,34,21,16,9,18,37,48.6,19,16,0,16,30,42,2
638,Mousa Dembélé,36,24,19,11,6,9,37,24.3,28,20,0,20,33,15,0
639,Ousmane Dembélé,10,7,2,5,3,1,13,7.7,12,8,0,8,5,2,0
640,Jessy Deminguet,12,9,4,6,2,4,14,28.6,10,5,0,5,10,13,0
641,Kerem Demirbay,38,30,15,17,6,12,28,42.9,16,21,3,18,14,21,0
642,Ermedin Demirović,1,1,0,1,0,0,1,0.0,1,5,0,5,0,2,0
643,Diego Demme,81,57,29,48,4,47,87,54.0,40,31,3,28,48,29,0
644,Fabio Depaoli,31,22,21,7,3,21,40,52.5,19,27,10,17,15,42,0
645,Mathieu Deplagne,52,38,33,14,5,20,48,41.7,28,26,10,16,60,95,2
646,Laurent Depoitre,14,8,4,8,2,3,21,14.3,18,15,3,12,11,36,0
647,Mike van der Hoorn,32,22,23,8,1,16,24,66.7,8,24,14,10,39,127,0
648,Gregory van der Wiel,5,3,4,1,0,3,5,60.0,2,1,0,1,10,12,0
649,Daniele Dessena,18,10,12,5,1,6,12,50.0,6,7,1,6,6,17,0
650,Mattia Destro,15,13,4,9,2,3,11,27.3,8,10,1,9,5,26,0
651,Gerard Deulofeu,5,3,2,2,1,2,11,18.2,9,0,0,0,4,3,1
652,Gerard Deulofeu,8,5,6,1,1,3,4,75.0,1,2,0,2,8,0,0
653,Gianluca Di Chiara,26,19,18,6,2,7,21,33.3,14,10,3,7,11,37,1
654,Federico Di Francesco,26,13,14,8,4,5,20,25.0,15,24,2,22,16,25,0
655,Davide Di Gennaro,1,0,1,0,0,1,1,100.0,0,0,0,0,0,0,0
656,Ángel Di María,13,10,5,3,5,7,39,17.9,32,18,2,16,10,8,0
657,Franco Di Santo,17,13,3,13,1,7,15,46.7,8,12,1,11,2,24,0
658,Cheick Diabaté,1,1,0,1,0,1,3,33.3,2,2,0,2,0,6,0
659,Fousseni Diabaté,9,6,5,3,1,1,4,25.0,3,6,0,6,8,8,0
660,Moussa Diaby,1,0,1,0,0,1,4,25.0,3,1,0,1,1,0,0
661,Fallou Diagne,33,20,21,12,0,7,22,31.8,15,33,18,15,46,116,3
662,Adama Diakhaby,23,15,6,12,5,6,16,37.5,10,13,0,13,13,5,0
663,Mouctar Diakhaby,10,6,7,3,0,4,7,57.1,3,14,9,5,12,52,1
664,Abdou Diallo,75,53,45,25,5,38,50,76.0,12,37,14,23,50,75,0
665,Abdoulaye Diallo,0,0,0,0,0,0,0,,0,0,0,0,0,4,1
666,Habib Diallo,0,0,0,0,0,0,0,,0,0,0,0,0,0,0
667,Mustapha Diallo,48,36,15,29,4,15,33,45.5,18,20,4,16,20,29,0
668,Mohamed Diamé,89,64,33,48,8,16,62,25.8,46,44,7,37,48,30,2
669,Lassana Diarra,12,4,4,7,1,8,12,66.7,4,3,1,2,6,6,0
670,Amadou Diawara,11,9,3,7,1,1,7,14.3,6,12,2,10,9,5,0
671,Brahim Díaz,1,0,1,0,0,0,0,,0,3,0,3,1,0,0
672,Bakaye Dibassy,71,51,45,22,4,24,50,48.0,26,52,26,26,58,148,0
673,Daniel Didavi,34,19,10,19,5,14,33,42.4,19,20,1,19,7,12,0
674,Thomas Didillon,0,0,0,0,0,0,1,0.0,1,0,0,0,0,5,2
675,Étienne Didot,54,33,20,33,1,20,43,46.5,23,21,7,14,19,29,0
676,Adrián Diéguez,10,5,5,5,0,6,13,46.2,7,5,0,5,11,24,1
677,Dennis Diekmeier,47,43,31,10,6,25,36,69.4,11,22,11,11,16,50,0
678,Eric Dier,61,43,15,39,7,17,42,40.5,25,32,11,21,48,93,7
679,Lucas Digne,22,17,13,6,3,8,12,66.7,4,15,3,12,12,18,0
680,Landry Dimata,7,6,4,3,0,5,6,83.3,1,6,2,4,2,5,0
681,Tristan Dingomé,25,20,12,9,4,5,13,38.5,8,12,0,12,12,16,1
682,Ismaël Diomandé,14,8,7,6,1,10,15,66.7,5,11,5,6,5,20,0
683,Lois Diony,3,0,1,2,0,0,3,0.0,3,5,1,4,1,8,0
684,Issa Diop,58,43,35,22,1,21,48,43.8,27,38,25,13,76,128,0
685,Papakouli Diop,5,3,1,3,1,0,3,0.0,3,5,2,3,6,6,0
686,Papakouli Diop,26,20,6,16,4,11,26,42.3,15,3,0,3,13,10,0
687,Assane Dioussé,32,21,14,14,4,13,34,38.2,21,29,2,27,11,16,2
688,Djené,87,65,71,15,1,34,52,65.4,18,33,14,19,78,190,1
689,Koffi Djidji,55,39,32,20,3,19,29,65.5,10,34,15,19,45,126,0
690,Alexander Djiku,65,43,52,11,2,25,52,48.1,27,34,5,29,57,155,2
691,Papy Djilobodji,45,29,34,11,0,21,43,48.8,22,38,25,13,71,211,5
692,Berat Djimsiti,32,17,28,4,0,12,30,40.0,18,37,23,14,62,178,1
693,Marko Dmitrović,4,4,4,0,0,4,11,36.4,7,1,0,1,2,26,2
694,Keagan Dolly,12,7,2,7,3,1,11,9.1,10,11,0,11,1,2,0
695,Jaume Doménech,0,0,0,0,0,0,0,,0,0,0,0,0,2,0
696,Jean-Luc Dompé,0,0,0,0,0,0,0,,0,0,0,0,0,0,0
697,Giulio Donati,56,42,30,21,5,34,50,68.0,16,38,8,30,35,66,1
698,Ji Dong-won,2,1,0,1,1,0,0,,0,1,1,0,1,0,0
699,Anastasios Donis,20,14,10,6,4,6,8,75.0,2,2,0,2,9,7,0
700,Gianluigi Donnarumma,1,0,1,0,0,1,1,100.0,0,0,0,0,1,13,8
701,Godfred Donsah,29,20,11,14,4,10,17,58.8,7,25,0,25,22,43,0
702,Dória,2,2,0,2,0,0,0,,0,3,1,2,1,1,0
703,Niklas Dorsch,1,1,0,1,0,0,2,0.0,2,0,0,0,1,0,0
704,Mauro dos Santos,16,14,11,5,0,10,15,66.7,5,7,5,2,12,53,1
705,Mathieu Dossevi,35,25,15,15,5,7,39,17.9,32,24,3,21,28,12,0
706,Abdoulaye Doucouré,79,52,28,42,9,27,79,34.2,52,43,10,33,54,61,0
707,Cheick Doukouré,34,19,18,15,1,6,22,27.3,16,15,4,11,14,4,0
708,Mohamed Dräger,0,0,0,0,0,0,1,0.0,1,1,0,1,0,0,0
709,Aleksandar Dragović,13,10,13,0,0,7,13,53.8,6,16,8,8,16,46,0
710,Aleksandar Dragović,0,0,0,0,0,0,1,0.0,1,0,0,0,0,0,1
711,Bartłomiej Drągowski,0,0,0,0,0,0,0,,0,0,0,0,0,0,1
712,Boukary Dramé,1,1,1,0,0,0,0,,0,0,0,0,2,4,0
713,Julian Draxler,20,14,4,13,3,6,32,18.8,26,18,2,16,28,8,0
714,Danny Drinkwater,15,10,6,8,1,3,17,17.6,14,10,2,8,8,7,0
715,Josip Drmić,0,0,0,0,0,0,4,0.0,4,1,0,1,0,1,1
716,Rick van Drongelen,30,25,23,7,0,21,28,75.0,7,20,11,9,19,58,1
717,Óscar Duarte,12,9,8,4,0,4,11,36.4,7,8,8,0,9,60,2
718,Rubén Duarte,76,40,42,27,7,35,59,59.3,24,40,10,30,44,94,0
719,Leo Dubois,50,39,33,15,2,20,47,42.6,27,47,13,34,50,99,2
720,Martin Dúbravka,0,0,0,0,0,0,0,,0,0,0,0,0,3,2
721,Ondrej Duda,16,12,7,6,3,6,14,42.9,8,15,0,15,4,8,0
722,Shane Duffy,31,19,22,9,0,7,20,35.0,13,66,59,7,50,332,5
723,Paul Dummett,28,19,21,7,0,13,27,48.1,14,27,10,17,23,107,1
724,Alfred Duncan,39,29,16,18,5,15,52,28.8,37,32,2,30,19,29,1
725,Lewis Dunk,67,33,49,18,0,25,48,52.1,23,73,58,15,71,230,2
726,Maxime Dupé,0,0,0,0,0,0,0,,0,0,0,0,0,2,0
727,Jimmy Durmaz,16,9,5,5,6,6,14,42.9,8,2,0,2,14,9,0
728,Riza Durmisi,39,21,24,14,1,10,18,55.6,8,18,7,11,15,65,1
729,Hugo Duro,0,0,0,0,0,0,1,0.0,1,0,0,0,0,0,0
730,Noë Dussenne,2,0,2,0,0,0,0,,0,0,0,0,1,8,0
731,Paulo Dybala,19,11,4,10,5,4,32,12.5,28,22,0,22,12,4,0
732,Nathan Dyer,22,16,8,9,5,6,24,25.0,18,13,0,13,11,3,0
733,Edin Džeko,15,10,1,9,5,3,15,20.0,12,9,1,8,4,36,0
734,Blerim Džemaili,27,19,11,15,1,9,27,33.3,18,15,4,11,18,11,0
735,Félix Eboa Eboa,19,11,12,7,0,8,16,50.0,8,21,11,10,39,119,2
736,Éder,10,7,2,4,4,0,10,0.0,10,6,1,5,5,4,0
737,Simone Edera,6,2,2,4,0,3,10,30.0,7,0,0,0,2,1,0
738,Ederson,1,1,1,0,0,0,0,,0,1,0,1,0,15,6
739,Tom Edwards,15,9,10,5,0,8,8,100.0,0,5,2,3,5,20,0
740,Mandela Egbo,0,0,0,0,0,0,0,,0,0,0,0,0,2,0
741,Johannes Eggestein,0,0,0,0,0,0,1,0.0,1,2,1,1,1,0,0
742,Maximilian Eggestein,70,48,32,34,4,34,58,58.6,24,41,6,35,40,51,0
743,Albin Ekdal,39,28,19,19,1,18,29,62.1,11,20,3,17,21,19,0
744,Josip Elez,12,8,9,2,1,5,9,55.6,4,9,7,2,16,39,1
745,Rob Elliot,0,0,0,0,0,0,1,0.0,1,0,0,0,0,8,0
746,Mohamed Elneny,12,6,6,3,3,6,10,60.0,4,11,0,11,10,12,2
747,Aritz Elustondo,32,20,20,9,3,19,30,63.3,11,20,7,13,45,84,0
748,Nico Elvedi,66,46,41,22,3,37,55,67.3,18,39,9,30,51,108,3
749,Rodrigo Ely,32,18,26,6,0,19,34,55.9,15,45,36,9,50,183,0
750,Breel Embolo,14,10,3,7,4,2,9,22.2,7,13,0,13,6,3,0
751,Youssef En-Nesyri,31,25,10,14,7,6,26,23.1,20,11,0,11,9,32,0
752,Sergi Enrich,11,8,3,3,5,2,8,25.0,6,13,1,12,6,8,0
753,Javier Eraso,32,15,10,18,4,13,42,31.0,29,16,5,11,23,17,0
754,Christian Eriksen,51,29,16,30,5,17,59,28.8,42,38,1,37,31,21,0
755,Gonzalo Escalante,59,35,21,32,6,17,39,43.6,22,26,3,23,32,19,0
756,Sergio Escudero,78,49,40,26,12,32,62,51.6,30,35,6,29,66,69,1
757,Bernardo Espinosa,36,22,29,6,1,18,33,54.5,15,27,19,8,66,169,0
758,Michael Esser,0,0,0,0,0,0,1,0.0,1,0,0,0,0,0,0
759,Alexander Esswein,25,16,13,10,2,12,25,48.0,13,4,0,4,9,11,0
760,Oghenekaro Etebo,24,17,9,12,3,12,26,46.2,14,17,3,14,27,10,0
761,Beñat Etxebarria,28,20,12,13,3,13,36,36.1,23,6,1,5,28,12,0
762,Xabier Etxeita,2,2,2,0,0,1,4,25.0,3,3,2,1,7,25,1
763,Jonny Evans,29,22,19,8,2,14,33,42.4,19,22,13,9,48,131,1
764,Franck Evina,2,2,2,0,0,2,2,100.0,0,5,0,5,0,0,0
765,Patrice Evra,6,4,5,1,0,6,8,75.0,2,4,1,3,7,6,0
766,Patrice Evra,6,5,5,1,0,3,6,50.0,3,2,2,0,3,16,0
767,Edu Expósito,1,0,0,0,1,0,1,0.0,1,1,0,1,2,2,0
768,Erik Expósito,1,1,0,1,0,0,6,0.0,6,6,0,6,1,5,0
769,Valentin Eysseric,17,13,7,4,6,6,20,30.0,14,10,2,8,6,6,0
770,Valentin Eysseric,0,0,0,0,0,0,0,,0,4,0,4,1,0,0
771,Imoh Ezekiel,8,6,3,2,3,3,4,75.0,1,4,0,4,2,3,0
772,Marco Fabián,5,3,2,3,0,3,4,75.0,1,2,0,2,3,1,0
773,Łukasz Fabiański,0,0,0,0,0,0,0,,0,0,0,0,0,10,2
774,Fabinho,114,64,38,67,9,48,112,42.9,64,48,13,35,43,62,0
775,Cesc Fàbregas,68,49,30,29,9,18,69,26.1,51,25,4,21,22,26,2
776,Ralf Fährmann,1,0,1,0,0,1,3,33.3,2,1,0,1,1,12,7
777,Fayçal Fajr,62,45,22,34,6,17,66,25.8,49,26,4,22,30,42,0
778,Radamel Falcao,11,6,0,8,3,2,13,15.4,11,13,3,10,10,11,0
779,Diego Falcinelli,1,1,1,0,0,0,5,0.0,5,5,1,4,1,4,0
780,Diego Falcinelli,4,4,1,2,1,1,13,7.7,12,12,2,10,2,9,0
781,Simon Falette,0,0,0,0,0,0,0,,0,0,0,0,1,8,0
782,Simon Falette,34,30,23,10,1,19,31,61.3,12,37,15,22,58,134,1
783,Cesar Falletti,11,7,4,6,1,4,8,50.0,4,10,0,10,0,5,0
784,Iago Falque,41,31,15,20,6,6,43,14.0,37,22,0,22,15,15,0
785,Paolo Faragò,92,67,53,24,15,24,60,40.0,36,41,5,36,23,76,0
786,Imad Faraj,5,2,2,1,2,4,8,50.0,4,1,0,1,4,3,0
787,Davide Faraoni,62,39,36,20,6,28,47,59.6,19,30,8,22,58,76,0
788,Mohamed Fares,50,33,29,17,4,16,42,38.1,26,24,5,19,50,132,2
789,Diego Farias,21,15,3,9,9,6,24,25.0,18,17,0,17,8,6,0
790,Federico Fazio,56,43,38,18,0,25,31,80.6,6,30,22,8,46,161,3
791,Zouhair Feddal,22,14,14,6,2,7,12,58.3,5,17,13,4,36,95,2
792,Nabil Fekir,45,33,11,24,10,8,40,20.0,32,11,0,11,8,5,0
793,Felipe,8,8,4,4,0,2,4,50.0,2,4,3,1,11,29,0
794,Luiz Felipe,40,28,24,16,0,15,25,60.0,10,26,14,12,18,50,1
795,Ohis Felix Uduokhai,42,23,27,13,2,17,24,70.8,7,23,10,13,34,66,6
796,Marouane Fellaini,15,8,6,8,1,2,11,18.2,9,12,3,9,14,19,1
797,Kiko Femenía,36,28,22,11,3,14,27,51.9,13,15,2,13,34,31,1
798,Leroy Fer,44,32,18,21,5,13,30,43.3,17,18,4,14,12,24,3
799,Julien Féret,40,27,10,25,5,14,75,18.7,61,52,7,45,49,58,2
800,Edimilson Fernandes,17,9,10,7,0,9,21,42.9,12,13,1,12,16,8,0
801,Gelson Fernandes,58,46,25,29,4,23,45,51.1,22,23,3,20,16,21,0
802,Andrés Fernández,1,0,1,0,0,0,0,,0,0,0,0,0,4,0
803,Augusto Fernández,3,2,1,2,0,1,3,33.3,2,3,2,1,2,3,0
804,Brian Fernández,0,0,0,0,0,0,1,0.0,1,2,0,2,0,0,0
805,Carlos Fernández,2,1,1,1,0,0,2,0.0,2,1,0,1,0,0,0
806,Federico Fernández,40,29,30,6,4,20,30,66.7,10,35,27,8,38,201,1
807,Raúl Fernández,0,0,0,0,0,0,0,,0,1,0,1,0,10,1
808,Fernandinho,62,35,22,28,12,24,65,36.9,41,38,6,32,47,68,2
809,Alex Ferrari,73,54,42,23,8,36,67,53.7,31,41,15,26,47,117,4
810,Jordan Ferri,20,11,8,11,1,7,20,35.0,13,11,1,10,5,11,2
811,Sam Field,14,11,8,4,2,3,10,30.0,7,6,1,5,11,8,0
812,Afonso Figueiredo,6,3,3,3,0,3,5,60.0,2,0,0,0,0,4,0
813,Gian Filippo Felicioli,13,8,5,5,3,0,4,0.0,4,0,0,0,5,6,0
814,Alfreð Finnbogason,18,13,7,5,6,8,15,53.3,7,15,1,14,14,7,0
815,Roberto Firmino,65,50,9,36,20,8,58,13.8,50,40,2,38,18,10,0
816,Junior Firpo,26,17,15,8,3,10,18,55.6,8,21,2,19,20,37,1
817,Viktor Fischer,4,4,2,1,1,2,5,40.0,3,2,0,2,3,2,0
818,Mathieu Flamini,11,5,3,7,1,4,9,44.4,5,2,0,2,8,8,0
819,Darren Fletcher,47,26,23,20,4,15,55,27.3,40,13,3,10,26,33,3
820,Sergio Floccari,13,9,7,5,1,6,11,54.5,5,6,1,5,2,6,0
821,Alessandro Florenzi,38,28,20,13,5,18,47,38.3,29,19,8,11,44,62,1
822,Phil Foden,1,1,0,1,0,0,1,0.0,1,0,0,0,0,1,0
823,Guessouma Fofana,20,13,8,12,0,6,13,46.2,7,7,1,6,12,11,0
824,Seko Fofana,20,17,8,12,0,4,20,20.0,16,17,3,14,27,26,1
825,Andreu Fontàs,13,9,8,5,0,3,13,23.1,10,9,5,4,14,30,0
826,José Fonte,11,6,5,6,0,2,6,33.3,4,12,9,3,14,37,1
827,Pablo Fornals,52,33,19,26,7,18,60,30.0,42,29,3,26,22,18,0
828,Emil Forsberg,24,17,3,15,6,9,21,42.9,12,19,1,18,8,4,0
829,Fraser Forster,0,0,0,0,0,0,0,,0,0,0,0,0,7,4
830,Steven Fortes,4,2,3,1,0,1,3,33.3,2,0,0,0,3,6,0
831,Marco Fossati,27,13,11,14,2,11,33,33.3,22,19,6,13,23,31,1
832,Iver Fossum,27,19,8,13,6,10,31,32.3,21,28,3,25,15,14,0
833,Ben Foster,1,0,1,0,0,0,7,0.0,7,0,0,0,1,12,1
834,Timothy Fosu-Mensah,42,33,33,8,1,21,34,61.8,13,17,9,8,31,74,1
835,Dimitri Foulquier,25,12,15,8,2,7,17,41.2,10,15,4,11,14,33,0
836,Lilian Fournier,0,0,0,0,0,0,0,,0,0,0,0,0,0,0
837,Raphael Framberger,22,18,14,6,2,15,16,93.8,1,12,3,9,14,15,0
838,Simon Francis,49,34,26,16,7,24,43,55.8,19,29,18,11,49,194,4
839,Mike Frantz,23,16,9,11,3,6,16,37.5,10,13,3,10,13,15,0
840,Ryan Fraser,11,8,7,2,2,7,20,35.0,13,20,4,16,17,34,0
841,Fabian Frei,22,15,7,12,3,8,15,53.3,7,10,0,10,16,17,1
842,Remo Freuler,89,62,35,41,13,27,82,32.9,55,46,13,33,28,37,2
843,Marco Friedl,9,8,4,4,1,7,10,70.0,3,10,1,9,8,17,1
844,Marco Friedl,0,0,0,0,0,0,0,,0,1,0,1,1,0,0
845,Christian Fuchs,41,27,25,12,4,14,40,35.0,26,23,3,20,58,86,0
846,Javi Fuego,20,13,8,11,1,7,14,50.0,7,7,4,3,3,14,0
847,Javi Fuego,34,25,19,12,3,11,28,39.3,17,15,6,9,19,23,0
848,Chris Führich,4,3,1,2,1,2,5,40.0,3,3,0,3,0,1,0
849,Angelo Fulgini,21,11,9,8,4,8,27,29.6,19,21,2,19,20,7,0
850,Niclas Füllkrug,16,11,4,8,4,10,20,50.0,10,22,3,19,8,30,0
851,Jay Fulton,0,0,0,0,0,0,0,,0,0,0,0,0,1,0
852,Ramiro Funes Mori,0,0,0,0,0,0,0,,0,1,1,0,3,14,0
853,Manolo Gabbiadini,3,2,0,2,1,1,15,6.7,14,3,0,3,4,6,0
854,Gabi,80,49,39,37,4,38,104,36.5,66,28,10,18,44,38,0
855,Gabriel,90,69,28,54,8,29,74,39.2,45,38,4,34,38,27,0
856,Mijat Gaćinović,56,44,21,27,8,20,52,38.5,32,38,1,37,39,22,1
857,Roberto Gagliardini,63,45,28,29,6,20,54,37.0,34,18,3,15,45,32,2
858,Nicolás Gaitán,9,6,3,5,1,3,9,33.3,6,2,0,2,1,3,0
859,Milan Gajić,6,3,4,2,0,2,4,50.0,2,7,0,7,4,14,0
860,Serge Gakpé,16,11,9,7,0,6,27,22.2,21,18,1,17,10,15,0
861,Andrey Galabinov,7,5,0,5,2,0,5,0.0,5,17,1,16,2,11,0
862,Álex Gálvez,50,36,26,24,0,22,41,53.7,19,20,11,9,43,74,2
863,Álex Gálvez,11,4,5,6,0,7,12,58.3,5,5,1,4,13,17,0
864,Bruno Gama,1,1,1,0,0,1,3,33.3,2,0,0,0,0,2,0
865,Alessandro Gamberini,13,8,11,2,0,8,12,66.7,4,32,25,7,16,117,1
866,Kévin Gameiro,11,9,3,4,4,1,10,10.0,9,6,0,6,4,11,0
867,Jesús Gámez,4,2,1,0,3,1,3,33.3,2,2,0,2,2,5,0
868,Idrissa Gana Gueye,117,93,65,41,11,35,86,40.7,51,59,9,50,62,48,1
869,Ignatius Ganago,0,0,0,0,0,0,2,0.0,2,1,0,1,0,1,0
870,Najib Gandi,6,5,3,2,1,4,6,66.7,2,4,1,3,4,3,0
871,Ganso,15,11,3,12,0,3,11,27.3,8,7,0,7,2,4,0
872,Ezequiel Garay,18,12,15,3,0,10,14,71.4,4,22,11,11,24,139,0
873,Aleix García,24,14,13,9,2,12,22,54.5,10,9,1,8,17,12,0
874,Borja García,39,18,15,18,6,13,39,33.3,26,31,2,29,30,15,0
875,Dani García,80,59,23,47,10,31,80,38.8,49,28,4,24,70,25,0
876,David García,16,10,10,4,2,8,12,66.7,4,15,8,7,19,33,1
877,Javi García,34,22,18,16,0,13,40,32.5,27,19,12,7,25,78,1
878,Manu García,95,65,38,51,6,24,89,27.0,65,34,11,23,35,67,0
879,Raúl García,82,51,28,36,18,26,71,36.6,45,55,3,52,30,23,0
880,Raúl García,34,25,24,9,1,18,30,60.0,12,18,3,15,19,50,1
881,Samu García,8,6,4,3,1,3,10,30.0,7,4,0,4,6,3,0
882,Samu García,9,7,1,6,2,2,5,40.0,3,3,0,3,1,2,0
883,Sergio García,15,12,1,10,4,3,22,13.6,19,6,3,3,10,12,0
884,Ulisses Garcia,1,1,1,0,0,1,2,50.0,1,0,0,0,0,3,0
885,Luca Garritano,4,3,2,1,1,0,4,0.0,4,3,1,2,1,6,0
886,Bruno Gaspar,20,11,13,6,1,9,15,60.0,6,8,1,7,9,25,0
887,Mario Gaspar,110,66,63,37,10,58,87,66.7,29,58,11,47,58,114,0
888,Gianluca Gaudino,0,0,0,0,0,0,0,,0,1,0,1,0,1,0
889,Dwight Gayle,12,10,2,8,2,1,21,4.8,20,16,2,14,6,17,0
890,Paulo Gazzaniga,0,0,0,0,0,0,1,0.0,1,0,0,0,0,0,0
891,Marcello Gazzola,10,9,3,6,1,8,12,66.7,4,10,2,8,8,25,0
892,Jean-Philippe Gbamin,78,63,48,26,4,43,65,66.2,22,50,10,40,50,80,0
893,David de Gea,0,0,0,0,0,0,1,0.0,1,1,0,1,0,9,3
894,Theodor Gebre Selassie,67,41,36,25,6,36,57,63.2,21,34,2,32,51,83,1
895,Dennis Geiger,52,36,19,31,2,16,40,40.0,24,38,2,36,15,7,0
896,Johannes Geis,20,15,12,7,1,11,21,52.4,10,13,5,8,10,27,1
897,Jérémy Gélin,37,18,22,14,1,20,53,37.7,33,22,12,10,37,92,3
898,Romain Genevois,48,28,27,13,8,21,39,53.8,18,25,11,14,31,76,0
899,Santiago Gentiletti,4,3,4,0,0,1,6,16.7,5,1,0,1,3,11,1
900,Christian Gentner,91,67,35,44,12,44,84,52.4,40,41,5,36,35,52,0
901,Yannick Gerhardt,37,28,18,14,5,22,34,64.7,12,25,5,20,15,31,0
902,Valère Germain,16,11,5,7,4,3,18,16.7,15,11,0,11,6,19,0
903,Gerson,20,12,10,8,2,2,7,28.6,5,15,2,13,11,11,1
904,Willem Geubbels,2,2,1,1,0,0,1,0.0,1,0,0,0,0,0,0
905,Yassine El Ghanassy,7,4,1,3,3,1,4,25.0,3,1,0,1,4,4,0
906,Anwar El Ghazi,23,18,7,13,3,9,29,31.0,20,11,1,10,7,7,1
907,Rachid Ghezzal,31,24,6,22,3,7,34,20.6,27,17,0,17,11,2,1
908,Faouzi Ghoulam,8,4,3,5,0,4,6,66.7,2,10,2,8,15,19,0
909,Emanuele Giaccherini,7,4,4,2,1,5,25,20.0,20,9,3,6,5,6,0
910,Emanuele Giaccherini,1,1,0,1,0,0,0,,0,0,0,0,0,0,0
911,Niccolò Giannetti,5,4,2,3,0,2,6,33.3,4,1,0,1,1,3,0
912,Kieran Gibbs,41,24,27,10,4,16,30,53.3,14,32,12,20,48,102,0
913,Rafał Gikiewicz,0,0,0,0,0,0,0,,0,0,0,0,0,0,0
914,Carles Gil,6,4,1,4,1,1,5,20.0,4,5,0,5,4,0,0
915,Nacho Gil,10,6,6,2,2,5,21,23.8,16,9,0,9,6,2,0
916,Nacho Gil,6,1,2,4,0,1,8,12.5,7,6,0,6,2,2,0
917,Guillaume Gillet,0,0,0,0,0,0,0,,0,1,1,0,0,0,0
918,Dani Giménez,0,0,0,0,0,0,0,,0,0,0,0,0,0,0
919,Daniel Ginczek,8,4,3,5,0,2,12,16.7,10,16,1,15,5,13,0
920,Matthias Ginter,48,37,27,20,1,35,45,77.8,10,40,17,23,40,114,1
921,Jimmy Giraudon,26,16,20,6,0,10,16,62.5,6,30,22,8,31,128,2
922,Thibault Giresse,0,0,0,0,0,0,0,,0,0,0,0,1,0,0
923,Andrei Girotto,57,38,15,37,5,21,52,40.4,31,32,7,25,15,45,1
924,Olivier Giroud,5,4,1,2,2,1,5,20.0,4,1,0,1,1,4,0
925,Olivier Giroud,4,3,1,2,1,1,3,33.3,2,0,0,0,1,5,0
926,Kamil Glik,36,23,22,12,2,15,29,51.7,14,28,18,10,54,279,2
927,Serge Gnabry,32,22,10,18,4,13,24,54.2,11,15,1,14,8,9,2
928,Joris Gnagnon,42,29,29,9,4,21,31,67.7,10,22,16,6,29,154,2
929,Massimo Gobbi,24,18,13,9,2,11,26,42.3,15,20,5,15,22,90,1
930,Diego Godín,50,33,37,11,2,26,47,55.3,21,33,20,13,59,145,1
931,Edoardo Goldaniga,14,8,10,4,0,5,9,55.6,4,10,5,5,19,56,0
932,Connor Goldson,2,2,1,1,0,1,4,25.0,3,3,3,0,1,9,0
933,Pierluigi Gollini,0,0,0,0,0,0,0,,0,0,0,0,0,1,0
934,André Gomes,19,12,8,10,1,5,13,38.5,8,7,1,6,4,6,0
935,Heurelho Gomes,0,0,0,0,0,0,1,0.0,1,1,0,1,2,15,3
936,Ibai Gómez,19,15,11,4,4,6,30,20.0,24,16,1,15,15,20,1
937,Joe Gomez,58,45,32,23,3,21,40,52.5,19,19,8,11,34,57,1
938,Mario Gómez,6,6,2,3,1,2,6,33.3,4,10,1,9,0,16,0
939,Mario Gómez,13,11,0,8,5,2,10,20.0,8,6,0,6,4,17,0
940,Maxi Gómez,7,4,1,4,2,0,18,0.0,18,9,4,5,3,34,0
941,Papu Gómez,14,9,6,5,3,5,26,19.2,21,16,1,15,22,7,0
942,Sergi Gómez,52,37,38,13,1,20,34,58.8,14,32,22,10,56,118,1
943,Sergio Gómez,0,0,0,0,0,0,0,,0,0,0,0,0,0,0
944,Vicente Gómez,21,13,6,11,4,10,29,34.5,19,18,4,14,17,14,1
945,Alfred Gomis,0,0,0,0,0,0,1,0.0,1,0,0,0,1,10,3
946,Maxime Gonalons,26,18,7,12,7,9,23,39.1,14,15,4,11,23,19,1
947,Anthony Gonçalves,50,31,14,32,4,15,50,30.0,35,27,0,27,25,27,0
948,Vagner Gonçalves,0,0,0,0,0,0,3,0.0,3,2,0,2,0,0,0
949,Jérôme Gondorf,12,9,3,9,0,4,18,22.2,14,11,2,9,6,12,0
950,Adrián González,40,25,14,22,4,12,50,24.0,38,25,8,17,38,34,0
951,Álvaro González,38,26,30,7,1,22,41,53.7,19,34,23,11,53,188,0
952,Bruno González,25,18,18,7,0,13,26,50.0,13,11,3,8,31,107,0
953,Diego González,27,19,20,7,0,18,26,69.2,8,25,10,15,19,69,0
954,Fabio González,2,1,2,0,0,1,4,25.0,3,1,0,1,1,1,0
955,Giancarlo González,20,15,14,5,1,9,13,69.2,4,26,18,8,33,152,1
956,Mario González,0,0,0,0,0,0,0,,0,1,0,1,0,0,0
957,Georges Gope-Fenepej,0,0,0,0,0,0,0,,0,0,0,0,0,0,0
958,Leon Goretzka,50,34,22,22,6,14,50,28.0,36,45,4,41,41,35,0
959,Mathieu Gorgelin,0,0,0,0,0,0,0,,0,0,0,0,0,0,1
960,Andoni Gorosabel,3,2,1,2,0,2,5,40.0,3,1,0,1,4,1,0
961,Robin Gosens,61,46,35,22,4,27,46,58.7,19,17,2,15,22,40,0
962,Dan Gosling,50,25,19,26,5,19,68,27.9,49,36,8,28,25,35,0
963,Mario Götze,50,43,19,24,7,14,34,41.2,20,17,1,16,8,9,0
964,Mohamed Gouaida,3,3,1,1,1,0,0,,0,0,0,0,0,3,0
965,Prince-Désir Gouano,42,29,32,8,2,22,31,71.0,9,58,47,11,49,191,6
966,Lemouya Goudiaby,2,1,0,2,0,1,3,33.3,2,2,1,1,0,3,0
967,Amine Gouiri,1,1,1,0,0,0,1,0.0,1,0,0,0,2,0,0
968,Yoann Gourcuff,7,5,1,3,3,0,2,0.0,2,5,0,5,2,2,0
969,Jeffrey Gouweleeuw,57,44,36,18,3,27,41,65.9,14,36,10,26,54,128,0
970,Julio Gracia,0,0,0,0,0,0,0,,0,0,0,0,1,0,0
971,Max Gradel,63,36,28,21,14,24,72,33.3,48,39,2,37,14,30,0
972,Samuel Grandsir,69,43,39,18,12,21,73,28.8,52,31,3,28,23,19,1
973,Álex Granell,78,53,31,39,8,38,114,33.3,76,46,3,43,47,29,0
974,Esteban Granero,32,22,15,13,4,9,27,33.3,18,19,0,19,19,21,0
975,Lee Grant,1,1,1,0,0,1,1,100.0,0,0,0,0,0,0,0
976,Alberto Grassi,44,33,22,12,10,16,35,45.7,19,27,8,19,47,55,0
977,Andrew Gravillon,2,1,2,0,0,0,1,0.0,1,1,1,0,3,10,0
978,Andre Gray,2,1,0,1,1,0,3,0.0,3,11,0,11,4,3,0
979,Demarai Gray,17,15,6,9,2,4,23,17.4,19,27,0,27,11,14,1
980,Michael Gregoritsch,35,27,13,15,7,11,26,42.3,15,27,1,26,10,56,0
981,Clément Grenier,23,14,3,13,7,12,42,28.6,30,16,1,15,14,15,1
982,Clément Grenier,1,1,1,0,0,0,0,,0,0,0,0,0,0,0
983,Anto Grgić,0,0,0,0,0,0,0,,0,0,0,0,0,0,0
984,Antoine Griezmann,36,24,6,23,7,10,30,33.3,20,20,1,19,10,14,0
985,Vincenzo Grifo,8,5,3,3,2,4,8,50.0,4,8,1,7,5,6,0
986,Florian Grillitsch,68,46,30,36,2,35,58,60.3,23,26,3,23,39,25,1
987,Jérémy Grimm,23,17,15,6,2,9,24,37.5,15,11,3,8,19,31,1
988,Pascal Groß,36,24,18,16,2,10,67,14.9,57,31,5,26,14,20,0
989,Marko Grujić,2,2,0,1,1,2,2,100.0,0,0,0,0,0,0,0
990,Vicente Guaita,0,0,0,0,0,0,0,,0,0,0,0,3,12,1
991,Andrés Guardado,41,27,17,18,6,15,55,27.3,40,27,5,22,22,29,1
992,Karim Guédé,2,2,2,0,0,2,2,100.0,0,1,1,0,1,0,0
993,Gonçalo Guedes,38,26,18,15,5,16,51,31.4,35,22,0,22,16,10,0
994,Gonçalo Guedes,0,0,0,0,0,0,0,,0,0,0,0,0,0,0
995,Ramiro Guerra,3,2,1,0,2,2,3,66.7,1,0,0,0,0,2,0
996,Raphaël Guerreiro,10,8,5,4,1,2,5,40.0,3,3,0,3,11,8,0
997,Francis Guerrero,31,19,22,7,2,16,34,47.1,18,16,4,12,21,26,0
998,John Guidetti,7,7,3,1,3,2,10,20.0,8,10,1,9,2,7,0
999,John Guidetti,0,0,0,0,0,0,0,,0,0,0,0,0,0,0
1000,Josuha Guilavogui,65,46,43,20,2,30,50,60.0,20,34,10,24,66,63,0
1001,Frederic Guilbert,136,89,71,58,7,50,105,47.6,55,43,13,30,88,136,0
1002,Guilherme,20,11,7,7,6,3,19,15.8,16,14,1,13,8,4,0
1003,Guilherme,79,56,35,37,7,28,77,36.4,49,36,9,27,46,62,0
1004,Baptiste Guillaume,4,1,0,2,2,0,5,0.0,5,4,1,3,2,1,0
1005,Serhou Guirassy,3,3,0,2,1,1,5,20.0,4,9,1,8,1,11,0
1006,Péter Gulácsi,0,0,0,0,0,0,2,0.0,2,0,0,0,0,12,4
1007,Manuel Gulde,16,10,14,2,0,10,19,52.6,9,24,17,7,14,71,0
1008,Gerard Gumbau,35,26,13,21,1,12,37,32.4,25,12,4,8,14,27,0
1009,İlkay Gündoğan,27,15,8,14,5,9,37,24.3,28,14,1,13,16,12,0
1010,Christian Günter,73,54,45,21,7,38,63,60.3,25,38,7,31,20,68,0
1011,Jon Guridi,1,0,1,0,0,0,1,0.0,1,1,0,1,0,0,0
1012,Régis Gurtner,1,0,1,0,0,1,1,100.0,0,0,0,0,4,15,4
1013,Samuel Gustafson,3,2,3,0,0,1,3,33.3,2,2,0,2,0,0,0
1014,Luiz Gustavo,89,54,45,40,4,26,62,41.9,36,44,13,31,50,56,1
1015,Alejandro Gutiérrez Mozo,3,2,1,2,0,1,4,25.0,3,0,0,0,0,0,0
1016,Jonathan de Guzmán,16,16,8,8,0,6,16,37.5,10,13,0,13,13,12,0
1017,Bright Gyamfi,2,2,1,1,0,1,2,50.0,1,3,1,2,7,8,0
1018,Nicolas Haas,1,1,1,0,0,0,2,0.0,2,1,1,0,1,4,1
1019,Janik Haberer,62,49,20,34,8,23,57,40.4,34,43,1,42,30,42,0
1020,Hacen,0,0,0,0,0,0,0,,0,4,2,2,1,0,0
1021,Alexander Hack,46,34,25,19,2,24,37,64.9,13,31,18,13,26,87,2
1022,Robin Hack,2,2,1,0,1,0,1,0.0,1,1,1,0,0,1,0
1023,Munir El Haddadi,25,20,8,9,8,5,14,35.7,9,13,2,11,9,5,0
1024,Oussama Haddadi,44,29,33,9,2,14,47,29.8,33,29,12,17,43,79,1
1025,Florent Hadergjonaj,21,16,7,10,4,12,30,40.0,18,22,10,12,17,45,0
1026,André Hahn,33,24,15,13,5,10,32,31.3,22,30,2,28,10,26,0
1027,Massadio Haïdara,0,0,0,0,0,0,0,,0,0,0,0,0,0,0
1028,Oualid El Hajjam,64,44,37,22,5,23,49,46.9,26,25,5,20,59,91,1
1029,Izet Hajrović,1,0,1,0,0,0,1,0.0,1,0,0,0,2,1,0
1030,Achraf Hakimi,21,15,9,6,6,11,25,44.0,14,9,1,8,10,19,1
1031,Alen Halilović,11,7,5,6,0,4,17,23.5,13,10,1,9,5,4,0
1032,Sébastien Haller,25,16,4,16,5,7,14,50.0,7,17,4,13,8,39,0
1033,Emil Hallfreðsson,19,14,9,7,3,7,24,29.2,17,13,2,11,20,16,0
1034,Marcel Halstenberg,29,19,16,9,4,15,19,78.9,4,15,1,14,23,42,1
1035,Ben Hamer,0,0,0,0,0,0,1,0.0,1,0,0,0,0,3,1
1036,Romain Hamouma,19,13,7,6,6,1,22,4.5,21,15,4,11,13,8,1
1037,Marek Hamšík,36,22,10,15,11,15,37,40.5,22,35,2,33,14,16,0
1038,Samir Handanović,0,0,0,0,0,0,0,,0,1,0,1,0,7,1
1039,Tim Handwerker,12,7,9,2,1,5,7,71.4,2,3,0,3,6,10,0
1040,Genki Haraguchi,6,6,2,3,1,2,6,33.3,4,4,0,4,2,3,0
1041,Amine Harit,39,27,11,21,7,13,37,35.1,24,23,0,23,19,11,0
1042,Martin Harnik,17,10,4,10,3,4,25,16.0,21,21,2,19,8,26,0
1043,Rekeem Harper,1,1,0,1,0,0,0,,0,0,0,0,0,0,0
1044,Joe Hart,1,1,1,0,0,1,2,50.0,1,1,0,1,0,2,4
1045,Makoto Hasebe,38,23,19,19,0,21,33,63.6,12,40,19,21,25,74,0
1046,Hans Hateboer,31,25,13,13,5,15,26,57.7,11,32,5,27,30,46,1
1047,Kai Havertz,34,23,8,23,3,12,25,48.0,13,33,2,31,19,23,0
1048,Isaac Hayden,40,23,23,16,1,12,34,35.3,22,21,6,15,23,43,0
1049,Eden Hazard,6,3,2,3,1,3,21,14.3,18,11,0,11,3,0,0
1050,Thorgan Hazard,49,32,16,23,10,20,54,37.0,34,39,1,38,28,18,0
1051,Tom Heaton,0,0,0,0,0,0,0,,0,0,0,0,0,0,0
1052,Jonas Hector,47,35,23,18,6,18,40,45.0,22,39,6,33,28,65,2
1053,Michael Hefele,0,0,0,0,0,0,0,,0,0,0,0,1,5,0
1054,Ahmed Hegazi,58,38,46,12,0,26,50,52.0,24,55,37,18,60,278,2
1055,Gauthier Hein,2,2,2,0,0,2,4,50.0,2,1,0,1,2,1,0
1056,Dominique Heintz,60,42,47,13,0,38,64,59.4,26,35,17,18,53,140,0
1057,Filip Helander,48,32,33,15,0,15,29,51.7,14,47,25,22,37,160,2
1058,Marcel Heller,37,24,21,14,2,12,28,42.9,16,22,1,21,10,7,0
1059,Tomer Hemed,7,5,3,4,0,2,10,20.0,8,10,1,9,2,12,0
1060,Jordan Henderson,51,33,13,32,6,18,52,34.6,34,33,2,31,31,27,0
1061,Jeff Hendrick,16,10,4,10,2,3,17,17.6,14,11,2,9,8,21,1
1062,Wayne Hennessey,0,0,0,0,0,0,0,,0,1,0,1,2,5,1
1063,Benjamin Henrichs,42,28,23,16,3,27,43,62.8,16,23,3,20,31,32,0
1064,Dalbert Henrique,15,10,11,3,1,7,13,53.8,6,7,4,3,13,19,0
1065,Christophe Hérelle,39,26,27,12,0,16,30,53.3,14,38,27,11,56,241,1
1066,Mario Hermoso,14,12,13,1,0,8,21,38.1,13,15,8,7,25,122,0
1067,Hernán,18,9,8,7,3,10,17,58.8,7,2,0,2,8,5,0
1068,Héctor Hernández,1,1,0,1,0,1,1,100.0,0,0,0,0,0,1,0
1069,Javier Hernández,11,7,2,7,2,3,14,21.4,11,6,1,5,6,1,0
1070,Lucas Hernández,93,68,51,35,7,55,74,74.3,19,35,10,25,40,90,0
1071,Luis Hernández,49,43,37,9,3,17,33,51.5,16,32,21,11,77,185,1
1072,Pablo Hernández,48,33,17,27,4,14,46,30.4,32,29,11,18,40,72,0
1073,Theo Hernández,21,15,16,2,3,13,25,52.0,12,9,2,7,17,20,0
1074,Hernani,21,13,9,9,3,10,22,45.5,12,15,2,13,6,5,0
1075,Ander Herrera,56,29,32,20,4,20,69,29.0,49,33,6,27,34,22,2
1076,Borja Herrera,2,1,2,0,0,2,7,28.6,5,6,1,5,3,4,0
1077,Iago Herrerín,2,1,2,0,0,2,2,100.0,0,0,0,0,0,7,1
1078,Patrick Herrmann,29,21,9,13,7,17,29,58.6,12,13,0,13,17,19,0
1079,Përparim Hetemaj,74,48,34,25,15,29,78,37.2,49,39,6,33,39,47,1
1080,Son Heung-min,17,10,2,12,3,2,28,7.1,26,18,0,18,10,12,0
1081,Thomas Heurtaux,14,11,12,2,0,4,8,50.0,4,25,16,9,37,97,1
1082,Gonzalo Higuaín,19,17,3,7,9,2,19,10.5,17,19,4,15,7,20,0
1083,Oscar Hiljemark,12,8,2,8,2,3,24,12.5,21,14,4,10,9,12,0
1084,Vitorino Hilton,44,26,33,11,0,13,36,36.1,23,28,14,14,58,140,5
1085,Kaylen Hinds,1,1,1,0,0,0,0,,0,1,0,1,1,0,0
1086,Martin Hinteregger,79,51,55,22,2,47,61,77.0,14,40,27,13,49,135,3
1087,Marwin Hitz,1,1,1,0,0,1,3,33.3,2,0,0,0,0,12,3
1088,Andrew Hjulsager,0,0,0,0,0,0,2,0.0,2,1,0,1,0,0,0
1089,Wesley Hoedt,60,51,48,12,0,36,61,59.0,25,32,17,15,40,177,2
1090,Nicolas Höfler,57,36,23,30,4,31,50,62.0,19,42,10,32,44,51,2
1091,Jonas Hofmann,23,19,12,11,0,12,26,46.2,14,15,4,11,12,16,0
1092,Marco Höger,60,40,31,28,1,30,64,46.9,34,35,5,30,25,27,1
1093,Jonathan Hogg,93,64,29,59,5,26,89,29.2,63,51,12,39,69,48,0
1094,Rob Holding,19,14,13,5,1,4,12,33.3,8,16,10,6,21,40,2
1095,José Holebas,51,31,34,14,3,18,44,40.9,26,24,8,16,29,95,2
1096,Lucas Höler,24,20,8,13,3,9,24,37.5,15,10,0,10,7,13,0
1097,Mason Holgate,23,16,15,7,1,10,21,47.6,11,12,9,3,23,86,2
1098,Lewis Holtby,44,29,14,26,4,17,32,53.1,15,23,2,21,10,9,0
1099,Gerrit Holtmann,16,13,8,5,3,11,22,50.0,11,19,2,17,12,9,0
1100,Jannes Horn,16,11,11,4,1,11,14,78.6,3,12,3,9,17,26,0
1101,Timo Horn,3,2,3,0,0,3,6,50.0,3,0,0,0,0,18,2
1102,Benedikt Höwedes,1,1,1,0,0,0,0,,0,0,0,0,8,10,1
1103,Lukáš Hrádecký,0,0,0,0,0,0,2,0.0,2,0,0,0,0,23,3
1104,Branimir Hrgota,5,4,0,3,2,4,7,57.1,3,2,0,2,0,1,0
1105,Timo Hübers,11,10,9,2,0,9,15,60.0,6,13,8,5,9,31,0
1106,Benjamin Hübner,71,56,43,27,1,31,46,67.4,15,40,18,22,51,114,0
1107,Florian Hübner,10,9,8,2,0,5,9,55.6,4,3,2,1,6,21,0
1108,Tomáš Hubočan,1,0,1,0,0,0,4,0.0,4,0,0,0,0,1,0
1109,Callum Hudson-Odoi,0,0,0,0,0,0,0,,0,0,0,0,0,0,0
1110,Will Hughes,34,18,7,18,9,9,19,47.4,10,16,1,15,15,6,0
1111,Jordan Hugill,0,0,0,0,0,0,1,0.0,1,0,0,0,0,0,0
1112,Vitor Hugo,32,21,26,6,0,10,17,58.8,7,10,6,4,43,92,0
1113,Mats Hummels,62,52,41,18,3,35,51,68.6,16,31,12,19,55,59,2
1114,Uwe Hünemeier,0,0,0,0,0,0,0,,0,0,0,0,0,4,0
1115,Adrien Hunou,27,15,11,8,8,11,42,26.2,31,22,1,21,9,8,1
1116,Aaron Hunt,36,24,12,20,4,11,37,29.7,26,20,2,18,14,18,2
1117,Emerson Hyndman,0,0,0,0,0,0,1,0.0,1,2,0,2,1,1,0
1118,Elseid Hysaj,64,45,28,30,6,32,56,57.1,24,35,4,31,43,68,4
1119,Suk Hyun-jun,6,5,2,2,2,1,9,11.1,8,10,0,10,1,7,0
1120,Pierre Højbjerg,45,29,24,18,3,13,56,23.2,43,30,3,27,37,26,1
1121,Jordon Ibe,14,12,7,5,2,6,22,27.3,16,5,0,5,10,11,0
1122,Vedad Ibišević,10,8,1,5,4,4,7,57.1,3,8,1,7,4,23,0
1123,Vicente Iborra,23,18,13,10,0,9,36,25.0,27,25,11,14,19,49,1
1124,Zlatan Ibrahimović,2,1,1,0,1,0,1,0.0,1,0,0,0,0,1,0
1125,Mauro Icardi,3,2,1,2,0,1,8,12.5,7,14,6,8,5,23,1
1126,Brown Ideye,2,2,0,2,0,0,5,0.0,5,2,0,2,1,11,0
1127,Edgar Ié,74,42,55,18,1,31,69,44.9,38,57,26,31,84,135,3
1128,Julien Ielsch,28,18,12,11,5,7,25,28.0,18,16,3,13,11,15,2
1129,Pietro Iemmello,2,2,1,1,0,2,8,25.0,6,4,0,4,1,11,2
1130,Kelechi Iheanacho,9,6,3,5,1,3,20,15.0,17,10,2,8,3,4,0
1131,Jordan Ikoko,44,29,24,15,5,22,42,52.4,20,20,2,18,48,74,0
1132,Jonathan Ikone,13,10,3,6,4,4,14,28.6,10,8,0,8,6,3,0
1133,Josip Iličić,24,19,5,13,6,8,29,27.6,21,19,0,19,16,2,0
1134,Asier Illarramendi,85,57,35,41,9,37,90,41.1,53,44,8,36,75,35,0
1135,Jules Iloki,13,9,1,9,3,3,16,18.8,13,8,0,8,12,16,0
1136,Stefan Ilsanker,37,29,23,11,3,22,39,56.4,17,23,10,13,25,55,1
1137,Giannelli Imbula,29,19,10,15,4,7,29,24.1,22,17,2,15,20,13,3
1138,Ciro Immobile,4,2,0,3,1,0,17,0.0,17,14,1,13,0,9,0
1139,Emmanuel Imorou,0,0,0,0,0,0,0,,0,0,0,0,1,1,0
1140,Tom Ince,35,27,14,16,5,10,29,34.5,19,20,0,20,12,12,0
1141,Svante Ingelsson,9,6,3,3,3,2,10,20.0,8,4,0,4,6,4,0
1142,Roberto Inglese,31,21,13,9,9,7,30,23.3,23,21,2,19,8,17,1
1143,Danny Ings,5,3,1,3,1,0,0,,0,4,0,4,2,1,0
1144,Andrés Iniesta,28,22,11,8,9,6,31,19.4,25,21,2,19,10,12,1
1145,Lorenzo Insigne,29,17,11,13,5,13,33,39.4,20,20,0,20,17,4,0
1146,Emiliano Insúa,46,34,27,16,3,17,32,53.1,15,30,4,26,36,48,1
1147,Pablo Insua,0,0,0,0,0,0,0,,0,1,1,0,0,1,0
1148,Takashi Inui,39,21,12,19,8,13,42,31.0,29,36,0,36,18,10,0
1149,Artur Ioniță,63,45,30,24,9,17,38,44.7,21,39,7,32,28,29,0
1150,Gorka Iraizoz,1,1,1,0,0,1,2,50.0,1,0,0,0,1,9,2
1151,Stephen Ireland,3,1,2,1,0,1,5,20.0,4,4,2,2,1,1,0
1152,Carlos Isaac,1,0,1,0,0,1,3,33.3,2,0,0,0,2,1,0
1153,Alexander Isak,1,0,0,1,0,0,1,0.0,1,1,0,1,0,0,0
1154,Isco,22,12,5,10,7,5,35,14.3,30,11,0,11,15,2,0
1155,Tatsuya Ito,16,13,4,8,4,11,22,50.0,11,28,0,28,6,1,0
1156,Gian-Luca Itter,19,12,15,2,2,14,22,63.6,8,6,0,6,5,15,0
1157,Manuel Iturra,70,45,36,27,7,22,55,40.0,33,19,2,17,29,23,0
1158,Ander Iturraspe,42,31,18,22,2,10,32,31.3,22,22,7,15,35,57,0
1159,Ivi,48,34,19,23,6,21,62,33.9,41,21,1,20,15,15,0
1160,Alex Iwobi,19,15,8,8,3,5,18,27.8,13,19,1,18,7,10,1
1161,José Izquierdo,23,15,12,9,2,7,19,36.8,12,6,0,6,16,34,0
1162,Armando Izzo,30,23,14,10,6,12,18,66.7,6,15,6,9,34,70,0
1163,Koo Ja-cheol,54,41,18,31,5,27,44,61.4,17,22,3,19,27,34,2
1164,Paul Jaeckel,3,3,3,0,0,1,2,50.0,1,5,2,3,1,8,0
1165,Phil Jagielka,33,23,24,9,0,8,21,38.1,13,30,20,10,39,179,1
1166,Kilian Jakob,0,0,0,0,0,0,0,,0,1,0,1,0,1,0
1167,Eldin Jakupović,0,0,0,0,0,0,0,,0,0,0,0,0,4,0
1168,Christophe Jallet,29,21,21,8,0,11,26,42.3,15,18,6,12,16,47,0
1169,Ablie Jallow,1,1,1,0,0,0,5,0.0,5,1,0,1,3,1,0
1170,Matty James,19,10,7,11,1,2,10,20.0,8,14,2,12,17,25,0
1171,Vasilije Janjicic,14,11,5,9,0,2,4,50.0,2,6,1,5,3,5,0
1172,Christoph Janker,4,3,3,1,0,2,3,66.7,1,0,0,0,1,4,1
1173,Saidy Janko,43,30,25,14,4,14,24,58.3,10,21,1,20,14,50,0
1174,Jakub Jankto,29,18,9,14,6,10,46,21.7,36,46,8,38,20,27,0
1175,Daryl Janmaat,46,31,29,10,7,22,52,42.3,30,16,5,11,33,61,0
1176,Vincent Janssen,0,0,0,0,0,0,0,,0,0,0,0,0,0,0
1177,Tony Jantschke,13,11,9,4,0,8,13,61.5,5,10,1,9,6,25,0
1178,Adnan Januzaj,16,11,2,8,6,5,18,27.8,13,12,0,12,11,5,0
1179,Nicolas Janvier,4,1,1,1,2,1,2,50.0,1,1,0,1,1,0,0
1180,Paweł Jaroszyński,20,12,14,5,1,9,18,50.0,9,11,4,7,21,40,1
1181,Rune Jarstein,1,1,1,0,0,1,2,50.0,1,0,0,0,0,8,5
1182,Jason,32,25,11,14,7,11,38,28.9,27,14,1,13,20,8,0
1183,Bakery Jatta,14,12,2,12,0,4,6,66.7,2,6,1,5,3,5,0
1184,Corentin Jean,12,8,4,7,1,5,21,23.8,16,14,1,13,14,10,0
1185,Benjamin Jeannot,12,7,5,6,1,1,13,7.7,12,9,3,6,6,26,0
1186,Tin Jedvaj,10,6,2,6,2,8,15,53.3,7,9,1,8,9,18,0
1187,Jemerson,48,32,32,15,1,24,31,77.4,7,46,32,14,56,169,1
1188,Jesé,10,7,3,5,2,3,13,23.1,10,5,0,5,0,3,0
1189,Gabriel Jesus,23,15,6,10,7,3,22,13.6,19,16,0,16,8,6,0
1190,Juan Jesus,42,30,25,15,2,18,34,52.9,16,18,9,9,39,63,0
1191,Álvaro Jiménez,15,8,5,6,4,8,21,38.1,13,6,0,6,1,6,0
1192,Joaquín,22,19,11,10,1,4,16,25.0,12,17,2,15,15,38,0
1193,Aron Jóhannsson,4,3,2,2,0,1,7,14.3,6,3,0,3,1,5,0
1194,Fabian Johnson,16,10,7,7,2,6,7,85.7,1,10,2,8,2,13,0
1195,Glen Johnson,7,5,5,2,0,3,12,25.0,9,7,2,5,10,23,0
1196,Karl-Johan Johnsson,0,0,0,0,0,0,1,0.0,1,0,0,0,0,14,4
1197,Miloš Jojić,36,26,18,15,3,16,40,40.0,24,31,4,27,15,16,0
1198,Jonathas,7,3,2,4,1,1,2,50.0,1,3,1,2,0,9,0
1199,Phil Jones,25,18,20,5,0,9,20,45.0,11,25,17,8,41,133,2
1200,Nigel de Jong,17,12,7,9,1,10,14,71.4,4,5,1,4,12,22,1
1201,Jony,3,2,2,0,1,0,4,0.0,4,1,0,1,2,1,0
1202,Joan Jordán,31,24,8,19,4,10,68,14.7,58,24,0,24,30,12,0
1203,Jorge,69,40,34,25,10,23,38,60.5,15,19,2,17,66,86,0
1204,Jorginho,62,46,14,39,9,15,68,22.1,53,32,3,29,50,12,2
1205,Willian José,10,7,1,5,4,2,9,22.2,7,10,1,9,5,31,0
1206,Joselu,22,17,10,11,1,7,34,20.6,27,25,2,23,11,39,0
1207,Yann Jouffre,3,2,0,2,1,1,6,16.7,5,5,1,4,3,2,0
1208,Vukašin Jovanović,18,14,11,7,0,6,14,42.9,8,18,10,8,27,67,0
1209,Stevan Jovetić,4,4,0,3,1,0,9,0.0,9,5,0,5,3,3,0
1210,Luka Jović,5,5,0,5,0,1,3,33.3,2,6,2,4,1,2,0
1211,Jozabed,18,12,7,9,2,3,18,16.7,15,18,2,16,16,19,0
1212,Juanfran,64,44,38,22,4,35,65,53.8,30,29,11,18,63,121,0
1213,Juanfran,33,24,21,9,3,21,32,65.6,11,14,4,10,26,35,0
1214,Juankar,23,17,13,8,2,11,20,55.0,9,8,1,7,19,26,0
1215,Juanmi,22,13,7,12,3,4,22,18.2,18,11,0,11,10,6,0
1216,Juanpe,48,30,28,20,0,30,43,69.8,13,27,19,8,53,137,0
1217,Juanpi,11,8,2,7,2,3,8,37.5,5,7,0,7,6,1,0
1218,Mariano Julio Izco,6,4,2,4,0,2,4,50.0,2,2,0,2,4,1,0
1219,Christopher Jullien,36,25,27,9,0,15,32,46.9,17,29,19,10,40,182,5
1220,David Juncà,15,13,9,6,0,7,19,36.8,12,7,1,6,11,25,0
1221,Gideon Jung,59,41,32,24,3,22,38,57.9,16,29,12,17,38,71,1
1222,Sebastian Jung,2,2,1,1,0,1,1,100.0,0,0,0,0,0,5,0
1223,Zlatko Junuzović,35,23,17,12,6,18,38,47.4,20,23,2,21,18,12,0
1224,Mathias Jørgensen,55,36,40,13,2,19,45,42.2,26,49,20,29,76,249,5
1225,Christian Kabasele,42,25,28,14,0,21,36,58.3,15,37,23,14,34,185,0
1226,Younès Kaboul,3,2,0,3,0,0,0,,0,4,2,2,2,15,0
1227,Alexander Kačaniklić,8,5,7,1,0,5,10,50.0,5,5,2,3,6,7,0
1228,Gojko Kačar,7,6,6,1,0,3,7,42.9,4,3,2,1,4,7,0
1229,Elias Kachunga,30,26,13,12,5,8,19,42.1,11,14,1,13,2,9,0
1230,Pavel Kadeřábek,44,30,22,18,4,20,44,45.5,24,27,8,19,34,45,1
1231,Shinji Kagawa,32,22,11,14,7,18,27,66.7,9,6,0,6,6,2,0
1232,Sullay Kaikai,1,0,0,1,0,0,0,,0,1,0,1,0,1,0
1233,Florian Kainz,33,25,9,18,6,9,19,47.4,10,23,0,23,17,13,0
1234,Dominik Kaiser,5,5,1,3,1,4,11,36.4,7,6,0,6,1,8,0
1235,Gaël Kakuta,54,32,14,27,13,9,40,22.5,31,33,3,30,26,19,0
1236,Nikola Kalinić,6,5,1,4,1,0,8,0.0,8,4,1,3,3,12,0
1237,Salomon Kalou,19,11,12,5,2,9,17,52.9,8,37,1,36,10,29,0
1238,Daichi Kamada,1,1,0,1,0,0,0,,0,0,0,0,1,0,0
1239,François Kamano,32,24,11,14,7,10,35,28.6,25,18,2,16,15,8,0
1240,Bingourou Kamara,0,0,0,0,0,0,2,0.0,2,0,0,0,1,6,3
1241,Boubacar Kamara,14,14,9,5,0,8,12,66.7,4,7,3,4,3,18,0
1242,Marcin Kamiński,17,14,5,11,1,12,18,66.7,6,12,3,9,30,55,0
1243,Kevin Kampl,42,33,16,20,6,16,39,41.0,23,37,2,35,33,33,0
1244,Kevin Kampl,1,1,1,0,0,1,1,100.0,0,0,0,0,0,0,0
1245,Harry Kane,17,12,2,8,7,4,15,26.7,11,15,4,11,5,19,0
1246,Wilfried Kanga,2,2,0,2,0,0,2,0.0,2,0,0,0,0,1,0
1247,Mamadou Kanouté,0,0,0,0,0,0,0,,0,0,0,0,1,1,0
1248,N'Golo Kanté,113,77,55,52,6,33,92,35.9,59,40,4,36,85,29,3
1249,Bartosz Kapustka,9,5,2,6,1,4,6,66.7,2,4,0,4,3,0,0
1250,Kenan Karaman,16,13,9,6,1,6,7,85.7,1,10,4,6,1,17,0
1251,Yann Karamoh,3,1,1,1,1,0,3,0.0,3,4,0,4,4,1,1
1252,Loris Karius,0,0,0,0,0,0,0,,0,0,0,0,1,4,0
1253,Orestis Karnezis,0,0,0,0,0,0,2,0.0,2,0,0,0,1,3,3
1254,Rick Karsdorp,1,1,1,0,0,0,0,,0,0,0,0,1,0,0
1255,Aleksandar Katai,1,1,0,1,0,0,1,0.0,1,0,0,0,0,0,0
1256,Florian Kath,15,10,3,9,3,9,17,52.9,8,9,0,9,8,1,0
1257,Ole Käuper,6,5,2,4,0,1,4,25.0,3,1,0,1,2,0,0
1258,Eiji Kawashima,1,1,1,0,0,1,3,33.3,2,0,0,0,3,9,2
1259,Beram Kayal,18,11,10,7,1,6,26,23.1,20,11,4,7,12,9,0
1260,Joris Kayembe,1,0,1,0,0,0,4,0.0,4,0,0,0,0,4,0
1261,Olarenwaju Kayode,3,3,1,2,0,0,4,0.0,4,1,0,1,1,0,0
1262,Moise Kean,8,5,1,3,4,1,6,16.7,5,6,0,6,7,4,0
1263,Michael Keane,33,25,26,5,2,19,43,44.2,24,39,28,11,53,214,0
1264,Thilo Kehrer,81,64,41,36,4,46,68,67.6,22,42,12,30,35,113,2
1265,Cheick Keita,2,2,1,1,0,1,3,33.3,2,5,0,5,2,1,0
1266,Naby Keïta,65,48,25,33,7,17,43,39.5,26,26,3,23,36,18,0
1267,Keko,38,23,17,13,8,15,47,31.9,32,25,3,22,13,9,0
1268,Martin Kelly,19,13,15,4,0,14,26,53.8,12,16,11,5,9,67,3
1269,Marc-Oliver Kempf,13,12,9,4,0,5,8,62.5,3,7,7,0,17,52,0
1270,Kenedy,31,17,16,13,2,12,35,34.3,23,12,1,11,14,11,0
1271,Jonjoe Kenny,41,33,28,10,3,20,32,62.5,12,17,7,10,28,95,0
1272,Ryan Kent,4,3,2,1,1,2,5,40.0,3,6,0,6,1,1,0
1273,Christophe Kerbrat,62,45,47,14,1,35,65,53.8,30,49,40,9,62,249,2
1274,Franck Kessié,48,34,20,19,9,17,44,38.6,27,47,11,36,26,45,3
1275,Billy Ketkeophomphone,14,9,4,5,5,5,15,33.3,10,9,0,9,5,8,0
1276,Driss Khalid,1,0,0,0,1,0,0,,0,0,0,0,0,2,0
1277,Saîf-Eddine Khaoui,57,25,22,27,8,15,50,30.0,35,12,2,10,27,9,0
1278,Wahbi Khazri,26,18,7,10,9,7,39,17.9,32,29,0,29,7,7,0
1279,Rani Khedira,62,47,25,28,9,33,47,70.2,14,41,18,23,36,96,0
1280,Sami Khedira,14,9,1,9,4,2,23,8.7,21,13,3,10,20,20,0
1281,Stefan Kießling,0,0,0,0,0,0,0,,0,2,0,2,0,1,0
1282,Kiké,14,8,1,7,6,2,11,18.2,9,15,1,14,10,14,0
1283,Joshua Kimmich,32,23,14,13,5,20,38,52.6,18,26,5,21,20,40,0
1284,Presnel Kimpembe,39,28,20,18,1,9,14,64.3,5,17,10,7,24,80,1
1285,Andy King,8,5,0,5,3,0,3,0.0,3,4,2,2,5,13,0
1286,Andy King,18,11,10,8,0,5,14,35.7,9,7,0,7,6,14,1
1287,Joshua King,36,26,11,17,8,4,27,14.8,23,23,3,20,4,14,1
1288,Simon Kjær,35,24,25,8,2,13,22,59.1,9,16,10,6,32,109,0
1289,Davy Klaassen,3,1,1,2,0,2,6,33.3,4,2,1,1,1,2,0
1290,Felix Klaus,48,38,20,21,7,23,50,46.0,27,29,4,25,8,28,0
1291,Ragnar Klavan,14,10,6,7,1,6,12,50.0,6,11,5,6,15,85,1
1292,Tim Kleindienst,22,15,6,12,4,4,17,23.5,13,17,3,14,6,21,0
1293,Lukas Klostermann,56,41,34,18,4,28,37,75.7,9,33,6,27,33,79,0
1294,Lukas Klünter,25,20,16,8,1,16,24,66.7,8,11,2,9,13,28,1
1295,Robin Knoche,34,20,26,8,0,25,35,71.4,10,36,24,12,25,89,1
1296,Anthony Knockaert,39,26,25,11,3,16,55,29.1,39,29,3,26,23,16,0
1297,Törles Knöll,0,0,0,0,0,0,0,,0,1,0,1,0,0,0
1298,Robin Koch,34,24,21,13,0,10,18,55.6,8,27,11,16,35,67,0
1299,Kenan Kodro,1,1,0,1,0,0,0,,0,1,0,1,3,0,0
1300,Hervé Koffi,0,0,0,0,0,0,0,,0,0,0,0,1,1,1
1301,Dominik Kohr,49,26,20,25,4,25,41,61.0,16,39,5,34,30,24,0
1302,Seybou Koita,1,1,1,0,0,1,1,100.0,0,0,0,0,0,2,0
1303,Koke,75,45,31,32,12,27,95,28.4,68,40,3,37,24,38,0
1304,Aleksandar Kolarov,58,47,34,16,8,27,49,55.1,22,24,7,17,53,100,2
1305,Sead Kolašinac,49,37,28,13,8,20,39,51.3,19,15,3,12,26,56,0
1306,Vincent Kompany,20,11,14,5,1,13,19,68.4,6,10,8,2,16,73,1
1307,Ibrahima Konaté,32,25,20,12,0,18,23,78.3,5,14,3,11,20,66,0
1308,Moussa Konaté,8,6,1,4,3,3,23,13.0,20,10,2,8,3,11,0
1309,Geoffrey Kondogbia,88,57,38,43,7,23,68,33.8,45,46,14,32,62,66,0
1310,Bakary Koné,26,17,23,3,0,12,31,38.7,19,20,10,10,33,122,2
1311,Terence Kongolo,33,20,19,13,1,14,22,63.6,8,12,6,6,32,71,0
1312,Terence Kongolo,6,4,4,2,0,0,2,0.0,2,5,3,2,5,14,0
1313,Yevhen Konoplyanka,11,9,3,4,4,3,11,27.3,8,18,1,17,5,6,0
1314,Julian Korb,52,41,27,19,6,37,68,54.4,31,30,2,28,22,77,0
1315,Laurent Koscielny,43,21,27,12,4,19,33,57.6,14,28,15,13,54,138,3
1316,Filip Kostić,48,38,16,21,11,20,41,48.8,21,42,1,41,10,12,0
1317,Christian Kouakou,24,13,14,8,2,5,19,26.3,14,16,1,15,8,6,1
1318,Rominigue Kouamé,5,2,2,2,1,2,3,66.7,1,1,0,1,5,0,0
1319,Tomáš Koubek,0,0,0,0,0,0,1,0.0,1,0,0,0,3,22,3
1320,Kalidou Koulibaly,54,42,31,19,4,20,40,50.0,20,36,16,20,40,119,3
1321,Jules Koundé,26,19,19,7,0,13,17,76.5,4,14,11,3,14,97,0
1322,Cheikhou Kouyaté,71,49,43,26,2,23,62,37.1,39,31,11,20,32,56,1
1323,Mateo Kovačić,37,27,19,18,0,8,27,29.6,19,9,4,5,5,5,0
1324,Maksym Koval,0,0,0,0,0,0,0,,0,0,0,0,0,0,2
1325,Dawid Kownacki,8,7,1,4,3,3,11,27.3,8,7,0,7,1,5,0
1326,Vincent Koziello,16,8,9,5,2,5,16,31.3,11,8,3,5,19,7,1
1327,Vincent Koziello,28,21,6,21,1,10,21,47.6,11,9,0,9,10,5,1
1328,Thomas Kraft,0,0,0,0,0,0,0,,0,0,0,0,0,1,0
1329,Emil Krafth,23,16,14,8,1,10,19,52.6,9,12,4,8,16,39,1
1330,Oliver Kragl,1,0,0,1,0,0,0,,0,1,0,1,2,2,0
1331,Andrej Kramarić,8,6,4,3,1,3,8,37.5,5,15,0,15,6,7,0
1332,Christoph Kramer,89,70,43,34,12,39,76,51.3,37,29,4,25,43,37,1
1333,Ladislav Krejčí,7,5,1,3,3,1,5,20.0,4,3,0,3,2,3,0
1334,Rene Krhin,18,12,7,11,0,3,17,17.6,14,11,2,9,16,39,0
1335,Bojan Krkić,0,0,0,0,0,0,1,0.0,1,1,0,1,0,0,0
1336,Bojan Krkić,2,1,1,1,0,1,2,50.0,1,5,0,5,3,0,0
1337,Michael Krohn-Dehli,12,9,6,5,1,4,17,23.5,13,2,0,2,13,7,0
1338,Michael Krohn-Dehli,13,7,4,5,4,6,11,54.5,5,5,0,5,4,7,0
1339,Toni Kroos,55,35,19,29,7,22,59,37.3,37,20,2,18,16,10,1
1340,Max Kruse,17,12,3,10,4,5,22,22.7,17,9,0,9,11,4,1
1341,Grzegorz Krychowiak,39,24,18,17,4,12,49,24.5,37,23,5,18,45,23,0
1342,Lukas Kübler,31,19,16,15,0,13,23,56.5,10,15,6,9,18,41,0
1343,Jasmin Kurtić,28,18,13,11,4,5,21,23.8,16,13,1,12,17,25,0
1344,Jasmin Kurtić,12,7,6,3,3,3,7,42.9,4,7,0,7,5,4,0
1345,Layvin Kurzawa,44,32,20,15,9,15,39,38.5,24,16,3,13,35,41,2
1346,Filip Kusić,0,0,0,0,0,0,0,,0,0,0,0,0,1,0
1347,Zdravko Kuzmanović,4,4,1,3,0,0,5,0.0,5,2,2,0,4,9,0
1348,Han Kwang-song,1,1,0,0,1,0,4,0.0,4,4,0,4,0,0,0
1349,Enock Kwateng,8,6,6,2,0,7,11,63.6,4,2,0,2,1,7,0
1350,Alberto de la Bella,36,22,25,10,1,16,28,57.1,12,19,5,14,21,54,0
1351,Rajiv van La Parra,41,29,18,15,8,12,41,29.3,29,27,1,26,21,8,1
1352,Brighton Labeau,0,0,0,0,0,0,0,,0,0,0,0,0,0,0
1353,Gaëtan Laborde,9,7,1,6,2,2,7,28.6,5,8,2,6,1,7,1
1354,Alexandre Lacazette,24,17,6,11,7,4,27,14.8,23,19,3,16,7,5,0
1355,Mehdi Lacen,35,19,18,17,0,14,38,36.8,24,13,1,12,15,11,0
1356,Mehdi Lacen,3,1,2,1,0,0,0,,0,1,0,1,0,1,0
1357,Léo Lacroix,13,8,8,5,0,5,9,55.6,4,6,3,3,11,54,1
1358,Freddie Ladapo,0,0,0,0,0,0,0,,0,0,0,0,0,0,0
1359,Alban Lafont,1,0,1,0,0,1,4,25.0,3,0,0,0,2,20,5
1360,Víctor Laguardia,20,15,13,5,2,11,19,57.9,8,23,14,9,29,109,0
1361,Konrad Laimer,57,39,31,22,4,28,57,49.1,29,37,2,35,11,32,0
1362,Kenny Lala,87,47,53,28,6,21,47,44.7,26,18,10,8,42,70,2
1363,Adam Lallana,3,1,3,0,0,2,10,20.0,8,3,0,3,1,1,0
1364,Eugenio Lamanna,0,0,0,0,0,0,0,,0,0,0,0,0,1,0
1365,Érik Lamela,23,13,9,7,7,3,20,15.0,17,11,1,10,7,5,0
1366,Ádám Lang,3,1,3,0,0,3,5,60.0,2,2,1,1,3,12,0
1367,Sebastian Langkamp,15,12,9,6,0,11,18,61.1,7,7,4,3,21,58,1
1368,Sebastian Langkamp,7,3,4,3,0,4,4,100.0,0,7,5,2,8,18,0
1369,Manuel Lanzini,20,11,6,11,3,2,34,5.9,32,7,1,6,30,5,2
1370,Gianluca Lapadula,8,5,4,4,0,1,11,9.1,10,7,1,6,3,8,0
1371,Aymeric Laporte,8,7,6,2,0,3,8,37.5,5,2,1,1,11,27,0
1372,Aymeric Laporte,38,23,27,11,0,14,25,56.0,11,19,13,6,27,94,1
1373,Danilo Larangeira,35,21,26,8,1,16,29,55.2,13,50,38,12,50,161,2
1374,Kevin Lasagna,10,7,0,8,2,2,7,28.6,5,27,4,23,8,18,0
1375,Jamaal Lascelles,31,19,19,11,1,12,19,63.2,7,33,24,9,28,232,1
1376,Paul Lasne,68,45,27,39,2,12,54,22.2,42,20,1,19,57,26,0
1377,Borja Lasso,4,1,2,2,0,1,2,50.0,1,3,0,3,0,0,0
1378,Toni Lato,30,16,22,6,2,16,27,59.3,11,9,3,6,9,23,0
1379,Danny Latza,67,48,28,33,6,33,73,45.2,40,43,8,35,26,47,1
1380,Vincent Laurini,34,23,21,9,4,12,22,54.5,10,20,5,15,11,72,1
1381,Wesley Lautoa,17,13,11,6,0,6,12,50.0,6,10,4,6,19,24,1
1382,Diego Laxalt,54,43,31,17,6,22,59,37.3,37,38,3,35,25,55,1
1383,Miguel Layún,28,19,14,12,2,17,36,47.2,19,18,4,14,15,44,1
1384,Achraf Lazaar,12,8,9,2,1,5,11,45.5,6,5,1,4,6,10,0
1385,Valentino Lazaro,33,28,11,12,10,15,31,48.4,16,35,2,33,15,32,0
1386,Darko Lazović,19,12,16,2,1,9,18,50.0,9,8,0,8,13,12,0
1387,Manuel Lazzari,61,47,33,21,7,27,62,43.5,35,32,7,25,31,73,2
1388,Mickaël Le Bihan,0,0,0,0,0,0,3,0.0,3,0,0,0,1,0,0
1389,Maxime Le Marchand,48,36,28,18,2,20,41,48.8,21,36,13,23,65,105,4
1390,James Lea Siliki,31,21,9,19,3,6,41,14.6,35,21,1,20,18,14,1
1391,Mathew Leckie,35,30,16,15,4,20,35,57.1,15,26,3,23,19,32,1
1392,Benjamin Lecomte,1,1,1,0,0,0,0,,0,1,0,1,0,14,1
1393,Pierre Lees-Melou,78,47,29,39,10,27,76,35.5,49,52,11,41,34,38,2
1394,Matthias Lehmann,33,23,14,18,1,17,29,58.6,12,15,7,8,26,24,1
1395,Lucas Leiva,107,80,43,59,5,29,100,29.0,71,33,7,26,70,59,0
1396,Florian Lejeune,34,20,26,8,0,14,30,46.7,16,21,15,6,46,154,0
1397,Iñigo Lekue,71,42,37,26,8,34,53,64.2,19,29,3,26,16,46,1
1398,Thomas Lemar,33,17,9,19,5,10,41,24.4,31,22,1,21,18,16,1
1399,Mario Lemina,55,40,21,29,5,12,30,40.0,18,18,6,12,36,36,4
1400,Mauricio Lemos,11,9,8,3,0,7,14,50.0,7,10,5,5,9,33,1
1401,Mauricio Lemos,22,10,17,5,0,15,27,55.6,12,16,13,3,25,51,1
1402,Dylan Lempereur,5,3,3,1,1,2,6,33.3,4,1,0,1,0,6,0
1403,Clément Lenglet,67,50,32,35,0,21,38,55.3,17,44,27,17,35,157,1
1404,Aaron Lennon,20,14,5,14,1,2,20,10.0,18,20,5,15,8,18,0
1405,Aaron Lennon,17,10,10,5,2,5,21,23.8,16,13,1,12,11,9,0
1406,Bernd Leno,0,0,0,0,0,0,1,0.0,1,0,0,0,1,11,2
1407,Pedro León,9,4,0,2,7,0,4,0.0,4,18,2,16,9,5,0
1408,Sergio León,13,7,3,6,4,3,11,27.3,8,12,1,11,6,5,0
1409,Lukas Lerager,107,74,33,61,13,33,107,30.8,74,44,8,36,67,66,1
1410,Mehdi Léris,1,1,1,0,0,0,1,0.0,1,0,0,0,1,0,0
1411,Jefferson Lerma,51,35,26,23,2,17,45,37.8,28,25,10,15,49,43,0
1412,Maxime Lestienne,8,5,5,0,3,3,15,20.0,12,7,1,6,6,6,0
1413,Alexandre Letellier,0,0,0,0,0,0,0,,0,0,0,0,0,1,2
1414,Gaetano Letizia,36,26,21,14,1,19,49,38.8,30,24,3,21,33,47,3
1415,Timo Letschert,13,8,10,3,0,5,8,62.5,3,9,3,6,7,23,0
1416,Robert Lewandowski,5,3,1,1,3,0,3,0.0,3,6,0,6,5,10,0
1417,Igor Lewczuk,9,7,5,3,1,3,6,50.0,3,2,2,0,7,11,0
1418,Stephan Lichtsteiner,31,27,16,10,5,9,17,52.9,8,11,2,9,15,38,1
1419,Dimitri Liénard,77,51,37,32,8,30,84,35.7,54,35,2,33,52,41,1
1420,Philipp Lienhart,16,14,12,4,0,6,17,35.3,11,14,9,5,11,60,0
1421,Lucas Lima,73,46,40,27,6,31,68,45.6,37,42,6,36,38,85,0
1422,Victor Lindelöf,17,11,10,6,1,9,14,64.3,5,15,11,4,13,67,1
1423,Karol Linetty,66,49,25,31,10,17,77,22.1,60,40,2,38,18,13,0
1424,Jesse Lingard,30,21,10,13,7,5,27,18.5,22,18,3,15,9,13,0
1425,Pol Lirola,34,21,26,6,2,20,35,57.1,15,11,4,7,28,88,1
1426,Jake Livermore,72,41,27,35,10,24,64,37.5,40,44,9,35,26,36,2
1427,Raúl Lizoain,1,0,1,0,0,1,3,33.3,2,0,0,0,1,2,3
1428,Adem Ljajić,12,9,4,6,2,5,13,38.5,8,11,1,10,9,13,0
1429,Diego Llorente,30,22,16,13,1,18,29,62.1,11,41,18,23,43,96,0
1430,Fernando Llorente,6,3,1,2,3,1,2,50.0,1,0,0,0,0,6,0
1431,Marcos Llorente,15,8,7,8,0,6,11,54.5,5,7,0,7,5,8,0
1432,Hugo Lloris,1,1,1,0,0,1,4,25.0,3,0,0,0,2,34,8
1433,Giovani Lo Celso,77,58,26,36,15,26,74,35.1,48,30,5,25,19,12,1
1434,Simone Lo Faso,1,1,1,0,0,0,1,0.0,1,0,0,0,1,0,0
1435,Stanislav Lobotka,64,45,24,35,5,23,65,35.4,42,25,9,16,39,22,0
1436,Jürgen Locadia,1,0,0,1,0,0,1,0.0,1,0,0,0,1,1,1
1437,Manuel Locatelli,16,13,6,9,1,4,18,22.2,14,10,2,8,9,13,0
1438,Ruben Loftus-Cheek,21,15,7,13,1,7,30,23.3,23,19,2,17,22,31,0
1439,Enzo Loiodice,9,5,4,5,0,4,7,57.1,3,0,0,0,2,0,0
1440,Joe Lolley,2,0,1,1,0,0,2,0.0,2,0,0,0,3,2,1
1441,David Lombán,16,8,12,3,1,10,15,66.7,5,6,4,2,29,66,2
1442,Cristiano Lombardi,25,19,16,7,2,6,27,22.2,21,12,2,10,13,22,0
1443,Kevin Long,32,23,28,4,0,16,26,61.5,10,25,14,11,19,129,1
1444,Shane Long,25,20,1,19,5,10,30,33.3,20,14,2,12,12,29,0
1445,Ademola Lookman,1,1,0,1,0,0,2,0.0,2,2,0,2,1,3,0
1446,Ademola Lookman,5,4,2,3,0,0,0,,0,3,0,3,2,2,0
1447,Anthony Lopes,0,0,0,0,0,0,0,,0,0,0,0,1,17,4
1448,Rony Lopes,55,32,15,27,13,21,78,26.9,57,23,2,21,16,22,0
1449,Adrián López,24,14,11,8,5,7,25,28.0,18,22,4,18,10,49,0
1450,Alberto López,1,1,0,1,0,1,1,100.0,0,1,0,1,2,2,0
1451,Andoni López,1,0,1,0,0,1,1,100.0,0,1,0,1,1,6,0
1452,David López,67,49,47,19,1,27,54,50.0,27,43,26,17,67,161,0
1453,Diego López,0,0,0,0,0,0,1,0.0,1,0,0,0,0,1,0
1454,Iván López,1,1,1,0,0,0,0,,0,2,2,0,8,2,0
1455,Javi López,47,35,31,12,4,18,35,51.4,17,7,2,5,18,48,0
1456,Lisandro López,2,2,1,1,0,0,2,0.0,2,0,0,0,1,3,0
1457,Maxi López,12,8,2,7,3,0,4,0.0,4,8,2,6,2,18,0
1458,Maxime Lopez,30,20,12,12,6,12,56,21.4,44,16,2,14,7,6,1
1459,Pedro López Muñoz,33,23,21,10,2,17,30,56.7,13,22,7,15,26,45,0
1460,Pau López,0,0,0,0,0,0,0,,0,0,0,0,1,15,2
1461,Pedro López,0,0,0,0,0,0,0,,0,1,0,1,0,3,0
1462,Víctor López,2,1,0,2,0,0,1,0.0,1,0,0,0,1,1,0
1463,Jonas Lössl,1,0,1,0,0,1,5,20.0,4,0,0,0,4,13,6
1464,Dejan Lovren,26,17,14,11,1,12,22,54.5,10,26,15,11,38,146,2
1465,Chris Löwe,43,29,26,15,2,20,44,45.5,24,21,8,13,34,65,3
1466,Matthew Lowton,55,34,26,27,2,28,60,46.7,32,35,15,20,39,141,2
1467,Anthony Lozano,9,5,2,7,0,1,5,20.0,4,3,0,3,3,2,0
1468,Fabio Lucioni,11,9,7,4,0,7,11,63.6,4,14,11,3,7,61,0
1469,Filipe Luís,83,52,41,33,9,36,49,73.5,13,27,7,20,35,34,0
1470,José Luis Gayà,77,60,52,22,3,43,68,63.2,25,43,12,31,56,90,1
1471,José Luis Morales,37,23,15,15,7,13,65,20.0,52,28,0,28,26,20,0
1472,José Luis Palomino,60,39,36,19,5,24,51,47.1,27,36,21,15,39,111,1
1473,Luisinho,111,77,64,40,7,65,96,67.7,31,24,4,20,55,113,0
1474,David Luiz,18,11,13,4,1,11,21,52.4,10,9,5,4,24,45,2
1475,Douglas Luiz,10,9,4,6,0,3,11,27.3,8,1,0,1,4,0,0
1476,Everton Luiz,22,16,10,10,2,6,29,20.7,23,8,1,7,10,8,1
1477,Jordan Lukaku,28,15,14,11,3,10,16,62.5,6,14,2,12,15,23,0
1478,Romelu Lukaku,7,4,1,3,3,0,13,0.0,13,9,2,7,3,22,2
1479,Lars Lukas Mai,4,4,4,0,0,3,4,75.0,1,3,2,1,3,3,0
1480,Dodi Lukebakio,1,0,1,0,0,0,0,,0,0,0,0,0,0,0
1481,Saša Lukić,21,16,9,8,4,5,16,31.3,11,14,6,8,17,13,0
1482,Senad Lulić,66,40,32,22,12,21,80,26.3,59,32,4,28,36,39,0
1483,Levi Lumeka,1,1,1,0,0,0,0,,0,0,0,0,1,0,0
1484,Antonio Luna,39,26,23,13,3,24,41,58.5,17,26,9,17,36,68,0
1485,Arnaud Lusamba,12,9,4,6,2,3,7,42.9,4,5,0,5,1,1,0
1486,Fabian Lustenberger,47,34,26,20,1,21,31,67.7,10,31,12,19,24,74,1
1487,Andreas Luthe,0,0,0,0,0,0,0,,0,0,0,0,0,2,0
1488,Lyanco,11,8,8,3,0,5,8,62.5,3,4,3,1,5,17,0
1489,Charalambos Lykogiannis,16,12,9,5,2,11,18,61.1,7,12,3,9,15,28,0
1490,Cheikh M'Bengue,8,4,8,0,0,4,4,100.0,0,6,4,2,8,22,1
1491,Raïs M'Bolhi,0,0,0,0,0,0,1,0.0,1,0,0,0,0,0,0
1492,Yann M'Vila,26,16,11,12,3,7,24,29.2,17,13,1,12,31,56,0
1493,Zinédine Machach,7,3,5,1,1,4,5,80.0,1,1,0,1,2,2,0
1494,Pablo Maffeo,74,55,39,23,12,25,49,51.0,24,28,7,21,50,82,0
1495,Gabriel Magalhães,1,1,1,0,0,0,1,0.0,1,2,1,1,0,4,1
1496,Christian Maggio,17,10,9,6,2,7,19,36.8,12,15,4,11,13,21,0
1497,Francesco Magnanelli,56,38,30,20,6,20,65,30.8,45,26,7,19,58,78,2
1498,Harry Maguire,63,46,47,15,1,26,43,60.5,17,35,28,7,48,181,1
1499,Hicham Mahou,1,1,1,0,0,1,3,33.3,2,0,0,0,3,0,0
1500,Riyad Mahrez,39,27,16,17,6,10,63,15.9,53,32,1,31,18,15,0
1501,Thiago Maia,55,40,26,26,3,15,61,24.6,46,32,10,22,61,47,1
1502,Arne Maier,29,23,12,16,1,18,24,75.0,6,19,3,16,24,20,0
1503,Sebastian Maier,11,6,4,7,0,2,12,16.7,10,6,1,5,4,1,1
1504,Domenico Maietta,5,4,4,1,0,3,9,33.3,6,8,6,2,7,13,1
1505,Habib Maïga,29,18,16,10,3,12,30,40.0,18,8,4,4,19,10,0
1506,Mike Maignan,1,1,1,0,0,1,1,100.0,0,0,0,0,0,8,6
1507,Linton Maina,1,1,0,0,1,0,0,,0,0,0,0,1,0,0
1508,Ainsley Maitland-Niles,25,17,12,7,6,14,31,45.2,17,15,1,14,12,35,2
1509,Jean-Victor Makengo,4,2,2,2,0,1,2,50.0,1,1,0,1,3,1,1
1510,Nemanja Maksimović,21,13,10,8,3,8,16,50.0,8,15,6,9,16,8,0
1511,Nikola Maksimović,1,1,0,1,0,1,1,100.0,0,1,0,1,0,5,0
1512,Malcom,15,10,3,7,5,1,28,3.6,27,13,1,12,14,6,0
1513,Kévin Malcuit,51,37,31,16,4,17,25,68.0,8,13,5,8,38,47,0
1514,Yunus Mallı,25,17,8,14,3,12,25,48.0,13,23,0,23,12,17,0
1515,Hugo Mallo,84,55,55,26,3,35,53,66.0,18,30,15,15,68,111,1
1516,Scott Malone,39,29,27,10,2,17,24,70.8,7,12,2,10,26,43,2
1517,Vincent Manceau,84,49,56,22,6,42,76,55.3,34,34,2,32,34,103,0
1518,Gianluca Mancini,20,14,11,8,1,10,17,58.8,7,8,2,6,15,22,0
1519,Steve Mandanda,0,0,0,0,0,0,0,,0,0,0,0,0,10,3
1520,Aïssa Mandi,54,35,27,25,2,19,34,55.9,15,39,24,15,71,133,3
1521,Georges Mandjeck,25,14,8,16,1,8,18,44.4,10,9,3,6,18,21,1
1522,Rolando Mandragora,91,60,48,34,9,26,69,37.7,43,41,13,28,86,75,0
1523,Mario Mandžukić,36,23,13,11,12,8,29,27.6,21,20,3,17,25,42,2
1524,Sadio Mané,28,20,8,11,9,3,23,13.0,20,20,0,20,9,8,0
1525,Eliaquim Mangala,2,1,1,1,0,0,0,,0,0,0,0,1,4,1
1526,Eliaquim Mangala,5,3,5,0,0,1,3,33.3,2,4,3,1,2,24,0
1527,Orel Mangala,28,18,7,19,2,11,21,52.4,10,8,2,6,18,15,0
1528,Kader Mangane,37,24,29,8,0,11,21,52.4,10,28,18,10,24,120,4
1529,Thomas Mangani,92,59,35,46,11,28,120,23.3,92,40,5,35,40,45,1
1530,Kostas Manolas,23,20,14,7,2,9,15,60.0,6,31,24,7,46,133,2
1531,Javier Manquillo,36,22,25,8,3,15,30,50.0,15,25,6,19,18,65,0
1532,Martín Mantovani,12,5,10,2,0,7,10,70.0,3,10,6,4,22,67,0
1533,José Manuel Jurado,18,14,8,8,2,5,14,35.7,9,13,1,12,16,5,0
1534,Harrison Manzala,32,23,16,9,7,8,25,32.0,17,22,3,19,18,15,0
1535,Myziane Maolida,5,5,3,2,0,0,2,0.0,2,1,0,1,0,0,0
1536,Faitout Maouassa,6,3,2,3,1,2,10,20.0,8,12,2,10,6,5,0
1537,Fernando Marçal,34,20,22,8,4,14,29,48.3,15,14,6,8,26,69,0
1538,Vincent Marcel,1,1,0,1,0,0,1,0.0,1,1,0,1,0,0,0
1539,Marcelo,53,37,19,23,11,22,58,37.9,36,26,2,24,30,23,2
1540,Marcelo,27,25,16,10,1,9,25,36.0,16,32,18,14,57,235,4
1541,Solly March,54,41,34,14,6,22,54,40.7,32,27,3,24,13,49,0
1542,Gabriele Marchegiani,0,0,0,0,0,0,0,,0,0,0,0,0,0,0
1543,Claudio Marchisio,17,10,9,5,3,6,21,28.6,15,7,2,5,4,7,0
1544,Gian Marco Ferrari,12,8,8,4,0,5,10,50.0,5,42,38,4,31,149,4
1545,Óscar de Marcos,28,21,11,15,2,13,29,44.8,16,15,2,13,19,36,0
1546,José María Giménez,38,27,29,6,3,23,35,65.7,12,28,15,13,30,101,1
1547,Mariano,16,11,0,5,11,2,23,8.7,21,9,1,8,3,20,0
1548,Adrian Mariappa,45,26,33,12,0,14,34,41.2,20,25,16,9,45,133,4
1549,Jordan Marié,63,38,22,36,5,18,66,27.3,48,26,9,17,40,25,2
1550,Adrián Marín,6,4,3,3,0,2,8,25.0,6,2,0,2,3,8,0
1551,João Mário,14,11,6,5,3,6,19,31.6,13,7,0,7,8,4,1
1552,João Mário,8,4,3,3,2,2,8,25.0,6,6,1,5,4,5,0
1553,Guillermo Maripán,28,16,24,4,0,17,32,53.1,15,19,10,9,36,108,0
1554,Marlon,36,26,22,13,1,15,22,68.2,7,19,15,4,15,72,2
1555,Dominic Maroh,22,15,18,4,0,15,18,83.3,3,17,9,8,21,68,1
1556,Marquinhos,28,14,14,14,0,13,21,61.9,8,36,22,14,14,114,2
1557,Bruno Martella,30,21,19,7,4,12,30,40.0,18,22,9,13,48,151,1
1558,Roger Martí,8,4,2,5,1,2,13,15.4,11,11,0,11,1,5,0
1559,Anthony Martial,15,13,9,2,4,3,12,25.0,9,5,1,4,3,7,0
1560,Aarón Martín,56,36,41,12,3,31,59,52.5,28,26,5,21,49,78,0
1561,Jonas Martin,73,50,41,28,4,17,54,31.5,37,30,3,27,33,36,0
1562,Cuco Martina,61,35,38,15,8,27,46,58.7,19,17,4,13,42,130,2
1563,Carlos Martínez,0,0,0,0,0,0,0,,0,0,0,0,0,0,0
1564,Emiliano Martínez,0,0,0,0,0,0,0,,0,0,0,0,0,3,0
1565,Iñigo Martínez,28,20,20,8,0,18,29,62.1,11,17,8,9,30,82,0
1566,Iñigo Martínez,14,9,9,4,1,5,11,45.5,6,9,4,5,23,55,0
1567,Javi Martínez,31,22,11,15,5,9,19,47.4,10,16,5,11,33,40,1
1568,Pablo Martinez,41,34,28,12,1,22,49,44.9,27,25,12,13,51,112,3
1569,Roger Martínez,1,1,0,1,0,0,2,0.0,2,2,0,2,0,1,0
1570,Christopher Martins,3,2,0,3,0,1,2,50.0,1,0,0,0,1,0,0
1571,Bruno Martins Indi,21,12,18,3,0,10,19,52.6,9,16,11,5,21,77,1
1572,Jonathan Martins Pereira,34,18,21,10,3,8,23,34.8,15,9,3,6,37,39,1
1573,Adam Marušić,28,21,17,8,3,12,28,42.9,16,22,2,20,31,33,0
1574,Omar Mascarell,20,16,8,12,0,10,18,55.6,8,14,1,13,21,10,0
1575,Javier Mascherano,15,13,9,6,0,8,9,88.9,1,14,8,6,8,20,0
1576,Andrea Masiello,58,38,34,20,4,30,54,55.6,24,24,6,18,72,137,0
1577,Adam Masina,82,57,49,26,7,36,84,42.9,48,46,7,39,51,127,0
1578,Eden Massouema,2,1,2,0,0,2,2,100.0,0,3,0,3,5,2,0
1579,Arthur Masuaku,58,37,36,16,6,25,58,43.1,33,25,2,23,26,38,1
1580,Juan Mata,18,13,4,12,2,2,24,8.3,22,10,0,10,15,10,1
1581,Christian Mathenia,0,0,0,0,0,0,3,0.0,3,0,0,0,0,11,3
1582,Nemanja Matić,70,42,32,34,4,23,71,32.4,48,50,13,37,64,62,2
1583,Joël Matip,35,24,23,11,1,12,24,50.0,12,26,15,11,35,101,1
1584,Ryder Matos,3,1,1,1,1,1,1,100.0,0,2,0,2,2,3,0
1585,Ryder Matos,18,15,11,5,2,4,9,44.4,5,5,0,5,3,9,1
1586,Alessandro Matri,2,1,1,1,0,0,3,0.0,3,1,0,1,0,5,0
1587,Ville Matti Steinmann,16,10,6,8,2,8,17,47.1,9,6,1,5,18,9,1
1588,Federico Mattiello,59,40,31,22,6,21,44,47.7,23,53,15,38,64,66,0
1589,Blaise Matuidi,49,35,14,25,10,10,35,28.6,25,28,4,24,32,22,1
1590,Blaise Matuidi,1,1,1,0,0,0,0,,0,2,1,1,0,0,0
1591,José Mauri,0,0,0,0,0,0,0,,0,0,0,0,0,0,0
1592,Maurício,0,0,0,0,0,0,0,,0,0,0,0,0,0,0
1593,Mërgim Mavraj,45,32,32,11,2,22,37,59.5,15,28,12,16,21,91,3
1594,Konstantinos Mavropanos,1,1,1,0,0,1,2,50.0,1,4,3,1,6,11,1
1595,Alfie Mawson,32,22,24,8,0,16,27,59.3,11,41,32,9,35,229,5
1596,Philipp Max,65,47,36,19,10,34,59,57.6,25,27,8,19,33,65,1
1597,Alexandru Maxim,17,12,6,8,3,7,22,31.8,15,20,2,18,6,3,0
1598,Eric Maxim Choupo-Moting,42,30,21,16,5,9,32,28.1,23,31,3,28,23,29,1
1599,Florian Mayer,1,1,1,0,0,1,1,100.0,0,0,0,0,0,1,0
1600,Borja Mayoral,6,3,0,4,2,1,5,20.0,4,3,0,3,0,0,0
1601,Róbert Mazáň,0,0,0,0,0,0,1,0.0,1,1,0,1,2,0,0
1602,Luca Mazzitelli,37,24,14,15,8,10,36,27.8,26,21,2,19,21,19,0
1603,Kylian Mbappé,1,1,0,1,0,0,0,,0,0,0,0,1,0,0
1604,Kylian Mbappé,11,8,3,3,5,1,13,7.7,12,4,1,3,0,1,0
1605,Ibrahima Mbaye,59,34,40,17,2,25,36,69.4,11,25,6,19,28,95,0
1606,Chancel Mbemba,16,12,13,3,0,10,17,58.8,7,7,3,4,15,44,1
1607,Adama Mbengue,71,48,48,18,5,41,65,63.1,24,21,1,20,28,50,0
1608,Isaac Mbenza,16,11,4,8,4,6,16,37.5,10,8,1,7,4,5,0
1609,Bryan Mbeumo,0,0,0,0,0,0,3,0.0,3,2,0,2,0,2,0
1610,Jordi Mboula,0,0,0,0,0,0,0,,0,2,0,2,0,2,0
1611,James McArthur,58,44,28,27,3,23,61,37.7,38,39,2,37,36,44,2
1612,Gareth McAuley,8,7,6,2,0,3,7,42.9,4,7,4,3,11,16,0
1613,Oliver McBurnie,4,3,0,2,2,1,3,33.3,2,2,0,2,0,3,0
1614,Alex McCarthy,0,0,0,0,0,0,0,,0,0,0,0,1,8,0
1615,James McCarthy,9,9,3,4,2,1,5,20.0,4,9,2,7,5,3,1
1616,James McClean,40,28,23,14,3,10,55,18.2,45,18,4,14,20,22,0
1617,Weston McKennie,36,23,11,21,4,13,32,40.6,19,16,2,14,20,32,0
1618,Sam McQueen,4,4,4,0,0,2,4,50.0,2,2,1,1,3,3,0
1619,Scott McTominay,11,9,4,5,2,5,13,38.5,8,3,0,3,13,9,0
1620,Iuri Medeiros,6,4,3,2,1,4,8,50.0,4,3,1,2,2,3,0
1621,Slobodan Medojević,0,0,0,0,0,0,0,,0,0,0,0,0,1,0
1622,Álvaro Medrán,20,14,5,10,5,8,21,38.1,13,7,0,7,13,10,0
1623,Álvaro Medrán,1,1,1,0,0,1,2,50.0,1,0,0,0,3,1,0
1624,Ben Mee,33,20,22,11,0,16,29,55.2,13,51,42,9,33,217,1
1625,Riccardo Meggiorini,9,6,3,6,0,1,6,16.7,5,12,3,9,2,9,0
1626,Admir Mehmedi,4,2,3,1,0,2,2,100.0,0,1,1,0,1,3,0
1627,Admir Mehmedi,20,18,6,11,3,4,13,30.8,9,13,0,13,13,5,0
1628,Alexander Meier,0,0,0,0,0,0,0,,0,0,0,0,0,0,0
1629,Soualiho Meïté,25,13,4,19,2,9,32,28.1,23,22,6,16,23,13,1
1630,Soualiho Meïté,2,1,1,1,0,2,5,40.0,3,1,0,1,3,3,0
1631,Óscar Melendo,2,2,2,0,0,0,5,0.0,5,2,0,2,3,3,0
1632,Memphis,13,9,4,3,6,3,28,10.7,25,15,0,15,9,5,0
1633,Ledian Memushaj,28,18,11,13,4,7,30,23.3,23,24,5,19,10,10,1
1634,Pedro Mendes,62,50,37,19,6,23,41,56.1,18,36,25,11,44,152,0
1635,Thiago Mendes,25,16,10,11,4,5,23,21.7,18,21,3,18,25,29,0
1636,Brais Méndez,19,15,9,6,4,7,17,41.2,10,13,0,13,4,12,0
1637,Stiven Mendoza,18,10,7,7,4,2,11,18.2,9,11,1,10,15,8,0
1638,Alexandre Mendy,4,4,1,2,1,1,6,16.7,5,5,1,4,1,4,0
1639,Benjamin Mendy,5,4,2,0,3,5,7,71.4,2,5,0,5,8,9,0
1640,Ferland Mendy,45,28,29,13,3,20,31,64.5,11,18,5,13,25,43,0
1641,Nampalys Mendy,13,6,8,5,0,5,17,29.4,12,9,1,8,13,10,1
1642,Hamza Mendyl,18,10,12,6,0,11,20,55.0,9,5,0,5,17,26,0
1643,Gabriel Mercado,55,37,35,18,2,36,67,53.7,31,32,20,12,42,83,1
1644,Jorge Meré,34,23,25,9,0,23,35,65.7,12,25,13,12,34,110,1
1645,Alex Meret,0,0,0,0,0,0,1,0.0,1,0,0,0,0,5,0
1646,Mikel Merino,56,40,21,32,3,17,56,30.4,39,36,8,28,34,25,0
1647,Sabin Merino,7,3,2,3,2,3,8,37.5,5,6,2,4,1,10,0
1648,Dries Mertens,28,22,5,13,10,5,36,13.9,31,18,2,16,5,8,1
1649,Per Mertesacker,2,2,0,2,0,0,1,0.0,1,4,3,1,6,22,2
1650,Roque Mesa,20,13,8,8,4,10,37,27.0,27,6,0,6,13,8,1
1651,Roque Mesa,13,10,2,7,4,6,8,75.0,2,3,2,1,0,5,0
1652,Lionel Messi,17,8,0,11,6,2,18,11.1,16,11,1,10,7,0,0
1653,Thomas Meunier,38,21,22,12,4,18,34,52.9,16,7,2,5,18,54,2
1654,Mexer,15,12,9,6,0,9,12,75.0,3,13,7,6,16,98,2
1655,Max Meyer,48,38,23,21,4,19,47,40.4,28,25,3,22,54,11,0
1656,Senna Miangue,7,5,4,2,1,3,7,42.9,4,8,1,7,7,35,0
1657,Michel,33,24,21,8,4,14,25,56.0,11,21,11,10,39,64,1
1658,Mathieu Michel,0,0,0,0,0,0,1,0.0,1,0,0,0,0,0,1
1659,Clément Michelin,11,7,7,4,0,7,11,63.6,4,3,1,2,4,12,0
1660,Francesco Migliore,5,5,4,1,0,2,6,33.3,4,1,0,1,3,9,1
1661,Simon Mignolet,2,1,2,0,0,1,3,33.3,2,0,0,0,0,5,3
1662,Nikola Milenković,39,25,20,16,3,16,29,55.2,13,18,8,10,23,70,0
1663,Danijel Milićević,8,4,0,4,4,1,9,11.1,8,5,0,5,3,2,0
1664,Arkadiusz Milik,2,1,0,1,1,0,1,0.0,1,5,0,5,1,4,0
1665,Sergej Milinković-Savić,55,39,11,34,10,13,52,25.0,39,29,6,23,33,36,1
1666,Vanja Milinković-Savić,0,0,0,0,0,0,0,,0,0,0,0,0,0,0
1667,Luka Milivojević,85,52,40,37,8,31,86,36.0,55,50,12,38,71,81,3
1668,James Milner,58,45,18,32,8,15,39,38.5,24,33,5,28,21,23,0
1669,Santi Mina,17,9,4,9,4,4,22,18.2,18,14,1,13,2,19,0
1670,Yerry Mina,10,8,6,4,0,4,6,66.7,2,6,3,3,6,16,0
1671,Tyrone Mings,1,1,1,0,0,0,0,,0,2,2,0,6,13,1
1672,Ignasi Miquel,19,10,11,7,1,4,15,26.7,11,23,13,10,33,113,0
1673,Kevin Mirallas,4,3,1,2,1,0,1,0.0,1,0,0,0,0,3,0
1674,Miranda,48,37,38,10,0,22,25,88.0,3,30,23,7,38,131,2
1675,Antonio Mirante,0,0,0,0,0,0,3,0.0,3,1,0,1,0,11,5
1676,Simone Missiroli,62,37,25,31,6,14,72,19.4,58,46,8,38,67,70,0
1677,Kostas Mitroglou,3,2,1,2,0,1,4,25.0,3,1,1,0,0,2,0
1678,Aleksandar Mitrović,1,1,0,1,0,0,1,0.0,1,1,0,1,0,2,0
1679,Maximilian Mittelstädt,19,11,14,4,1,10,19,52.6,9,8,1,7,9,11,0
1680,Henrikh Mkhitaryan,18,13,9,7,2,5,21,23.8,16,16,2,14,8,7,0
1681,Henrikh Mkhitaryan,15,11,4,7,4,5,25,20.0,20,8,0,8,7,3,0
1682,Luka Modrić,33,22,14,15,4,15,41,36.6,26,13,4,9,31,7,0
1683,Niklas Moisander,36,28,22,13,1,24,36,66.7,12,21,9,12,38,98,2
1684,Johan Mojica,42,27,31,8,3,21,37,56.8,16,24,3,21,32,42,2
1685,Jorge Molina,18,10,3,6,9,4,27,14.8,23,25,4,21,7,27,0
1686,Daniel Molina Orta,0,0,0,0,0,0,0,,0,0,0,0,0,0,0
1687,Cristian Molinaro,37,29,19,14,4,11,18,61.1,7,15,4,11,22,70,1
1688,Francisco Molinero,13,10,10,3,0,7,16,43.8,9,6,0,6,14,27,0
1689,Florent Mollet,25,18,10,12,3,3,25,12.0,22,8,1,7,11,8,0
1690,Momo,14,8,8,3,3,4,13,30.8,9,5,0,5,5,1,0
1691,Thomas Monconduit,81,49,33,43,5,34,87,39.1,53,52,17,35,55,81,2
1692,Kévin Monnet-Paquet,33,25,9,19,5,11,48,22.9,37,15,2,13,13,23,1
1693,Nacho Monreal,54,32,19,29,6,21,48,43.8,27,26,7,19,56,83,2
1694,Jefferson Montero,1,1,1,0,0,1,1,100.0,0,0,0,0,0,2,0
1695,Riccardo Montolivo,29,21,11,15,3,7,24,29.2,17,17,4,13,19,15,0
1696,Martín Montoya,66,48,36,22,8,30,55,54.5,25,35,10,25,53,89,0
1697,Walter Montoya,1,1,1,0,0,1,3,33.3,2,1,0,1,0,3,0
1698,Shaquell Moore,8,6,3,3,2,3,7,42.9,4,4,0,4,13,11,0
1699,Aaron Mooy,102,60,39,51,12,23,55,41.8,32,39,5,34,38,52,0
1700,Emre Mor,14,7,6,7,1,6,11,54.5,5,7,1,6,4,7,0
1701,Luca Mora,19,17,6,8,5,5,17,29.4,12,9,3,6,4,20,0
1702,Sergio Mora,21,15,8,12,1,14,31,45.2,17,10,2,8,15,11,0
1703,Erik Morán,2,2,1,0,1,0,3,0.0,3,1,1,0,4,0,0
1704,Álvaro Morata,13,8,0,7,6,1,21,4.8,20,17,4,13,6,20,0
1705,Jan Morávek,41,37,17,23,1,21,36,58.3,15,19,3,16,11,11,0
1706,Jérémy Morel,39,27,23,15,1,18,23,78.3,5,28,23,5,46,129,5
1707,Alberto Moreno,35,26,21,12,2,13,29,44.8,16,19,2,17,12,44,0
1708,Gerard Moreno,41,28,7,22,12,12,53,22.6,41,27,6,21,19,46,0
1709,Héctor Moreno,2,2,1,1,0,0,1,0.0,1,1,1,0,3,5,0
1710,Héctor Moreno,7,3,7,0,0,5,7,71.4,2,3,3,0,10,17,0
1711,Marlos Moreno,1,1,0,0,1,0,1,0.0,1,1,0,1,0,0,0
1712,Emiliano Moretti,31,18,25,6,0,14,16,87.5,2,30,23,7,21,77,2
1713,Wes Morgan,35,25,26,8,1,12,18,66.7,6,41,27,14,31,146,1
1714,Loren Morón,14,8,4,5,5,4,17,23.5,13,14,1,13,1,12,0
1715,James Morrison,2,1,0,2,0,1,4,25.0,3,1,1,0,1,1,0
1716,Victor Moses,37,29,21,13,3,14,24,58.3,10,29,4,25,15,39,2
1717,Pedro Mosquera,48,31,15,29,4,13,38,34.2,25,26,6,20,23,38,0
1718,Lebo Mothiba,8,5,4,0,4,0,7,0.0,7,6,2,4,2,11,0
1719,Thiago Motta,28,21,14,11,3,8,24,33.3,16,15,6,9,21,26,1
1720,François Moubandje,28,15,20,7,1,10,34,29.4,24,23,7,16,27,75,0
1721,Jessy Moulin,0,0,0,0,0,0,0,,0,0,0,0,0,3,2
1722,Steve Mounié,11,8,2,4,5,0,19,0.0,19,23,3,20,7,30,0
1723,Lucas Moura,4,2,3,0,1,1,3,33.3,2,2,0,2,2,2,0
1724,Lucas Moura,1,1,0,1,0,0,1,0.0,1,0,0,0,0,0,0
1725,Lys Mousset,9,5,6,3,0,0,8,0.0,8,5,2,3,3,9,0
1726,João Moutinho,65,41,19,37,9,27,80,33.8,53,52,12,40,36,54,0
1727,Samuel Moutoussamy,15,7,6,7,2,5,8,62.5,3,7,1,6,3,4,0
1728,Toni Moya,0,0,0,0,0,0,0,,0,0,0,0,0,0,0
1729,Ndombe Mubele,8,4,6,2,0,4,10,40.0,6,11,0,11,9,4,0
1730,Ndombe Mubele,14,8,5,6,3,5,13,38.5,8,9,0,9,3,3,0
1731,Nordi Mukiele,70,55,41,25,4,25,44,56.8,19,26,14,12,73,104,2
1732,Álex Mula,7,3,3,4,0,2,12,16.7,10,5,0,5,6,1,0
1733,Florian Müller,0,0,0,0,0,0,0,,0,0,0,0,0,1,1
1734,Nicolai Müller,2,0,0,1,1,0,0,,0,1,0,1,0,0,0
1735,Thomas Müller,35,30,10,15,10,13,27,48.1,14,17,1,16,7,14,1
1736,Iker Muniain,10,8,2,6,2,1,7,14.3,6,4,0,4,4,3,0
1737,Marc Muniesa,33,18,17,15,1,11,23,47.8,12,12,5,7,33,40,0
1738,Ezequiel Muñoz,36,28,24,12,0,11,20,55.0,9,18,11,7,24,84,0
1739,Sulley Muntari,9,7,2,7,0,1,7,14.3,6,10,4,6,11,10,0
1740,Alessandro Murgia,19,12,9,9,1,5,19,26.3,14,14,3,11,17,13,0
1741,Luis Muriel,16,9,2,8,6,2,23,8.7,21,16,2,14,3,4,1
1742,Jeison Murillo,31,24,25,6,0,14,21,66.7,7,18,9,9,29,85,1
1743,Jacob Murphy,13,10,5,4,4,7,27,25.9,20,16,0,16,6,13,2
1744,Jamie Murphy,2,2,2,0,0,2,4,50.0,2,0,0,0,1,3,0
1745,Glenn Murray,18,12,4,11,3,2,18,11.1,16,16,4,12,5,27,0
1746,Nicola Murru,40,31,18,18,4,24,38,63.2,14,29,4,25,17,60,1
1747,Mateo Musacchio,22,15,13,7,2,8,16,50.0,8,9,3,6,12,58,1
1748,Charly Musonda Jr.,1,0,0,0,1,1,1,100.0,0,0,0,0,0,0,0
1749,Shkodran Mustafi,64,46,42,18,4,28,54,51.9,26,23,15,8,57,175,2
1750,Yoshinori Mutō,21,15,6,8,7,5,14,35.7,9,16,0,16,6,12,0
1751,Fahad Al Muwallad,0,0,0,0,0,0,1,0.0,1,0,0,0,1,0,0
1752,Yvon Mvogo,0,0,0,0,0,0,0,,0,0,0,0,0,1,1
1753,Boaz Myhill,0,0,0,0,0,0,0,,0,0,0,0,0,1,0
1754,Alfred N'Diaye,3,1,1,1,1,1,1,100.0,0,0,0,0,3,3,0
1755,Kévin N'Doram,16,10,6,9,1,6,24,25.0,18,6,2,4,16,29,0
1756,Abdallah N'dour,9,5,6,3,0,5,10,50.0,5,6,1,5,2,5,0
1757,Clinton N'Jie,10,6,2,5,3,2,9,22.2,7,5,0,5,3,0,0
1758,Georges-Kévin N'Koudou,0,0,0,0,0,0,0,,0,0,0,0,0,1,0
1759,Georges-Kévin N'Koudou,7,6,5,1,1,3,8,37.5,5,4,0,4,1,1,0
1760,Stanley N'Soki,0,0,0,0,0,0,1,0.0,1,0,0,0,0,1,0
1761,Nacho,55,40,29,19,7,20,38,52.6,18,21,9,12,46,51,0
1762,Yuto Nagatomo,10,6,4,5,1,5,14,35.7,9,8,3,5,10,28,0
1763,Ádám Nagy,16,9,6,8,2,7,13,53.8,6,11,0,11,7,5,0
1764,Matías Nahuel,4,4,1,1,2,2,5,40.0,3,2,0,2,2,1,0
1765,Radja Nainggolan,49,36,14,28,7,9,33,27.3,24,18,1,17,18,31,1
1766,Préjuce Nakoulma,10,8,3,6,1,2,7,28.6,5,2,0,2,5,0,0
1767,Naldo,14,8,12,1,1,5,10,50.0,5,13,10,3,16,57,1
1768,Naldo,51,36,38,12,1,31,46,67.4,15,39,21,18,55,200,1
1769,Andrea Nalini,43,32,22,16,5,16,25,64.0,9,25,2,23,15,19,1
1770,Nani,9,6,2,2,5,3,9,33.3,6,8,0,8,2,0,0
1771,Nano,7,6,2,4,1,1,1,100.0,0,4,0,4,0,0,0
1772,Naranjo,17,10,3,12,2,4,12,33.3,8,11,1,10,3,4,0
1773,Luciano Narsingh,7,5,1,5,1,2,7,28.6,5,7,0,7,3,3,0
1774,Nikolas Nartey,0,0,0,0,0,0,0,,0,0,0,0,0,0,0
1775,Juanjo Narváez,8,6,4,4,0,3,6,50.0,3,3,0,3,8,4,0
1776,Matija Nastasić,48,38,37,10,1,28,37,75.7,9,40,22,18,36,85,0
1777,Nathan,0,0,0,0,0,0,0,,0,0,0,0,0,0,0
1778,Kyle Naughton,92,60,49,35,8,54,100,54.0,46,60,13,47,60,144,4
1779,Fernando Navarro,32,22,24,7,1,16,25,64.0,9,13,3,10,29,49,0
1780,Marc Navarro,20,13,12,8,0,10,20,50.0,10,11,6,5,22,17,0
1781,Rafa Navarro,3,2,3,0,0,0,4,0.0,4,0,0,0,1,6,0
1782,Ximo Navarro,63,43,44,19,0,28,50,56.0,22,27,16,11,66,131,4
1783,Jesús Navas,32,25,17,9,6,12,26,46.2,14,14,5,9,19,37,0
1784,Keylor Navas,2,1,2,0,0,1,1,100.0,0,0,0,0,3,10,2
1785,Raúl Navas,22,15,18,4,0,14,26,53.8,12,23,13,10,30,73,0
1786,Badou Ndiaye,53,28,22,25,6,16,41,39.0,25,21,9,12,13,18,0
1787,Wilfred Ndidi,138,89,68,65,5,45,119,37.8,74,67,10,57,51,103,2
1788,Merveille Ndockyt,1,1,0,1,0,0,1,0.0,1,2,0,2,2,0,0
1789,Tanguy Ndombele,6,5,2,4,0,1,4,25.0,3,4,0,4,5,3,0
1790,Tanguy Ndombele,62,39,23,31,8,11,40,27.5,29,53,8,45,36,9,0
1791,Reiss Nelson,4,3,1,1,2,0,0,,0,4,0,4,3,0,0
1792,Neto,1,1,1,0,0,1,2,50.0,1,1,0,1,1,8,3
1793,Manuel Neuer,0,0,0,0,0,0,0,,0,0,0,0,0,1,0
1794,Neymar,20,14,3,11,6,7,40,17.5,33,4,0,4,5,2,0
1795,Yeni Ngbakoto,11,10,4,6,1,3,10,30.0,7,10,0,10,9,6,0
1796,Santy Ngom,10,5,5,5,0,1,8,12.5,7,9,1,8,2,2,0
1797,Guy Ngosso,8,5,4,4,0,4,20,20.0,16,5,3,2,9,19,0
1798,Julien Ngoy,1,1,0,1,0,1,2,50.0,1,0,0,0,0,0,0
1799,Opa Nguette,27,22,11,12,4,5,21,23.8,16,10,0,10,18,13,0
1800,Moussa Niakhate,57,38,44,12,1,22,37,59.5,15,27,14,13,55,139,1
1801,Adama Niane,22,12,5,10,7,6,26,23.1,20,11,2,9,9,13,0
1802,Ibrahima Niane,6,5,4,1,1,2,8,25.0,6,6,0,6,4,8,0
1803,M'Baye Niang,29,23,11,9,9,6,18,33.3,12,17,3,14,13,15,0
1804,Oumar Niasse,10,6,2,5,3,4,19,21.1,15,3,2,1,2,6,0
1805,Florian Niederlechner,8,6,1,5,2,2,5,40.0,3,5,1,4,3,6,0
1806,Saúl Ñíguez,132,90,53,69,10,40,104,38.5,64,61,12,49,55,77,0
1807,Casimir Ninga,12,7,1,6,5,2,10,20.0,8,12,2,10,4,13,0
1808,Benjamin Nivet,31,14,12,14,5,11,51,21.6,40,18,1,17,16,20,0
1809,Eddie Nketiah,1,1,0,1,0,0,0,,0,0,0,0,0,0,0
1810,Jordan Nkololo,9,6,4,5,0,1,4,25.0,3,7,1,6,1,0,0
1811,Nicolas Nkoulou,56,40,40,15,1,22,33,66.7,11,44,22,22,57,163,1
1812,Christopher Nkunku,5,2,2,2,1,3,14,21.4,11,8,2,6,5,2,1
1813,Lukas Nmecha,0,0,0,0,0,0,0,,0,0,0,0,0,0,0
1814,Mark Noble,61,36,32,22,7,16,76,21.1,60,28,10,18,47,32,1
1815,Vincent Nogueira,0,0,0,0,0,0,0,,0,0,0,0,0,2,0
1816,Nolito,49,36,21,21,7,14,33,42.4,19,17,2,15,10,17,0
1817,Håvard Nordtveit,19,16,10,9,0,13,18,72.2,5,19,8,11,10,50,0
1818,Paul-Georges Ntep,14,8,8,5,1,8,17,47.1,9,4,1,3,3,4,0
1819,Paul-Georges Ntep,2,2,0,0,2,0,1,0.0,1,3,1,2,1,0,0
1820,Alexander Nübel,0,0,0,0,0,0,0,,0,0,0,0,0,0,0
1821,Unai Núñez,73,52,54,19,0,38,56,67.9,18,52,27,25,67,155,2
1822,Bram Nuytinck,65,41,40,24,1,25,39,64.1,14,43,24,19,37,124,1
1823,Simeon Nwankwo,12,9,1,5,6,1,12,8.3,11,16,3,13,1,20,0
1824,Gerzino Nyamsi,4,2,4,0,0,0,3,0.0,3,2,2,0,3,18,2
1825,Allan Nyom,64,39,43,17,4,28,43,65.1,15,20,9,11,27,93,0
1826,Steven Nzonzi,39,26,14,19,6,20,30,66.7,10,27,8,19,28,36,2
1827,Aiden O'Neill,,,,,,,,,,,,,,,
1828,Michael Obafemi,0,0,0,0,0,0,0,,0,0,0,0,0,0,0
1829,Joel Obi,45,25,20,20,5,8,26,30.8,18,17,3,14,24,15,0
1830,Johann Obiang,13,9,9,2,2,6,13,46.2,7,9,1,8,7,15,0
1831,Pedro Obiang,53,34,20,29,4,17,51,33.3,34,37,16,21,24,27,1
1832,Jan Oblak,0,0,0,0,0,0,0,,0,0,0,0,2,7,0
1833,Lucas Ocampos,83,57,30,44,9,30,93,32.3,63,42,3,39,30,26,0
1834,Philipp Ochs,5,4,1,3,1,1,2,50.0,1,0,0,0,1,0,0
1835,Bastian Oczipka,60,48,29,26,5,29,37,78.4,8,41,2,39,40,40,1
1836,Álvaro Odriozola,41,27,22,15,4,20,35,57.1,15,25,7,18,26,50,0
1837,Ebenezer Ofori,0,0,0,0,0,0,1,0.0,1,1,0,1,0,0,0
1838,Angelo Ogbonna,30,24,18,10,2,8,18,44.4,10,40,27,13,58,197,1
1839,Marios Oikonomou,5,3,4,1,0,0,2,0.0,2,0,0,0,4,12,0
1840,Stefano Okaka,6,4,0,6,0,3,6,50.0,3,3,0,3,0,0,0
1841,Shinji Okazaki,25,16,3,18,4,4,28,14.3,24,15,1,14,8,6,0
1842,Orji Okwonkwo,9,3,6,3,0,1,4,25.0,3,2,0,2,1,1,0
1843,Kwasi Okyere Wriedt,2,2,1,1,0,0,0,,0,0,0,0,0,0,0
1844,Oier Olazábal,0,0,0,0,0,0,2,0.0,2,1,0,1,1,12,3
1845,Paulo Oliveira,41,22,28,13,0,16,22,72.7,6,23,9,14,62,140,0
1846,Mathías Olivera,3,1,1,0,2,3,5,60.0,2,3,0,3,1,2,0
1847,Maximiliano Olivera,12,9,5,4,3,3,8,37.5,5,4,1,3,11,11,0
1848,Paweł Olkowski,17,12,9,8,0,5,9,55.6,4,11,2,9,3,17,0
1849,Martin Olsson,34,26,18,10,6,12,29,41.4,17,21,4,17,31,81,0
1850,Michael Olunga,6,5,1,3,2,1,3,33.3,2,5,0,5,3,5,0
1851,Stephane Omeonga,25,15,16,8,1,7,18,38.9,11,20,1,19,5,6,0
1852,Prince Oniangué,16,11,5,9,2,8,31,25.8,23,20,4,16,11,8,0
1853,Karim Onisiwo,7,5,5,1,1,3,7,42.9,4,4,0,4,1,8,0
1854,Javier Ontiveros,10,7,8,2,0,2,4,50.0,2,4,2,2,4,4,0
1855,Daniel Opare,31,27,20,10,1,21,27,77.8,6,14,5,9,28,56,0
1856,Willi Orban,49,30,35,14,0,29,43,67.4,14,45,18,27,28,155,1
1857,Fabián Orellana,14,8,5,8,1,4,23,17.4,19,10,1,9,7,3,0
1858,Divock Origi,0,0,0,0,0,0,0,,0,0,0,0,0,0,0
1859,Divock Origi,6,5,2,3,1,1,7,14.3,6,16,2,14,3,17,0
1860,Riccardo Orsolini,5,5,4,1,0,1,5,20.0,4,2,1,1,3,4,0
1861,Riccardo Orsolini,3,2,3,0,0,1,1,100.0,0,1,0,1,0,0,0
1862,Yuya Osako,13,10,4,9,0,4,18,22.2,14,13,2,11,8,22,0
1863,Victor Osimhen,4,4,3,1,0,2,5,40.0,3,2,1,1,2,7,0
1864,David Ospina,0,0,0,0,0,0,0,,0,0,0,0,0,1,0
1865,Matthias Ostrzolek,68,53,43,20,5,38,57,66.7,19,39,10,29,30,58,1
1866,Nicolás Otamendi,58,43,35,22,1,19,44,43.2,25,21,10,11,48,129,3
1867,Otávio,64,42,25,37,2,20,61,32.8,41,26,4,22,32,35,0
1868,Anas Ouahim,1,1,0,1,0,1,1,100.0,0,0,0,0,0,0,0
1869,Alexandre Oukidja,0,0,0,0,0,0,1,0.0,1,0,0,0,3,9,1
1870,Adam Ounas,4,3,0,2,2,1,4,25.0,3,2,0,2,0,2,0
1871,Reece Oxford,2,1,1,1,0,1,1,100.0,0,0,0,0,0,0,0
1872,Reece Oxford,8,6,3,4,1,3,4,75.0,1,4,0,4,9,26,1
1873,Alex Oxlade-Chamberlain,5,3,2,2,1,2,3,66.7,1,5,2,3,6,8,0
1874,Alex Oxlade-Chamberlain,32,21,13,14,5,6,21,28.6,15,24,0,24,20,14,0
1875,Mikel Oyarzabal,33,23,10,13,10,7,39,17.9,32,32,2,30,18,19,0
1876,Ambroise Oyongo,2,1,1,1,0,0,1,0.0,1,2,1,1,6,6,0
1877,Berkay Özcan,19,10,7,9,3,7,11,63.6,4,14,2,12,3,8,0
1878,Ramazan Özcan,0,0,0,0,0,0,1,0.0,1,0,0,0,0,0,0
1879,Salih Özcan,56,42,24,29,3,28,54,51.9,26,27,5,22,29,22,1
1880,Mesut Özil,20,13,6,10,4,5,22,22.7,17,11,1,10,12,9,0
1881,Levin Öztunalı,26,19,8,15,3,10,20,50.0,10,25,0,25,11,9,0
1882,Pablo,16,15,13,3,0,10,16,62.5,6,13,7,6,16,96,1
1883,Daniel Pacheco,4,4,1,2,1,0,1,0.0,1,2,0,2,2,1,0
1884,Fernando Pacheco,0,0,0,0,0,0,0,,0,1,0,1,3,12,4
1885,Simone Padoin,22,18,8,10,4,12,28,42.9,16,38,14,24,24,74,0
1886,Vincent Pajot,24,16,9,13,2,3,17,17.6,14,21,9,12,24,34,0
1887,Rodrigo Palacio,25,18,6,12,7,10,28,35.7,18,16,2,14,12,14,0
1888,Raffaele Palladino,1,1,1,0,0,0,1,0.0,1,0,0,0,1,0,0
1889,Nicolas Pallois,39,28,25,9,5,18,36,50.0,18,34,19,15,35,182,3
1890,Kasey Palmer,6,3,2,3,1,2,8,25.0,6,5,0,5,0,2,0
1891,Emerson Palmieri,6,4,4,2,0,5,5,100.0,0,2,0,2,2,10,0
1892,Emerson Palmieri,0,0,0,0,0,0,0,,0,0,0,0,0,0,0
1893,Julian Palmieri,29,15,17,9,3,17,29,58.6,12,16,2,14,22,31,0
1894,Simone Palombi,0,0,0,0,0,0,0,,0,0,0,0,0,0,0
1895,Alberto Paloschi,10,7,0,9,1,0,10,0.0,10,2,1,1,4,11,0
1896,Goran Pandev,10,9,3,6,1,2,13,15.4,11,8,0,8,4,5,0
1897,Costel Pantilimon,0,0,0,0,0,0,1,0.0,1,0,0,0,0,0,1
1898,Kyriakos Papadopoulos,60,54,36,24,0,41,69,59.4,28,54,35,19,43,181,2
1899,Sokratis Papastathopoulos,65,47,50,13,2,39,47,83.0,8,36,11,25,30,112,0
1900,Rubén Pardo,1,0,0,1,0,1,2,50.0,1,5,0,5,5,1,0
1901,Nicolás Pareja,11,8,7,3,1,3,5,60.0,2,8,1,7,13,24,0
1902,Daniel Parejo,88,57,35,43,10,31,87,35.6,56,37,10,27,34,27,1
1903,Vittorio Parigini,18,11,11,6,1,6,17,35.3,11,8,1,7,5,1,0
1904,Shawn Parker,0,0,0,0,0,0,0,,0,0,0,0,0,0,0
1905,Marco Parolo,70,37,27,36,7,14,58,24.1,44,49,8,41,43,64,0
1906,Thomas Partey,94,64,48,39,7,33,69,47.8,36,32,7,25,53,34,1
1907,Felix Passlack,2,2,2,0,0,2,3,66.7,1,0,0,0,0,2,0
1908,Felix Passlack,0,0,0,0,0,0,0,,0,0,0,0,1,0,0
1909,Javier Pastore,33,21,9,16,8,5,23,21.7,18,13,0,13,10,14,1
1910,Patric,11,6,8,2,1,4,6,66.7,2,3,0,3,3,32,0
1911,Paulinho,39,28,17,15,7,11,38,28.9,27,25,3,22,15,16,1
1912,Gabriel Paulista,47,27,41,4,2,32,46,69.6,14,30,14,16,51,142,2
1913,Benjamin Pavard,55,40,40,13,2,36,47,76.6,11,59,34,25,70,192,1
1914,Jiří Pavlenka,1,1,1,0,0,0,0,,0,2,0,2,0,17,4
1915,Daniel Pavlović,10,5,9,0,1,5,10,50.0,5,4,3,1,5,22,0
1916,Daniel Pavlović,3,1,1,1,1,1,1,100.0,0,0,0,0,0,5,0
1917,Mateo Pavlović,13,7,10,3,0,7,20,35.0,13,14,11,3,21,120,0
1918,Leonardo Pavoletti,27,13,5,14,8,2,21,9.5,19,13,5,8,13,28,0
1919,Dimitri Payet,22,11,5,13,4,8,37,21.6,29,19,2,17,19,7,1
1920,Giampaolo Pazzini,0,0,0,0,0,0,4,0.0,4,2,0,2,1,13,0
1921,Giampaolo Pazzini,0,0,0,0,0,0,0,,0,1,0,1,1,1,0
1922,Alfonso Pedraza,57,40,24,21,12,19,56,33.9,37,39,5,34,32,26,0
1923,Pedro,20,11,6,8,6,5,18,27.8,13,13,1,12,13,7,1
1924,João Pedro,15,9,4,9,2,0,12,0.0,12,9,1,8,11,24,0
1925,Stef Peeters,22,11,6,14,2,6,31,19.4,25,17,3,14,7,11,0
1926,Gianluca Pegolo,0,0,0,0,0,0,0,,0,0,0,0,0,0,0
1927,Peter Pekarík,42,33,17,21,4,21,29,72.4,8,23,3,20,18,44,0
1928,Bryan Pelé,20,9,9,8,3,4,28,14.3,24,11,0,11,15,13,0
1929,Yohann Pelé,0,0,0,0,0,0,1,0.0,1,0,0,0,1,2,0
1930,Pietro Pellegri,1,0,0,0,1,0,5,0.0,5,3,0,3,2,1,0
1931,Pietro Pellegri,0,0,0,0,0,0,2,0.0,2,1,0,1,0,0,0
1932,Lorenzo Pellegrini,36,20,16,11,9,10,35,28.6,25,21,2,19,41,21,1
1933,Théo Pellenard,32,20,13,15,4,10,28,35.7,18,15,6,9,32,31,0
1934,Sergio Pellissier,6,2,1,3,2,1,3,33.3,2,3,0,3,1,2,0
1935,Federico Peluso,46,34,29,13,4,14,26,53.8,12,39,13,26,40,132,1
1936,Rubén Peña,41,28,20,17,4,20,42,47.6,22,24,6,18,30,31,0
1937,Gabriel Peñalba,6,5,4,2,0,5,11,45.5,6,7,4,3,8,15,0
1938,Adalberto Peñaranda,10,6,2,6,2,2,3,66.7,1,8,1,7,0,1,0
1939,Nicolas Pépé,30,18,14,11,5,11,42,26.2,31,23,0,23,10,20,0
1940,Andreas Pereira,26,15,12,11,3,10,30,33.3,20,9,1,8,11,5,0
1941,Pedro Pereira,5,4,2,1,2,3,5,60.0,2,5,2,3,5,15,0
1942,Bruno Peres,26,17,16,7,3,10,23,43.5,13,9,2,7,22,28,1
1943,Roberto Pereyra,10,8,4,5,1,2,13,15.4,11,16,0,16,9,6,0
1944,Ayoze Pérez,39,21,11,15,13,12,54,22.2,42,36,1,35,24,28,0
1945,Hernán Pérez,11,8,6,4,1,2,19,10.5,17,5,0,5,3,6,0
1946,Hernán Pérez,4,3,1,1,2,2,3,66.7,1,1,0,1,1,1,0
1947,Lucas Pérez,17,12,5,8,4,1,32,3.1,31,19,1,18,9,1,0
1948,Rubén Pérez,99,61,47,48,4,48,101,47.5,53,30,5,25,77,40,0
1949,Stipe Perica,8,5,2,5,1,2,13,15.4,11,7,1,6,3,9,0
1950,Mattia Perin,0,0,0,0,0,0,1,0.0,1,0,0,0,1,14,2
1951,Ivan Perišić,47,31,15,23,9,8,56,14.3,48,47,6,41,45,62,0
1952,Diego Perotti,25,17,6,14,5,8,20,40.0,12,19,0,19,11,13,0
1953,Romain Perraud,0,0,0,0,0,0,0,,0,0,0,0,0,0,0
1954,Loïc Perrin,39,26,28,10,1,21,31,67.7,10,35,22,13,36,142,1
1955,Andrea Petagna,8,3,2,4,2,1,11,9.1,10,14,3,11,4,5,0
1956,Nils Petersen,27,18,7,18,2,10,27,37.0,17,28,2,26,17,33,0
1957,Bruno Petković,14,12,3,8,3,6,13,46.2,7,11,1,10,7,12,0
1958,Bruno Petković,7,6,0,5,2,1,1,100.0,0,3,0,3,4,5,0
1959,Germán Pezzella,63,47,42,19,2,19,41,46.3,22,33,16,17,63,185,1
1960,Giuseppe Pezzella,19,11,10,4,5,7,19,36.8,12,8,1,7,6,32,0
1961,Maximilian Philipp,24,19,9,12,3,6,19,31.6,13,12,0,12,6,7,0
1962,Chris Philipps,22,12,10,10,2,5,26,19.2,21,13,5,8,30,18,0
1963,Matt Phillips,27,16,17,5,5,10,29,34.5,19,21,1,20,24,43,0
1964,Lebogang Phiri,28,17,14,12,2,11,43,25.6,32,9,2,7,19,13,0
1965,Pablo Piatti,45,32,14,21,10,17,57,29.8,40,28,3,25,22,16,0
1966,Jordan Pickford,0,0,0,0,0,0,2,0.0,2,0,0,0,2,26,5
1967,Jérémy Pied,9,6,8,1,0,6,9,66.7,3,3,2,1,8,4,0
1968,Nicholas Pierini,1,1,0,0,1,0,0,,0,1,0,1,1,0,0
1969,Ronaël Pierre-Gabriel,43,31,33,7,3,17,28,60.7,11,11,2,9,9,35,0
1970,Erik Pieters,71,47,43,26,2,24,51,47.1,27,70,25,45,61,127,5
1971,Tomás Pina Isla,71,49,27,38,6,20,40,50.0,20,28,10,18,43,37,0
1972,Andrea Pinamonti,0,0,0,0,0,0,0,,0,0,0,0,0,0,0
1973,Carlo Pinsoglio,0,0,0,0,0,0,0,,0,0,0,0,0,0,0
1974,Gerard Piqué,31,22,22,9,0,16,36,44.4,20,40,27,13,30,127,0
1975,Facundo Píriz,25,16,9,12,4,6,35,17.1,29,10,1,9,18,14,0
1976,Fabio Pisacane,52,39,36,13,3,15,41,36.6,26,29,16,13,38,105,1
1977,Łukasz Piszczek,51,37,23,23,5,30,52,57.7,22,39,11,28,42,64,1
1978,Claudio Pizarro,11,9,3,6,2,6,9,66.7,3,10,2,8,3,5,0
1979,Guido Pizarro,75,47,36,36,3,29,67,43.3,38,20,7,13,26,48,0
1980,Marko Pjaca,5,3,2,3,0,4,6,66.7,2,3,0,3,1,2,0
1981,Miralem Pjanić,36,30,13,18,5,13,51,25.5,38,25,5,20,64,27,2
1982,Carles Planas,5,2,4,1,0,3,6,50.0,3,1,0,1,5,6,0
1983,Jaroslav Plašil,24,14,7,17,0,7,31,22.6,24,18,6,12,21,15,0
1984,Marvin Plattenhardt,57,43,39,15,3,35,50,70.0,15,24,7,17,27,92,0
1985,Alassane Pléa,15,9,5,7,3,5,32,15.6,27,14,3,11,8,21,0
1986,Morgan Poaty,0,0,0,0,0,0,1,0.0,1,5,3,2,1,2,0
1987,Gerónimo Poblete,58,37,23,29,6,25,66,37.9,41,19,0,19,24,22,1
1988,Florentin Pogba,6,0,4,2,0,3,5,60.0,2,2,2,0,1,12,0
1989,Paul Pogba,33,23,13,15,5,5,33,15.2,28,16,0,16,21,26,0
1990,Joel Pohjanpalo,0,0,0,0,0,0,2,0.0,2,1,1,0,0,2,0
1991,Eugen Polanski,8,7,3,4,1,5,6,83.3,1,6,1,5,4,4,0
1992,Andrea Poli,66,53,33,27,6,18,64,28.1,46,55,3,52,43,27,0
1993,Matteo Politano,23,16,8,10,5,3,32,9.4,29,13,2,11,14,13,0
1994,Julian Pollersbeck,0,0,0,0,0,0,1,0.0,1,0,0,0,0,4,1
1995,Ezequiel Ponce,9,8,3,5,1,0,7,0.0,7,2,1,1,3,11,0
1996,Pere Pons,80,54,28,48,4,23,87,26.4,64,28,3,25,30,25,0
1997,Simone Pontisso,1,0,0,1,0,0,0,,0,0,0,0,0,0,0
1998,Nick Pope,0,0,0,0,0,0,1,0.0,1,0,0,0,0,21,0
1999,Jérémie Porsan-Clémenté,3,2,1,2,0,2,2,100.0,0,1,0,1,1,4,1
2000,Francisco Portillo,38,23,15,18,5,11,45,24.4,34,25,1,24,22,21,0
2001,Portu,30,24,9,11,10,8,33,24.2,25,14,0,14,12,1,0
2002,Stefan Posch,28,21,18,7,3,15,27,55.6,12,15,4,11,24,30,0
2003,Sergio Postigo,36,23,30,5,1,18,32,56.3,14,27,13,14,40,140,1
2004,Yussuf Poulsen,23,19,2,13,8,7,12,58.3,5,24,5,19,9,8,0
2005,Maxime Poundjé,53,29,32,16,5,28,51,54.9,23,14,6,8,35,63,1
2006,Darío Poveda,1,0,0,1,0,1,1,100.0,0,0,0,0,0,0,0
2007,Dennis Praet,85,57,34,36,15,38,73,52.1,35,49,1,48,37,22,0
2008,Sanjin Prcić,37,18,9,24,4,8,39,20.5,31,19,5,14,30,25,0
2009,Nicolas de Préville,34,27,10,15,9,9,33,27.3,24,25,4,21,21,12,0
2010,Nicolas de Préville,3,3,0,1,2,1,5,20.0,4,3,0,3,0,2,0
2011,Andrés Prieto,0,0,0,0,0,0,0,,0,0,0,0,0,2,0
2012,Xabi Prieto,18,14,5,9,4,2,10,20.0,8,8,2,6,7,20,0
2013,Jérôme Prior,0,0,0,0,0,0,0,,0,0,0,0,0,2,2
2014,Alex Pritchard,18,8,2,6,10,10,21,47.6,11,6,1,5,5,11,0
2015,Sloan Privat,0,0,0,0,0,0,0,,0,0,0,0,0,0,0
2016,Sebastian Prödl,22,17,19,3,0,8,15,53.3,7,20,9,11,31,92,1
2017,Davy Pröpper,73,44,35,35,3,18,83,21.7,65,35,11,24,60,80,2
2018,Manuel Pucciarelli,23,14,3,11,9,8,21,38.1,13,15,0,15,7,4,0
2019,Christian Puggioni,0,0,0,0,0,0,0,,0,0,0,0,0,5,1
2020,Christian Puggioni,0,0,0,0,0,0,0,,0,0,0,0,0,6,1
2021,Marc Pugh,7,3,2,4,1,2,10,20.0,8,6,1,5,13,13,2
2022,Erick Pulgar,70,48,41,29,0,24,75,32.0,51,49,13,36,46,83,1
2023,Christian Pulisic,46,30,12,20,14,26,44,59.1,18,24,2,22,16,11,0
2024,Jason Puncheon,13,4,3,7,3,1,5,20.0,4,3,0,3,5,4,0
2025,George Pușcaș,0,0,0,0,0,0,3,0.0,3,0,0,0,1,13,0
2026,Loïc Puyo,9,5,2,5,2,3,4,75.0,1,7,3,4,4,2,0
2027,Fabio Quagliarella,11,9,1,3,7,2,25,8.0,23,34,0,34,7,23,0
2028,Robin Quaison,17,14,1,10,6,7,11,63.6,4,16,2,14,7,9,0
2029,Collin Quaner,22,15,8,8,6,9,26,34.6,17,24,4,20,11,15,0
2030,Dani Raba,25,21,9,12,4,9,45,20.0,36,21,1,20,17,10,0
2031,Adrien Rabiot,59,36,27,23,9,15,36,41.7,21,29,10,19,33,22,1
2032,Nemanja Radoja,18,16,6,8,4,3,8,37.5,5,8,2,6,10,11,0
2033,Ivan Radovanović,55,35,30,22,3,18,48,37.5,30,39,16,23,47,107,1
2034,Ștefan Radu,53,38,36,16,1,25,41,61.0,16,30,14,16,55,105,1
2035,Rafael,0,0,0,0,0,0,0,,0,0,0,0,1,9,0
2036,Rafael,54,28,30,18,6,22,43,51.2,21,20,3,17,42,53,0
2037,Raffael,40,32,12,23,5,17,36,47.2,19,18,0,18,8,2,0
2038,Rafinha,14,9,1,10,3,3,16,18.8,13,15,0,15,7,9,0
2039,Rafinha,39,33,24,11,4,28,47,59.6,19,17,6,11,32,30,0
2040,Andrea Raggi,20,10,15,4,1,10,27,37.0,17,12,6,6,31,66,0
2041,Antonino Ragusa,17,7,11,4,2,8,23,34.8,15,12,1,11,6,16,0
2042,Baba Rahman,1,0,0,1,0,0,0,,0,2,0,2,2,1,0
2043,Ivan Rakitić,52,31,16,30,6,15,45,33.3,30,42,7,35,44,16,0
2044,André Ramalho,3,1,2,1,0,2,2,100.0,0,1,0,1,1,1,0
2045,Jonás Ramalho,25,16,20,5,0,15,24,62.5,9,25,11,14,35,115,0
2046,Adil Rami,39,29,22,15,2,22,41,53.7,19,25,19,6,45,163,3
2047,Benito Ramírez,6,3,2,3,1,1,5,20.0,4,0,0,0,2,3,0
2048,Gastón Ramírez,33,20,4,15,14,9,56,16.1,47,30,3,27,18,24,0
2049,Sandro Ramírez,2,1,0,1,1,0,3,0.0,3,1,0,1,1,0,0
2050,Sandro Ramírez,8,8,1,5,2,1,7,14.3,6,2,0,2,4,2,0
2051,Toño Ramírez,0,0,0,0,0,0,1,0.0,1,0,0,0,0,1,3
2052,Iván Ramis,20,14,8,12,0,8,19,42.1,11,12,5,7,25,51,2
2053,Omar Ramos,22,14,6,8,8,9,22,40.9,13,16,1,15,14,15,0
2054,Sergio Ramos,40,29,22,18,0,19,28,67.9,9,22,12,10,47,91,0
2055,Aaron Ramsey,35,27,18,17,0,8,44,18.2,36,14,3,11,24,6,1
2056,Àngel Rangel,4,3,2,2,0,1,3,33.3,2,0,0,0,3,4,0
2057,Andrea Ranocchia,8,4,6,2,0,3,6,50.0,3,6,5,1,12,35,0
2058,Marcus Rashford,14,11,4,5,5,6,18,33.3,12,18,0,18,8,19,0
2059,Milot Rashica,2,2,1,1,0,1,8,12.5,7,3,0,3,3,4,0
2060,Konstantin Rausch,21,16,13,7,1,11,26,42.3,15,9,2,7,17,25,0
2061,Yoric Ravet,9,7,3,6,0,3,7,42.9,4,7,0,7,3,6,0
2062,Ante Rebić,37,29,7,21,9,7,24,29.2,17,27,2,25,6,13,0
2063,Pedro Rebocho,29,22,18,8,3,12,28,42.9,16,20,6,14,19,76,0
2064,Recio,54,42,26,23,5,17,62,27.4,45,15,3,12,30,17,0
2065,Nathan Redmond,32,17,16,14,2,12,31,38.7,19,20,0,20,15,17,2
2066,Alberto Redondo,4,3,4,0,0,2,4,50.0,2,2,1,1,0,1,0
2067,Fabian Reese,2,2,1,1,0,1,2,50.0,1,1,0,1,2,1,0
2068,Vasco Regini,13,7,11,0,2,6,11,54.5,5,14,7,7,11,68,0
2069,Xesc Regis,1,1,0,1,0,0,0,,0,0,0,0,0,0,0
2070,Winston Reid,11,9,7,4,0,4,15,26.7,11,27,14,13,22,104,0
2071,Pepe Reina,1,0,1,0,0,1,2,50.0,1,0,0,0,0,13,2
2072,Jeff Reine-Adélaïde,13,8,7,5,1,6,17,35.3,11,7,2,5,1,9,0
2073,Karim Rekik,38,29,32,6,0,24,26,92.3,2,27,11,16,28,116,2
2074,Loïc Rémy,4,3,1,3,0,0,1,0.0,1,0,0,0,1,2,0
2075,Loïc Rémy,4,2,1,3,0,1,5,20.0,4,4,0,4,1,2,0
2076,Jan Repas,14,11,5,5,4,4,18,22.2,14,10,0,10,7,3,0
2077,Panagiotis Retsos,48,40,32,14,2,33,46,71.7,13,29,8,21,29,47,0
2078,Marco Reus,16,8,2,12,2,5,12,41.7,7,16,3,13,4,9,0
2079,Elvis Rexhbeçaj,4,2,1,2,1,1,1,100.0,0,3,0,3,2,3,0
2080,Baptiste Reynet,6,4,5,1,0,5,7,71.4,2,2,0,2,2,35,1
2081,Franck Ribéry,19,16,9,5,5,13,17,76.5,4,11,0,11,7,3,0
2082,Federico Ricca,43,24,32,9,2,23,33,69.7,10,10,2,8,24,46,0
2083,Federico Ricci,25,18,9,10,6,9,28,32.1,19,14,0,14,11,5,0
2084,Federico Ricci,2,2,2,0,0,1,3,33.3,2,2,0,2,1,1,0
2085,Declan Rice,36,24,25,10,1,15,25,60.0,10,19,13,6,27,77,1
2086,Richarlison,64,44,26,28,10,10,39,25.6,29,39,5,34,24,32,1
2087,Marco Richter,17,14,8,8,1,8,17,47.1,9,5,1,4,1,10,0
2088,Diego Rico,68,43,37,21,10,36,53,67.9,17,30,6,24,76,61,0
2089,Mikel Rico,24,13,7,16,1,12,34,35.3,22,15,5,10,23,12,1
2090,Sergio Rico,1,1,1,0,0,0,2,0.0,2,0,0,0,1,5,3
2091,Jaïro Riedewald,11,8,6,4,1,0,2,0.0,2,7,1,6,12,13,0
2092,Asier Riesgo,0,0,0,0,0,0,0,,0,0,0,0,0,0,0
2093,Luca Rigoni,32,22,11,20,1,7,35,20.0,28,24,2,22,19,13,0
2094,Nicola Rigoni,29,20,15,12,2,9,26,34.6,17,8,3,5,11,22,1
2095,Kévin Rimane,0,0,0,0,0,0,0,,0,0,0,0,0,0,0
2096,Tomás Rincón,66,40,30,34,2,24,66,36.4,42,33,8,25,57,61,1
2097,Birk Risa,1,1,0,1,0,0,3,0.0,3,2,1,1,0,0,0
2098,Marcel Risse,21,14,17,4,0,11,19,57.9,8,21,3,18,6,10,2
2099,Matt Ritchie,46,32,22,18,6,14,53,26.4,39,37,5,32,35,63,1
2100,Cristian Rivera,13,10,4,8,1,5,7,71.4,2,2,2,0,3,2,0
2101,Emmanuel Rivière,10,3,1,6,3,1,12,8.3,11,8,0,8,2,5,0
2102,Jonathan Rivierez,81,59,50,26,5,41,80,51.3,39,21,7,14,39,73,0
2103,Luca Rizzo,18,10,7,10,1,5,17,29.4,12,10,0,10,3,5,1
2104,Arjen Robben,14,11,1,7,6,4,12,33.3,8,9,0,9,4,4,0
2105,Rober,35,22,27,8,0,17,32,53.1,15,29,18,11,41,75,1
2106,Roberto,0,0,0,0,0,0,0,,0,0,0,0,2,15,0
2107,Sergi Roberto,63,40,30,25,8,25,49,51.0,24,18,8,10,39,30,1
2108,Connor Roberts,6,4,5,1,0,3,3,100.0,0,2,0,2,3,6,0
2109,Andrew Robertson,31,17,19,9,3,15,29,51.7,14,22,2,20,26,56,0
2110,Álex Robles,2,1,1,1,0,0,0,,0,1,0,1,3,4,0
2111,Hal Robson-Kanu,5,4,1,2,2,0,13,0.0,13,9,3,6,4,9,0
2112,Marc Roca,8,7,3,5,0,3,4,75.0,1,4,2,2,4,10,0
2113,Rubén Rochina,8,5,5,2,1,4,6,66.7,2,0,0,0,2,0,0
2114,Ronny Rodelin,33,22,7,18,8,8,42,19.0,34,21,2,19,28,41,1
2115,Rodri,104,71,50,48,6,30,86,34.9,56,49,21,28,52,100,1
2116,Rodrigo,23,13,9,12,2,3,21,14.3,18,14,2,12,17,11,1
2117,Kévin Rodrigues,44,32,18,20,6,19,34,55.9,15,22,6,16,27,39,0
2118,Ángel Rodríguez,28,19,3,19,6,3,26,11.5,23,18,3,15,6,14,0
2119,Iván Rodríguez,1,1,0,1,0,0,0,,0,0,0,0,1,1,0
2120,James Rodríguez,35,27,10,15,10,15,30,50.0,15,16,1,15,12,4,0
2121,Jay Rodriguez,31,21,12,11,8,9,50,18.0,41,32,2,30,19,41,0
2122,Ricardo Rodríguez,48,29,24,18,6,18,28,64.3,10,36,6,30,33,93,3
2123,Marko Rog,11,7,3,6,2,1,11,9.1,10,4,1,3,2,1,0
2124,Rogério,18,14,10,5,3,7,15,46.7,8,11,1,10,9,31,0
2125,Marcus Rohdén,33,19,21,10,2,14,50,28.0,36,14,1,13,18,30,0
2126,Marcos Rojo,7,5,6,0,1,1,8,12.5,7,11,6,5,7,56,2
2127,Diego Rolán,33,25,7,13,13,9,44,20.5,35,18,1,17,12,9,0
2128,Rolando,44,29,28,15,1,23,40,57.5,17,22,14,8,37,126,0
2129,Esteban Rolón,6,4,4,2,0,2,4,50.0,2,7,1,6,9,8,1
2130,Filippo Romagna,33,18,20,12,1,16,26,61.5,10,20,11,9,33,96,0
2131,Alessio Romagnoli,20,14,17,2,1,9,14,64.3,5,24,14,10,23,154,1
2132,Simone Romagnoli,12,9,10,2,0,4,9,44.4,5,12,8,4,7,41,2
2133,Aristóteles Romero,11,7,7,4,0,3,5,60.0,2,3,0,3,5,0,0
2134,Óscar Romero,5,2,4,1,0,0,3,0.0,3,3,0,3,3,2,0
2135,Sergio Romero,0,0,0,0,0,0,0,,0,0,0,0,0,0,0
2136,Oriol Romeu,93,64,41,44,8,32,100,32.0,68,59,19,40,69,77,2
2137,Rômulo,58,44,23,29,6,13,54,24.1,41,29,2,27,43,41,0
2138,Cristiano Ronaldo,7,4,3,3,1,1,6,16.7,5,10,3,7,6,14,0
2139,Facundo Roncaglia,35,25,30,5,0,22,36,61.1,14,18,6,12,31,50,1
2140,Salomón Rondón,14,6,0,7,7,5,26,19.2,21,27,0,27,14,20,0
2141,Valentin Rongier,73,49,25,39,9,17,64,26.6,47,42,6,36,40,13,1
2142,Marten de Roon,77,50,27,44,6,29,82,35.4,53,40,5,35,46,36,0
2143,Wayne Rooney,28,19,11,13,4,10,42,23.8,32,25,6,19,16,43,2
2144,Roberto Rosales,104,69,52,40,12,50,84,59.5,34,37,13,24,58,104,1
2145,Danny Rose,15,11,6,7,2,8,15,53.3,7,12,6,6,9,15,0
2146,Liam Rosenior,4,3,2,1,1,2,5,40.0,3,2,1,1,4,7,0
2147,Aleandro Rosi,24,17,7,13,4,5,19,26.3,14,24,5,19,20,61,1
2148,Valentin Rosier,73,54,47,23,3,26,68,38.2,42,43,9,34,58,124,0
2149,Luca Rossettini,16,8,12,3,1,6,17,35.3,11,31,21,10,29,151,1
2150,Francesco Rossi,0,0,0,0,0,0,0,,0,0,0,0,0,0,0
2151,Giuseppe Rossi,1,1,0,1,0,0,3,0.0,3,2,0,2,1,1,0
2152,Jérôme Roussillon,40,27,17,19,4,15,26,57.7,11,26,3,23,15,52,0
2153,Wayne Routledge,10,5,2,6,2,2,8,25.0,6,5,0,5,2,5,0
2154,Nolan Roux,24,17,8,10,6,7,38,18.4,31,32,2,30,25,22,0
2155,Rubén,1,0,1,0,0,1,3,33.3,2,0,0,0,1,5,4
2156,Antonio Rüdiger,31,21,20,10,1,15,31,48.4,16,29,15,14,24,115,1
2157,Sebastian Rudy,50,40,12,33,5,28,55,50.9,27,11,1,10,18,7,1
2158,Stéphane Ruffier,0,0,0,0,0,0,0,,0,0,0,0,0,14,1
2159,Vincent Rüfli,4,1,3,1,0,3,3,100.0,0,1,0,1,1,0,0
2160,Daniele Rugani,18,12,11,5,2,7,13,53.8,6,18,14,4,20,87,1
2161,Mário Rui,55,39,18,32,5,30,52,57.7,22,30,5,25,14,43,1
2162,Aitor Ruibal,0,0,0,0,0,0,0,,0,0,0,0,0,0,0
2163,Fabián Ruiz Peña,83,53,34,40,9,26,73,35.6,47,35,3,32,42,36,1
2164,Víctor Ruiz,33,22,29,4,0,13,25,52.0,12,27,18,9,58,134,1
2165,Antonio Rukavina,25,22,12,9,4,17,25,68.0,8,11,3,8,16,68,0
2166,Gerónimo Rulli,2,1,2,0,0,2,6,33.3,4,0,0,0,0,10,2
2167,Lukas Rupp,36,32,18,14,4,19,36,52.8,17,18,0,18,13,13,2
2168,Marco Russ,17,11,9,8,0,13,19,68.4,6,23,11,12,24,66,0
2169,Mathew Ryan,0,0,0,0,0,0,3,0.0,3,0,0,0,3,10,3
2170,Idriss Saadi,6,5,2,3,1,2,11,18.2,9,3,2,1,5,1,0
2171,Youssouf Sabaly,93,61,54,34,5,43,68,63.2,25,26,6,20,54,104,0
2172,Abdelhamid Sabiri,5,4,2,0,3,1,7,14.3,6,4,0,4,1,2,0
2173,Marcel Sabitzer,38,28,12,20,6,23,49,46.9,26,23,2,21,24,21,1
2174,Enric Saborit,50,27,31,17,2,19,29,65.5,10,17,5,12,24,55,0
2175,Ihsan Sacko,1,1,0,1,0,0,1,0.0,1,1,0,1,2,1,0
2176,Ihsan Sacko,10,8,6,0,4,2,10,20.0,8,2,0,2,5,6,0
2177,Mujaid Sadick,4,2,2,2,0,2,3,66.7,1,3,2,1,1,4,0
2178,Armando Sadiku,1,1,0,1,0,0,1,0.0,1,4,2,2,2,2,0
2179,Umar Sadiq,0,0,0,0,0,0,3,0.0,3,1,0,1,1,2,0
2180,Bacary Sagna,9,7,5,3,1,1,7,14.3,6,9,2,7,20,28,0
2181,Adrián Sahibeddine,0,0,0,0,0,0,1,0.0,1,1,0,1,0,0,0
2182,Nuri Şahin,40,34,9,28,3,15,39,38.5,24,12,0,12,20,29,1
2183,Wesley Saïd,33,22,17,11,5,7,26,26.9,19,15,1,14,15,4,0
2184,Allan Saint-Maximin,18,14,13,2,3,12,28,42.9,16,12,1,11,11,10,0
2185,Allan Saint-Maximin,0,0,0,0,0,0,0,,0,0,0,0,0,0,0
2186,Henri Saivet,5,3,4,1,0,2,5,40.0,3,0,0,0,4,8,1
2187,Gōtoku Sakai,50,40,25,18,7,22,47,46.8,25,40,12,28,44,55,0
2188,Hiroki Sakai,66,45,30,30,6,32,49,65.3,17,32,7,25,45,90,1
2189,Diafra Sakho,5,2,1,4,0,0,3,0.0,3,3,0,3,1,2,0
2190,Diafra Sakho,5,4,1,2,2,0,7,0.0,7,4,0,4,2,11,0
2191,Mamadou Sakho,21,14,15,5,1,9,16,56.3,7,19,11,8,30,101,3
2192,Bakary Sako,7,6,5,0,2,2,9,22.2,7,2,0,2,1,2,0
2193,Emiliano Sala,19,11,3,9,7,5,33,15.2,28,27,3,24,9,50,0
2194,Jacopo Sala,17,10,12,4,1,4,10,40.0,6,9,1,8,8,28,2
2195,Mohamed Salah,12,6,2,5,5,3,23,13.0,20,10,0,10,5,5,0
2196,Bartosz Salamon,28,22,21,7,0,12,21,57.1,9,24,18,6,58,148,0
2197,Carlos Salcedo,26,22,16,9,1,19,29,65.5,10,28,12,16,21,94,1
2198,Eddie Salcedo,0,0,0,0,0,0,0,,0,0,0,0,0,0,0
2199,Yannis Salibur,11,9,4,6,1,4,15,26.7,11,7,1,6,7,2,0
2200,Sejad Salihović,7,5,3,3,1,0,3,0.0,3,5,0,5,5,1,0
2201,Yoann Salmier,15,13,10,5,0,5,12,41.7,7,11,6,5,26,62,1
2202,Mamadou Samassa,0,0,0,0,0,0,2,0.0,2,0,0,0,0,12,3
2203,Brice Samba,0,0,0,0,0,0,0,,0,0,0,0,0,2,0
2204,Junior Sambia,21,12,6,11,4,6,28,21.4,22,16,0,16,20,18,0
2205,Frédéric Sammaritano,29,25,17,9,3,10,36,27.8,26,14,0,14,5,15,0
2206,Sergi Samper,10,4,4,6,0,2,3,66.7,1,0,0,0,0,0,0
2207,Jairo Samperio,9,6,2,6,1,3,13,23.1,10,5,1,4,1,5,0
2208,Jairo Samperio,1,1,0,1,0,1,1,100.0,0,0,0,0,0,0,0
2209,Mario Sampirisi,44,32,29,12,3,13,22,59.1,9,27,14,13,43,116,2
2210,Mikel San José,52,37,19,23,10,19,73,26.0,54,43,13,30,41,30,0
2211,Antonio Sanabria,8,8,0,4,4,0,3,0.0,3,5,0,5,4,6,0
2212,Renato Sanches,12,7,6,6,0,6,18,33.3,12,9,1,8,7,5,1
2213,Alexis Sánchez,20,9,9,4,7,7,32,21.9,25,5,2,3,6,1,0
2214,Alexis Sánchez,21,17,10,4,7,4,27,14.8,23,8,0,8,17,0,0
2215,Carlos Sánchez,7,6,2,5,0,4,6,66.7,2,3,1,2,8,10,0
2216,Carlos Sánchez,25,12,6,16,3,9,24,37.5,15,13,5,8,18,24,2
2217,Davinson Sánchez,38,24,28,9,1,18,40,45.0,22,26,10,16,38,162,0
2218,Sergio Sánchez,4,3,4,0,0,3,4,75.0,1,1,0,1,3,3,0
2219,Víctor Sánchez,106,72,56,45,5,49,113,43.4,64,38,14,24,79,73,1
2220,Jadon Sancho,5,5,2,2,1,2,7,28.6,5,8,0,8,5,2,0
2221,Sandro,29,21,15,13,1,12,18,66.7,6,23,16,7,18,43,1
2222,Alex Sandro,57,31,33,17,7,20,39,51.3,19,21,1,20,30,45,0
2223,Arona Sané,1,0,1,0,0,0,0,,0,1,0,1,0,0,0
2224,Lamine Sané,19,14,15,4,0,8,10,80.0,2,8,6,2,20,49,1
2225,Leroy Sané,27,21,14,7,6,8,22,36.4,14,22,1,21,13,6,0
2226,Salif Sané,57,43,46,10,1,40,64,62.5,24,49,29,20,57,238,6
2227,Ibrahim Sangaré,72,47,35,34,3,29,69,42.0,40,33,7,26,24,19,1
2228,Younousse Sankharé,33,23,10,20,3,4,34,11.8,30,15,4,11,21,7,0
2229,Baissama Sankoh,27,19,8,18,1,8,28,28.6,20,20,8,12,25,64,1
2230,Siriki Sanogo,1,1,0,1,0,0,0,,0,0,0,0,1,1,0
2231,Yaya Sanogo,11,6,1,5,5,3,11,27.3,8,6,1,5,6,14,1
2232,Morgan Sanson,64,40,13,34,17,21,71,29.6,50,30,0,30,25,5,1
2233,Nicola Sansone,8,4,2,4,2,2,17,11.8,15,1,0,1,1,2,0
2234,Baptiste Santamaria,59,40,25,29,5,23,83,27.7,60,39,8,31,43,48,2
2235,Ivan Santini,19,12,5,8,6,4,29,13.8,25,13,5,8,4,33,0
2236,Davide Santon,19,14,13,6,0,9,17,52.9,8,10,3,7,20,32,2
2237,Christian Santos,2,0,1,0,1,0,4,0.0,4,2,1,1,2,9,0
2238,Douglas Santos,90,60,53,34,3,50,87,57.5,37,63,2,61,56,96,1
2239,Samir Santos,55,38,35,17,3,19,38,50.0,19,33,16,17,75,161,1
2240,Antonio Santurro,0,0,0,0,0,0,0,,0,0,0,0,0,1,0
2241,Riccardo Saponara,12,8,2,8,2,2,11,18.2,9,3,1,2,1,5,0
2242,Pablo Sarabia,27,19,10,13,4,11,49,22.4,38,39,1,38,30,34,1
2243,Yusuf Sari,0,0,0,0,0,0,0,,0,0,0,0,0,0,0
2244,Bouna Sarr,65,42,42,20,3,22,38,57.9,16,20,4,16,32,53,2
2245,Ismaila Sarr,20,10,5,10,5,7,29,24.1,22,17,0,17,9,3,1
2246,Malang Sarr,24,18,17,7,0,8,18,44.4,10,14,6,8,31,44,2
2247,Imanol Sarriegi,2,2,1,0,1,2,3,66.7,1,2,0,2,1,0,0
2248,Marco Sau,9,6,2,4,3,1,17,5.9,16,10,0,10,9,1,0
2249,Stefan Savić,30,20,23,7,0,16,39,41.0,23,38,23,15,45,150,1
2250,Gianluca Scamacca,0,0,0,0,0,0,0,,0,1,0,1,0,0,0
2251,Fabian Schär,59,45,45,14,0,32,61,52.5,29,36,20,16,45,141,1
2252,Ezequiel Schelotto,20,13,14,6,0,12,27,44.4,15,7,3,4,19,58,2
2253,Pasquale Schiattarella,40,31,20,15,5,13,43,30.2,30,7,2,5,24,26,0
2254,Eros Schiavon,6,5,2,3,1,1,7,14.3,6,6,2,4,2,4,0
2255,Patrik Schick,9,7,1,5,3,1,9,11.1,8,14,0,14,2,11,0
2256,Julian Schieber,1,1,0,0,1,1,1,100.0,0,1,0,1,0,2,0
2257,Christopher Schindler,83,61,56,27,0,24,41,58.5,17,54,30,24,75,275,1
2258,Sven Schipplock,7,6,1,5,1,0,1,0.0,1,4,0,4,1,3,0
2259,Jeffrey Schlupp,57,36,35,20,2,23,43,53.5,20,34,8,26,24,67,0
2260,Kasper Schmeichel,1,0,1,0,0,1,3,33.3,2,1,0,1,0,18,5
2261,Marcel Schmelzer,35,27,21,12,2,20,30,66.7,10,27,6,21,30,57,1
2262,Jonathan Schmid,23,16,6,13,4,11,18,61.1,7,16,1,15,10,35,1
2263,Manuel Schmiedebach,5,5,5,0,0,4,9,44.4,5,2,0,2,5,6,0
2264,Benno Schmitz,3,2,2,1,0,2,3,66.7,1,0,0,0,0,1,0
2265,Morgan Schneiderlin,58,40,34,21,3,15,44,34.1,29,18,7,11,61,59,1
2266,Alessandro Schöpf,22,17,10,9,3,11,23,47.8,12,16,0,16,15,13,1
2267,Nico Schulz,40,29,17,14,9,20,27,74.1,7,33,5,28,23,24,0
2268,André Schürrle,22,19,8,7,7,9,18,50.0,9,13,1,12,7,7,1
2269,Julian Schuster,14,10,6,7,1,6,11,54.5,5,17,10,7,19,56,0
2270,Pirmin Schwegler,81,57,25,55,1,42,70,60.0,28,33,9,24,49,46,1
2271,Alexander Schwolow,0,0,0,0,0,0,1,0.0,1,0,0,0,0,9,1
2272,Simone Scuffet,0,0,0,0,0,0,0,,0,0,0,0,1,1,1
2273,Sergio Segura García,,2,,,,,,,,,,,1,,
2274,Ernest Seka,60,47,41,14,5,40,61,65.6,21,25,8,17,51,98,1
2275,Vahid Selimović,20,14,10,9,1,11,14,78.6,3,10,8,2,17,58,1
2276,Davie Selke,13,10,1,5,7,4,9,44.4,5,26,5,21,2,20,1
2277,Ole Selnæs,73,45,29,42,2,18,61,29.5,43,37,15,22,34,53,1
2278,Nélson Semedo,34,25,19,11,4,17,29,58.6,12,16,2,14,22,26,1
2279,Rúben Semedo,6,5,6,0,0,4,6,66.7,2,5,1,4,5,13,2
2280,Stefano Sensi,17,13,11,6,0,9,22,40.9,13,16,3,13,22,10,1
2281,Luigi Sepe,0,0,0,0,0,0,0,,0,0,0,0,0,1,0
2282,Suat Serdar,59,47,21,26,12,27,64,42.2,37,38,3,35,21,17,1
2283,Jean Seri,25,14,9,12,4,9,56,16.1,47,16,4,12,26,15,4
2284,Julien Serrano,2,2,1,0,1,1,2,50.0,1,2,0,2,4,14,0
2285,Grégory Sertic,5,3,3,2,0,2,6,33.3,4,8,7,1,6,23,0
2286,Stéphane Sessègnon,4,4,2,2,0,1,7,14.3,6,0,0,0,0,2,0
2287,Lee Seung-woo,3,2,0,1,2,0,6,0.0,6,1,0,1,2,0,0
2288,Stephan El Shaarawy,22,16,9,8,5,5,21,23.8,16,16,1,15,24,8,0
2289,Meritan Shabani,2,1,1,0,1,1,2,50.0,1,1,0,1,0,0,1
2290,Xherdan Shaqiri,25,17,9,11,5,10,39,25.6,29,9,1,8,16,6,2
2291,Luke Shaw,18,15,10,7,1,11,18,61.1,7,16,2,14,4,22,1
2292,Ryan Shawcross,36,20,25,9,2,13,25,52.0,12,33,23,10,40,224,1
2293,Jonjo Shelvey,39,24,17,21,1,8,26,30.8,18,26,5,21,28,33,0
2294,Gaku Shibasaki,21,10,8,10,3,6,21,28.6,15,6,1,5,19,9,0
2295,Djibril Sidibé,59,39,24,27,8,23,45,51.1,22,20,4,16,46,52,1
2296,Sidnei,41,28,30,11,0,18,25,72.0,7,26,9,17,31,101,1
2297,Jaime Sierra Mateos,1,1,1,0,0,0,1,0.0,1,0,0,0,1,0,0
2298,Vincent Sierro,8,6,2,6,0,4,9,44.4,5,2,1,1,4,0,0
2299,Gylfi Sigurðsson,38,26,15,14,9,16,57,28.1,41,37,7,30,34,36,0
2300,Kolbeinn Sigþórsson,0,0,0,0,0,0,0,,0,0,0,0,1,0,0
2301,Adrien Silva,22,13,8,13,1,6,28,21.4,22,12,2,10,14,0,0
2302,André Silva,5,4,1,0,4,2,7,28.6,5,10,1,9,4,6,0
2303,Bernardo Silva,27,18,11,9,7,6,30,20.0,24,17,1,16,10,12,1
2304,David Silva,32,21,11,17,4,9,45,20.0,36,28,5,23,18,7,0
2305,Gabriel Silva,28,20,19,4,5,19,31,61.3,12,21,6,15,37,83,1
2306,Jonathan Silva,0,0,0,0,0,0,1,0.0,1,1,1,0,3,1,0
2307,Thiago Silva,31,23,19,12,0,12,21,57.1,9,28,18,10,18,114,0
2308,Matías Silvestre,12,8,10,1,1,6,12,50.0,6,33,26,7,11,154,3
2309,Marco Silvestri,0,0,0,0,0,0,0,,0,0,0,0,1,0,0
2310,Giovanni Simeone,32,23,9,17,6,8,40,20.0,32,27,1,26,12,32,0
2311,Lorenco Šimić,5,3,5,0,0,3,4,75.0,1,7,4,3,11,15,0
2312,Stefan Simić,13,8,11,2,0,10,11,90.9,1,6,3,3,10,44,0
2313,David Simón,24,17,11,10,3,9,16,56.3,7,13,4,9,22,11,1
2314,Danny Simpson,38,22,31,6,1,22,45,48.9,23,31,19,12,34,132,1
2315,Jack Simpson,1,1,1,0,0,0,1,0.0,1,1,0,1,0,4,0
2316,Josh Sims,4,3,1,2,1,2,7,28.6,5,5,0,5,1,0,0
2317,Jerome Sinclair,0,0,0,0,0,0,1,0.0,1,0,0,0,1,0,0
2318,Giovanni Sio,14,8,2,9,3,0,20,0.0,20,11,0,11,6,23,1
2319,Dimitris Siovas,48,33,43,5,0,29,46,63.0,17,27,12,15,62,89,0
2320,Tobias Sippel,1,1,1,0,0,1,2,50.0,1,0,0,0,0,5,1
2321,Salvatore Sirigu,0,0,0,0,0,0,0,,0,0,0,0,1,35,3
2322,Moussa Sissoko,23,17,14,5,4,9,12,75.0,3,11,1,10,9,23,1
2323,Pione Sisto,18,12,8,6,4,9,33,27.3,24,12,1,11,12,7,1
2324,Antonio Sivera,0,0,0,0,0,0,0,,0,0,0,0,0,0,0
2325,Ellyes Skhiri,89,54,34,47,8,37,88,42.0,51,59,10,49,77,57,4
2326,Łukasz Skorupski,0,0,0,0,0,0,0,,0,0,0,0,0,1,0
2327,Milan Škriniar,86,55,69,16,1,44,70,62.9,26,38,26,12,35,180,0
2328,Islam Slimani,2,2,1,1,0,1,4,25.0,3,2,0,2,0,2,0
2329,Islam Slimani,0,0,0,0,0,0,2,0.0,2,0,0,0,1,1,0
2330,Naïm Sliti,47,32,20,17,10,20,52,38.5,32,22,2,20,13,7,0
2331,Chris Smalling,40,25,28,12,0,16,28,57.1,12,32,28,4,63,162,1
2332,Adam Smith,50,36,33,16,1,24,53,45.3,29,46,8,38,31,73,0
2333,Tommy Smith,38,27,18,14,6,23,36,63.9,13,22,6,16,26,80,3
2334,Wesley Sneijder,0,0,0,0,0,0,3,0.0,3,1,0,1,2,2,1
2335,Cédric Soares,54,34,40,10,4,22,31,71.0,9,32,8,24,24,109,2
2336,Ramadan Sobhi,32,21,17,14,1,11,36,30.6,25,14,0,14,14,14,0
2337,Rubén Sobrino,33,24,12,16,5,6,27,22.2,21,19,2,17,18,10,0
2338,Dominic Solanke,7,4,0,6,1,1,4,25.0,3,5,1,4,2,9,0
2339,Carlos Soler,51,32,21,21,9,22,53,41.5,31,25,1,24,5,19,0
2340,Somália,65,45,21,36,8,14,54,25.9,40,34,2,32,34,35,0
2341,Yann Sommer,0,0,0,0,0,0,0,,0,0,0,0,3,6,3
2342,Kévin Soni,1,1,0,1,0,0,0,,0,0,0,0,0,0,0
2343,Jérémy Sorbon,32,19,24,7,1,10,32,31.3,22,37,24,13,53,152,4
2344,Oliver Sorg,46,28,27,18,1,23,53,43.4,30,24,7,17,42,71,0
2345,David Soria,1,0,1,0,0,1,1,100.0,0,0,0,0,2,13,2
2346,Roberto Soriano,30,20,10,16,4,3,16,18.8,13,14,0,14,4,9,0
2347,Stefano Sorrentino,0,0,0,0,0,0,0,,0,0,0,0,0,23,3
2348,Pape Souaré,0,0,0,0,0,0,0,,0,0,0,0,0,0,0
2349,Rayan Souici,0,0,0,0,0,0,0,,0,1,0,1,0,0,0
2350,Adama Soumaoro,9,5,7,2,0,2,3,66.7,1,22,16,6,16,50,1
2351,Boubakary Soumaré,13,9,8,5,0,3,14,21.4,11,8,1,7,7,6,1
2352,Samuel Souprayen,29,19,25,3,1,12,19,63.2,7,18,9,9,22,67,1
2353,Arnaud Souquet,89,68,58,26,5,36,56,64.3,20,46,16,30,39,72,2
2354,Çağlar Söyüncü,42,26,26,15,1,15,26,57.7,11,30,20,10,54,91,2
2355,Luca Sparandeo,0,0,0,0,0,0,1,0.0,1,1,0,1,0,0,0
2356,Julián Speroni,0,0,0,0,0,0,0,,0,0,0,0,1,4,0
2357,Leonardo Spinazzola,14,5,9,4,1,7,15,46.7,8,25,6,19,18,44,1
2358,Nicolás Spolli,27,21,24,2,1,13,22,59.1,9,26,17,9,36,120,2
2359,Marco Sportiello,0,0,0,0,0,0,1,0.0,1,0,0,0,1,13,4
2360,Bassem Srarfi,17,11,6,9,2,4,14,28.6,10,12,0,12,7,6,1
2361,Kostas Stafylidis,12,6,6,4,2,6,9,66.7,3,7,2,5,5,19,0
2362,Kostas Stafylidis,1,1,1,0,0,0,0,,0,1,0,1,0,2,0
2363,Benjamin Stambouli,95,75,45,48,2,49,74,66.2,25,39,7,32,64,76,1
2364,Junior Stanislas,16,8,8,4,4,7,15,46.7,8,21,6,15,6,15,0
2365,Caleb Stanko,2,2,1,1,0,1,2,50.0,1,3,0,3,1,8,0
2366,Niklas Stark,49,31,32,17,0,22,30,73.3,8,39,14,25,34,165,0
2367,Tom Starke,0,0,0,0,0,0,0,,0,0,0,0,0,0,0
2368,Timo Stavitski,4,3,1,1,2,1,16,6.3,15,7,0,7,3,1,0
2369,Renato Steffen,10,9,6,3,1,8,12,66.7,4,6,0,6,5,6,0
2370,Marc Stendera,23,20,6,15,2,8,20,40.0,12,10,1,9,8,2,0
2371,Pascal Stenzel,62,45,35,25,2,34,57,59.6,23,20,3,17,35,51,1
2372,Dale Stephens,104,62,63,39,2,32,114,28.1,82,53,16,37,63,69,1
2373,Jack Stephens,29,20,24,5,0,13,25,52.0,12,30,18,12,41,108,2
2374,Mariusz Stępiński,9,5,4,4,1,2,10,20.0,8,5,1,4,4,5,0
2375,Mariusz Stępiński,0,0,0,0,0,0,0,,0,0,0,0,0,0,0
2376,Raheem Sterling,19,14,7,7,5,3,32,9.4,29,24,0,24,9,9,0
2377,Ognjen Stijepović,0,0,0,0,0,0,0,,0,0,0,0,0,0,0
2378,Lars Stindl,52,39,11,29,12,14,38,36.8,24,53,4,49,31,32,1
2379,Valentin Stocker,1,0,0,1,0,0,0,,0,1,0,1,0,0,0
2380,Adrian Stoian,23,19,12,10,1,11,44,25.0,33,29,0,29,25,26,0
2381,John Stones,15,11,11,4,0,4,11,36.4,7,8,5,3,19,44,0
2382,Thomas Strakosha,0,0,0,0,0,0,0,,0,0,0,0,2,13,4
2383,Ivan Strinić,35,24,22,12,1,17,38,44.7,21,21,2,19,22,46,2
2384,Tobias Strobl,3,1,0,2,1,0,1,0.0,1,2,0,2,6,2,0
2385,Kevin Strootman,57,38,19,24,14,15,46,32.6,31,27,3,24,27,21,0
2386,Jens Stryger Larsen,36,27,25,10,1,21,39,53.8,18,35,14,21,31,82,2
2387,Cristhian Stuani,22,14,2,17,3,3,29,10.3,26,10,0,10,5,32,0
2388,Stefano Sturaro,17,11,5,9,3,4,11,36.4,7,9,2,7,5,18,1
2389,Daniel Sturridge,0,0,0,0,0,0,0,,0,0,0,0,0,0,0
2390,Daniel Sturridge,0,0,0,0,0,0,1,0.0,1,1,0,1,0,1,0
2391,Damián Suárez,86,64,54,21,11,44,90,48.9,46,34,8,26,46,76,1
2392,Denis Suárez,11,9,3,8,0,3,8,37.5,5,7,0,7,2,3,0
2393,Leonardo Suárez,0,0,0,0,0,0,0,,0,0,0,0,0,1,0
2394,Luis Suárez,17,10,4,5,8,4,19,21.1,15,4,3,1,8,31,0
2395,Danijel Subašić,0,0,0,0,0,0,2,0.0,2,1,0,1,0,13,2
2396,Neven Subotić,23,14,16,7,0,10,27,37.0,17,13,9,4,18,96,1
2397,Neven Subotić,9,9,5,3,1,6,7,85.7,1,6,2,4,5,16,0
2398,Isaac Success,9,7,4,4,1,3,8,37.5,5,2,0,2,5,0,0
2399,Niklas Süle,34,25,25,7,2,24,31,77.4,7,24,16,8,33,58,0
2400,Ki Sung-yueng,25,18,10,13,2,4,16,25.0,12,16,1,15,32,23,0
2401,Gilles Sunu,4,4,1,3,0,0,4,0.0,4,7,0,7,3,3,0
2402,Andrew Surman,16,12,5,8,3,6,23,26.1,17,33,12,21,16,52,2
2403,Markel Susaeta,42,29,16,15,11,16,65,24.6,49,17,0,17,18,13,0
2404,Suso,18,14,3,5,10,4,31,12.9,27,25,0,25,16,2,1
2405,Markus Suttner,25,15,18,4,3,10,22,45.5,12,16,2,14,12,49,1
2406,Seydou Sy,0,0,0,0,0,0,0,,0,0,0,0,0,2,0
2407,Issiaga Sylla,44,32,22,16,6,19,47,40.4,28,31,4,27,34,65,1
2408,Moussa Sylla,0,0,0,0,0,0,2,0.0,2,2,0,2,0,1,0
2409,Ádám Szalai,8,7,1,4,3,2,5,40.0,3,9,2,7,0,10,0
2410,Wojciech Szczęsny,0,0,0,0,0,0,0,,0,0,0,0,0,4,0
2411,Alexander Søderlund,1,1,1,0,0,0,2,0.0,2,1,0,1,2,2,0
2412,Frederik Sørensen,56,45,40,14,2,30,41,73.2,11,35,17,18,37,130,3
2413,Lasse Sørensen,2,2,2,0,0,1,5,20.0,4,2,0,2,0,3,0
2414,Alexander Sørloth,6,3,1,4,1,4,12,33.3,8,5,0,5,2,5,0
2415,Adel Taarabt,18,11,5,11,2,7,16,43.8,9,13,3,10,12,7,0
2416,Franck Tabanou,23,17,17,5,1,10,26,38.5,16,5,3,2,26,48,0
2417,Dušan Tadić,46,29,16,22,8,11,35,31.4,24,38,2,36,19,29,1
2418,Jonathan Tah,47,34,35,12,0,30,38,78.9,8,22,13,9,34,112,2
2419,Ervin Taha,1,1,0,1,0,0,1,0.0,1,0,0,0,0,0,0
2420,Mehdi Tahrat,7,6,4,3,0,2,5,40.0,3,3,1,2,9,15,1
2421,Saphir Taïder,6,2,4,2,0,1,2,50.0,1,3,2,1,1,4,0
2422,Flavien Tait,50,36,26,18,6,18,78,23.1,60,43,4,39,20,17,1
2423,Adrien Tameze,58,36,32,21,5,26,47,55.3,21,26,5,21,41,22,1
2424,Tana,31,24,13,14,4,12,36,33.3,24,8,0,8,23,5,0
2425,Oussama Tannane,15,13,6,8,1,7,12,58.3,5,5,0,5,5,0,0
2426,Oussama Tannane,12,6,4,5,3,2,5,40.0,3,2,0,2,3,2,0
2427,Matt Targett,6,3,5,0,1,1,3,33.3,2,3,2,1,3,7,1
2428,James Tarkowski,46,26,36,10,0,17,38,44.7,21,55,43,12,50,223,2
2429,Ciprian Tătărușanu,1,0,1,0,0,1,2,50.0,1,0,0,0,1,12,3
2430,Júlio Tavares,3,1,1,1,1,1,11,9.1,10,11,6,5,3,36,0
2431,Taleb Tawatha,12,7,7,5,0,5,9,55.6,4,7,1,6,6,18,0
2432,Charlie Taylor,16,4,9,6,1,7,12,58.3,5,13,5,8,15,52,0
2433,Jordan Tell,4,4,1,3,0,0,1,0.0,1,0,0,0,1,0,0
2434,Cristian Tello,32,24,12,14,6,7,37,18.9,30,19,0,19,16,4,1
2435,Marc-André ter Stegen,1,0,1,0,0,1,3,33.3,2,1,0,1,4,12,1
2436,Simon Terodde,9,6,1,7,1,2,5,40.0,3,8,2,6,5,8,0
2437,Simon Terodde,11,9,3,8,0,4,11,36.4,7,3,0,3,4,7,0
2438,Marco Terrazzino,31,24,12,13,6,21,39,53.8,18,16,0,16,9,19,0
2439,Martin Terrier,42,30,16,23,3,9,28,32.1,19,11,1,10,14,6,0
2440,Kenny Tete,37,25,24,10,3,15,26,57.7,11,20,7,13,29,52,0
2441,Cedric Teuchert,0,0,0,0,0,0,0,,0,1,0,1,0,0,0
2442,Florian Thauvin,44,28,16,20,8,15,46,32.6,31,22,1,21,17,20,0
2443,Kévin Théophile-Catherine,36,27,23,13,0,11,24,45.8,13,19,15,4,31,113,1
2444,Cyril Théréau,1,1,1,0,0,1,2,50.0,1,0,0,0,0,2,0
2445,Cyril Théréau,11,6,3,6,2,7,19,36.8,12,13,0,13,8,9,0
2446,Vincent Thill,0,0,0,0,0,0,0,,0,0,0,0,0,0,0
2447,Romain Thomas,31,21,16,15,0,14,29,48.3,15,32,19,13,34,151,1
2448,Adrien Thomasson,71,52,41,23,7,22,73,30.1,51,58,4,54,18,20,0
2449,Erik Thommy,6,5,1,3,2,3,8,37.5,5,2,0,2,5,0,0
2450,Erik Thommy,19,11,7,7,5,9,17,52.9,8,17,2,15,9,8,1
2451,Marcus Thuram,20,15,6,10,4,6,25,24.0,19,14,0,14,5,12,0
2452,Youri Tielemans,47,24,14,28,5,17,55,30.9,38,24,5,19,34,20,1
2453,David Timor,17,10,7,7,3,7,18,38.9,11,10,5,5,20,30,1
2454,Jonathan Tinhan,1,0,0,1,0,0,1,0.0,1,1,0,1,1,0,0
2455,Marcel Tisserand,15,10,10,4,1,7,14,50.0,7,18,13,5,31,50,0
2456,Tito,8,5,5,3,0,6,18,33.3,12,12,5,7,12,16,0
2457,Ola Toivonen,4,4,1,0,3,0,7,0.0,7,2,0,2,2,12,0
2458,Karl Toko Ekambi,17,8,2,5,10,5,29,17.2,24,13,0,13,15,2,0
2459,Hernán Toledo,5,5,2,2,1,1,11,9.1,10,2,0,2,5,5,0
2460,Corentin Tolisso,33,22,8,18,7,14,32,43.8,18,13,3,10,16,8,0
2461,Jeremy Toljan,3,1,1,2,0,2,3,66.7,1,3,0,3,0,3,0
2462,Jeremy Toljan,29,20,17,11,1,19,32,59.4,13,17,2,15,12,45,0
2463,Rafael Tolói,72,40,34,38,0,35,68,51.5,33,35,14,21,63,119,1
2464,James Tomkins,47,26,36,10,1,16,31,51.6,15,24,12,12,63,216,1
2465,Nenad Tomović,2,1,1,1,0,0,2,0.0,2,0,0,0,3,5,1
2466,Nenad Tomović,23,17,17,6,0,10,17,58.8,7,29,21,8,50,146,0
2467,Lorenzo Tonelli,7,1,4,3,0,5,9,55.6,4,2,1,1,7,10,0
2468,Aleksandar Tonev,5,3,1,2,2,0,1,0.0,1,4,1,3,1,6,0
2469,Toño,12,11,11,1,0,5,10,50.0,5,4,0,4,6,29,0
2470,Ömer Toprak,36,25,29,6,1,26,29,89.7,3,27,16,11,21,104,1
2471,Vasilis Torosidis,8,7,5,2,1,4,9,44.4,5,8,3,5,15,42,0
2472,Emanuele Torrasi,,,,,,,,,,,,,,,
2473,Emanuele Torrasi,0,0,0,0,0,0,0,,0,0,0,0,0,0,0
2474,Lucas Torreira,101,73,36,57,8,30,77,39.0,47,52,17,35,72,36,1
2475,Daniel Torres,19,11,14,5,0,7,31,22.6,24,15,7,8,19,32,2
2476,Fernando Torres,11,8,3,7,1,2,6,33.3,4,4,1,3,2,9,0
2477,Ferrán Torres,8,7,3,5,0,2,6,33.3,4,1,0,1,3,1,0
2478,Miguel Torres,16,13,13,3,0,6,14,42.9,8,9,7,2,13,35,0
2479,Pau Torres,0,0,0,0,0,0,1,0.0,1,1,1,0,0,4,0
2480,Jordan Torunarigha,18,12,16,2,0,7,13,53.8,6,20,13,7,23,43,1
2481,Alin Toșca,11,8,7,4,0,6,12,50.0,6,9,4,5,13,69,0
2482,Alin Toșca,12,9,7,5,0,5,9,55.6,4,7,1,6,5,17,1
2483,Cenk Tosun,6,3,2,2,2,1,11,9.1,10,9,4,5,1,13,0
2484,Jérémy Toulalan,43,25,35,7,1,17,39,43.6,22,25,16,9,28,121,0
2485,Abdoulaye Touré,74,52,28,38,8,23,67,34.3,44,40,10,30,62,49,1
2486,Almamy Touré,51,29,31,13,7,18,30,60.0,12,15,2,13,22,61,0
2487,Thomas Touré,0,0,0,0,0,0,0,,0,0,0,0,1,0,0
2488,Thomas Touré,2,1,0,1,1,0,7,0.0,7,5,0,5,1,0,0
2489,Yaya Touré,2,2,1,0,1,1,1,100.0,0,3,1,2,5,4,0
2490,Lucas Tousart,98,59,41,55,2,38,98,38.8,60,41,16,25,52,79,0
2491,Andros Townsend,60,34,35,12,13,24,75,32.0,51,49,1,48,35,28,0
2492,Adama Traoré,6,4,0,4,2,1,4,25.0,3,3,0,3,3,1,0
2493,Bertrand Traoré,32,20,7,20,5,10,35,28.6,25,24,3,21,39,31,1
2494,Charles Traore,60,32,46,9,5,26,56,46.4,30,52,16,36,57,171,0
2495,Hamari Traoré,79,55,43,31,5,41,66,62.1,25,31,12,19,61,117,0
2496,Ibrahima Traoré,4,2,2,2,0,4,7,57.1,3,2,0,2,0,1,0
2497,Ismaël Traoré,54,32,40,13,1,14,29,48.3,15,25,10,15,52,132,2
2498,Lacina Traoré,9,9,2,3,4,3,7,42.9,4,6,3,3,2,21,0
2499,Kevin Trapp,0,0,0,0,0,0,0,,0,0,0,0,0,1,0
2500,Manu Trigueros,61,41,23,34,4,21,71,29.6,50,38,13,25,22,44,0
2501,Kieran Trippier,52,30,29,21,2,21,44,47.7,23,31,6,25,20,53,1
2502,Marcello Trotta,39,21,12,18,9,10,55,18.2,45,22,2,20,14,20,0
2503,Philipp Tschauner,1,0,1,0,0,1,2,50.0,1,2,0,2,0,8,5
2504,Axel Tuanzebe,0,0,0,0,0,0,0,,0,0,0,0,0,0,0
2505,Marco Tumminello,2,2,0,1,1,0,2,0.0,2,2,0,2,0,0,0
2506,Marco Tumminello,0,0,0,0,0,0,0,,0,0,0,0,0,0,0
2507,Ľubomír Tupta,0,0,0,0,0,0,3,0.0,3,0,0,0,0,0,0
2508,Josh Tymon,5,1,4,1,0,2,3,66.7,1,1,0,1,1,3,0
2509,Przemysław Tytoń,0,0,0,0,0,0,0,,0,0,0,0,0,0,0
2510,Matthieu Udol,14,8,13,1,0,5,14,35.7,9,10,2,8,5,17,0
2511,Anthony Ujah,4,3,0,2,2,1,1,100.0,0,2,0,2,0,6,0
2512,Leonardo Ulloa,1,0,0,0,1,0,0,,0,0,0,0,0,1,0
2513,Leonardo Ulloa,3,1,0,1,2,1,7,14.3,6,1,0,1,0,3,0
2514,Sven Ulreich,1,0,1,0,0,1,1,100.0,0,0,0,0,3,6,1
2515,Samuel Umtiti,50,35,35,15,0,20,29,69.0,9,25,17,8,37,72,3
2516,Enes Ünal,9,5,0,4,5,0,12,0.0,12,16,3,13,4,11,0
2517,Enes Ünal,6,6,2,2,2,1,10,10.0,9,7,1,6,2,5,0
2518,Cengiz Ünder,10,6,4,6,0,3,18,16.7,15,8,1,7,9,10,0
2519,Dayot Upamecano,57,43,36,17,4,31,45,68.9,14,32,9,23,55,141,1
2520,Mark Uth,32,23,4,21,7,5,22,22.7,17,30,3,27,9,19,0
2521,Francis Uzoho,0,0,0,0,0,0,0,,0,0,0,0,0,1,0
2522,Valentín Vada,22,11,7,14,1,8,32,25.0,24,8,1,7,6,5,1
2523,Josha Vagnoman,1,1,0,1,0,1,1,100.0,0,0,0,0,0,0,0
2524,Sauli Väisänen,12,9,9,3,0,6,8,75.0,2,5,4,1,13,26,0
2525,Mirko Valdifiori,13,9,5,7,1,2,11,18.2,9,3,1,2,6,9,0
2526,Antonio Valencia,57,32,21,28,8,16,36,44.4,20,47,6,41,48,80,0
2527,Gerard Valentín,5,4,4,0,1,1,2,50.0,1,1,0,1,3,3,0
2528,Borja Valero,46,31,17,25,4,20,58,34.5,38,15,4,11,18,41,1
2529,Borja Valle,6,6,3,3,0,1,4,25.0,3,2,0,2,3,4,0
2530,Jesús Vallejo,8,7,6,2,0,2,5,40.0,3,6,5,1,16,21,1
2531,Mattia Valoti,62,41,21,35,6,11,53,20.8,42,25,3,22,41,37,1
2532,Federico Valverde,25,16,12,10,3,8,15,53.3,7,12,1,11,21,17,0
2533,Virgil van Dijk,10,7,6,2,2,2,3,66.7,1,14,13,1,29,81,1
2534,Virgil van Dijk,15,8,7,7,1,4,5,80.0,1,8,2,6,18,80,1
2535,Raphaël Varane,28,19,20,7,1,8,15,53.3,7,27,10,17,33,109,2
2536,Jamie Vardy,15,9,3,7,5,1,8,12.5,7,21,1,20,2,17,0
2537,Cédric Varrault,13,7,6,7,0,9,12,75.0,3,14,11,3,16,72,0
2538,Franco Vázquez,39,32,16,15,8,6,34,17.6,28,20,2,18,11,11,0
2539,Lucas Vázquez,48,33,16,21,11,12,42,28.6,30,28,2,26,7,9,0
2540,Matías Vecino,54,34,15,30,9,19,49,38.8,30,28,6,22,20,31,0
2541,Koke Vegas,0,0,0,0,0,0,0,,0,0,0,0,0,1,0
2542,Carlos Vela,12,7,5,3,4,6,7,85.7,1,2,0,2,0,1,0
2543,Miloš Veljković,45,32,30,13,2,30,52,57.7,22,34,12,22,34,134,1
2544,Miguel Veloso,40,29,18,19,3,11,41,26.8,30,26,3,23,13,35,0
2545,Lorenzo Venuti,44,34,26,12,6,16,37,43.2,21,40,16,24,40,105,3
2546,Rémy Vercoutre,2,2,2,0,0,2,2,100.0,0,0,0,0,2,14,2
2547,Daniele Verde,10,9,8,1,1,6,20,30.0,14,8,0,8,30,19,0
2548,Simone Verdi,33,24,17,13,3,11,43,25.6,32,20,1,19,36,12,0
2549,Olivier Verdon,0,0,0,0,0,0,0,,0,0,0,0,0,3,0
2550,Jordan Veretout,65,45,34,23,8,20,69,29.0,49,39,4,35,37,59,0
2551,Paul Verhaegh,45,38,21,22,2,24,33,72.7,9,38,10,28,33,60,0
2552,Thomas Vermaelen,13,9,7,5,1,5,11,45.5,6,10,3,7,18,28,0
2553,Marco Verratti,51,33,20,25,6,12,55,21.8,43,25,6,19,26,11,3
2554,Valerio Verre,7,3,3,2,2,2,7,28.6,5,12,0,12,8,7,0
2555,Jan Vertonghen,64,41,40,20,4,25,36,69.4,11,29,11,18,60,177,0
2556,Mikel Vesga,17,8,6,11,0,4,25,16.0,21,14,3,11,8,15,0
2557,Jannik Vestergaard,58,41,43,15,0,32,48,66.7,16,55,39,16,40,161,3
2558,Rúben Vezo,43,24,30,12,1,16,32,50.0,16,25,9,16,23,83,0
2559,Francesco Vicari,38,22,25,13,0,21,39,53.8,18,33,27,6,45,210,1
2560,Aleix Vidal,6,4,2,3,1,1,10,10.0,9,4,0,4,9,1,0
2561,Arturo Vidal,69,51,36,28,5,33,69,47.8,36,22,1,21,28,20,1
2562,Nacho Vidal,17,14,15,1,1,14,22,63.6,8,5,2,3,10,18,0
2563,Luca Vido,5,5,2,3,0,1,1,100.0,0,1,0,1,0,0,0
2564,Jonathan Viera,36,25,10,22,4,3,28,10.7,25,21,0,21,11,2,0
2565,Luciano Vietto,5,4,1,2,2,0,3,0.0,3,3,0,3,3,3,0
2566,Luciano Vietto,8,6,2,3,3,1,4,25.0,3,3,0,3,2,5,0
2567,Carlos Vigaray,27,16,16,9,2,11,16,68.8,5,5,1,4,14,13,0
2568,Dídac Vilà,29,26,15,9,5,13,18,72.2,5,14,3,11,14,27,0
2569,Julio Villalba,0,0,0,0,0,0,0,,0,0,0,0,0,0,0
2570,Nicolas Viola,37,27,20,14,3,15,39,38.5,24,29,8,21,24,23,2
2571,Mattia Vitale,2,1,2,0,0,0,0,,0,1,0,1,3,1,0
2572,Vitolo,15,12,9,5,1,4,17,23.5,13,10,3,7,6,9,0
2573,Vitolo,9,6,4,3,2,3,15,20.0,12,10,1,9,6,5,0
2574,Federico Viviani,52,36,23,26,3,18,55,32.7,37,39,9,30,58,26,2
2575,Emiliano Viviano,0,0,0,0,0,0,0,,0,0,0,0,2,10,4
2576,Oswaldo Vizcarrondo,21,15,17,3,1,14,37,37.8,23,18,16,2,20,129,2
2577,Nikola Vlašić,9,5,3,6,0,2,9,22.2,7,14,2,12,9,10,0
2578,Kevin Vogt,38,28,30,7,1,23,34,67.6,11,37,23,14,25,114,2
2579,Sam Vokes,3,1,1,2,0,0,3,0.0,3,6,2,4,3,15,0
2580,Kevin Volland,23,20,7,8,8,11,26,42.3,15,16,1,15,3,35,0
2581,Giovanni Volpicelli,0,0,0,0,0,0,1,0.0,1,0,0,0,0,0,0
2582,Michel Vorm,0,0,0,0,0,0,0,,0,0,0,0,0,1,0
2583,Stefan de Vrij,31,22,14,17,0,14,23,60.9,9,43,24,19,71,156,1
2584,Šime Vrsaljko,48,30,25,17,6,26,40,65.0,14,24,8,16,36,63,0
2585,Jagoš Vuković,5,4,3,1,1,3,6,50.0,3,19,14,5,20,113,0
2586,Sandro Wagner,8,5,3,5,0,5,6,83.3,1,11,3,8,3,13,0
2587,Sandro Wagner,9,6,3,5,1,1,1,100.0,0,4,0,4,2,1,0
2588,Molla Wagué,5,3,3,2,0,2,5,40.0,3,1,0,1,9,30,0
2589,Molla Wagué,1,0,0,1,0,0,0,,0,0,0,0,2,5,0
2590,Wakaso,43,30,25,15,3,13,39,33.3,26,22,1,21,35,21,0
2591,Walace,38,25,13,23,2,19,44,43.2,25,25,3,22,21,14,1
2592,Theo Walcott,1,0,1,0,0,0,0,,0,0,0,0,1,0,0
2593,Theo Walcott,27,19,12,13,2,7,15,46.7,8,9,0,9,8,12,0
2594,Luca Waldschmidt,10,6,1,8,1,3,10,30.0,7,11,0,11,3,2,0
2595,Kyle Walker,47,31,20,21,6,18,31,58.1,13,21,2,19,29,75,2
2596,Kyle Walker-Peters,5,4,4,1,0,2,4,50.0,2,2,0,2,3,8,0
2597,Wallace,17,7,11,6,0,4,13,30.8,9,13,5,8,29,43,3
2598,Anthony Walongwa,2,1,2,0,0,0,0,,0,0,0,0,1,8,0
2599,Rémi Walter,11,7,4,6,1,3,7,42.9,4,2,1,1,5,3,0
2600,Rémi Walter,23,10,9,13,1,2,23,8.7,21,7,3,4,11,14,0
2601,Jonathan Walters,0,0,0,0,0,0,0,,0,0,0,0,0,1,0
2602,Aaron Wan-Bissaka,30,19,20,7,3,15,19,78.9,4,18,7,11,15,45,0
2603,Victor Wanyama,30,20,13,16,1,14,31,45.2,17,13,3,10,10,20,1
2604,Joel Ward,35,30,23,12,0,16,28,57.1,12,27,11,16,28,76,0
2605,Stephen Ward,39,31,27,8,4,20,42,47.6,22,27,12,15,42,126,0
2606,James Ward-Prowse,23,16,9,11,3,3,27,11.1,24,29,1,28,8,31,0
2607,Daniel Wass,30,21,8,18,4,8,25,32.0,17,23,3,20,30,47,0
2608,Ben Watson,19,9,9,9,1,10,31,32.3,21,6,1,5,7,10,0
2609,Timothy Weah,1,1,1,0,0,1,1,100.0,0,0,0,0,0,0,0
2610,Roman Weidenfeller,0,0,0,0,0,0,0,,0,0,0,0,0,0,1
2611,Julian Weigl,69,49,20,42,7,42,66,63.6,24,26,6,20,34,29,2
2612,Mitchell Weiser,54,43,20,27,7,17,38,44.7,21,28,1,27,44,37,1
2613,Danny Welbeck,20,13,9,5,6,4,12,33.3,8,22,1,21,11,13,0
2614,Nahki Wells,4,3,0,3,1,1,1,100.0,0,2,0,2,0,0,0
2615,Wendell,54,41,29,20,5,32,58,55.2,26,44,8,36,28,58,0
2616,Oscar Wendt,54,40,31,19,4,30,45,66.7,15,46,12,34,27,71,0
2617,Axel Werner,0,0,0,0,0,0,0,,0,0,0,0,0,1,0
2618,Timo Werner,16,11,2,8,6,3,19,15.8,16,26,0,26,7,11,0
2619,Ashley Westwood,13,10,10,3,0,2,16,12.5,14,17,9,8,19,16,0
2620,Dean Whitehead,0,0,0,0,0,0,1,0.0,1,1,0,1,2,0,0
2621,Silvan Widmer,45,32,30,15,0,22,40,55.0,18,22,5,17,28,59,0
2622,Georginio Wijnaldum,34,23,13,16,5,11,23,47.8,12,20,2,18,25,20,0
2623,Jetro Willems,55,42,28,23,4,27,42,64.3,15,31,1,30,20,53,0
2624,William,76,61,43,26,7,46,86,53.5,40,41,6,35,46,65,1
2625,Ashley Williams,23,13,17,6,0,9,18,50.0,9,31,23,8,36,173,3
2626,Danny Williams,23,14,13,9,1,7,22,31.8,15,12,2,10,26,27,0
2627,Iñaki Williams,28,17,11,15,2,8,41,19.5,33,24,2,22,17,13,0
2628,Willian,22,17,7,12,3,0,16,0.0,16,13,1,12,10,10,0
2629,Joe Willock,4,2,4,0,0,1,1,100.0,0,3,0,3,1,2,0
2630,Jack Wilshere,15,10,3,7,5,4,20,20.0,16,10,2,8,8,5,0
2631,Callum Wilson,9,5,2,6,1,1,14,7.1,13,15,3,12,3,15,0
2632,Kevin Wimmer,24,17,17,7,0,9,20,45.0,11,25,12,13,30,88,0
2633,Harry Winks,15,12,8,5,2,8,16,50.0,8,12,2,10,11,10,1
2634,Marius Wolf,37,28,15,18,4,18,46,39.1,28,45,1,44,27,46,0
2635,Bobby Wood,13,8,2,4,7,3,9,33.3,6,4,0,4,2,13,0
2636,Chris Wood,7,3,2,3,2,3,13,23.1,10,12,4,8,0,16,0
2637,Ben Woodburn,0,0,0,0,0,0,0,,0,0,0,0,0,0,0
2638,Xeka,25,14,10,11,4,10,38,26.3,28,13,2,11,16,21,0
2639,Xeka,1,0,1,0,0,0,0,,0,1,0,1,1,0,0
2640,Granit Xhaka,78,57,35,40,3,26,69,37.7,43,30,9,21,37,68,4
2641,Claudio Yacob,36,27,23,13,0,13,27,48.1,14,14,6,8,16,25,2
2642,Steeve Yago,49,36,28,17,4,20,37,54.1,17,16,7,9,34,64,1
2643,Cédric Yamberé,58,42,46,12,0,16,34,47.1,18,24,16,8,54,138,5
2644,Jawad El Yamiq,8,5,7,1,0,6,8,75.0,2,11,5,6,5,22,1
2645,Mapou Yanga-Mbiwa,3,2,3,0,0,1,1,100.0,0,0,0,0,1,2,0
2646,Andriy Yarmolenko,17,12,6,6,5,7,16,43.8,9,4,0,4,7,4,0
2647,DeAndre Yedlin,57,33,39,14,4,26,54,48.1,28,37,7,30,44,114,0
2648,Yoel,0,0,0,0,0,0,0,,0,0,0,0,0,2,0
2649,Maya Yoshida,27,20,22,5,0,18,25,72.0,7,32,14,18,41,133,2
2650,Ashley Young,53,32,30,17,6,18,47,38.3,29,24,5,19,57,86,1
2651,Zaydou Youssouf,3,1,2,1,0,1,2,50.0,1,1,0,1,1,1,0
2652,Pablo Zabaleta,96,67,54,28,14,48,98,49.0,50,72,13,59,61,152,0
2653,Mattia Zaccagni,7,5,4,0,3,2,3,66.7,1,0,0,0,5,0,0
2654,Dan-Axel Zagadou,9,8,5,3,1,6,7,85.7,1,9,0,9,11,20,1
2655,Wilfried Zaha,30,23,9,13,8,4,23,17.4,19,24,0,24,7,4,0
2656,Denis Zakaria,74,48,38,32,4,40,61,65.6,21,52,9,43,45,40,1
2657,Joseba Zaldúa,68,52,31,31,6,39,62,62.9,23,28,5,23,61,85,0
2658,Andre-Frank Zambo Anguissa,88,65,23,57,8,32,94,34.0,62,50,7,43,67,46,3
2659,Francesco Zampano,9,7,5,3,1,5,10,50.0,5,4,0,4,6,7,0
2660,Niccolò Zanellato,3,2,0,3,0,1,2,50.0,1,3,0,3,0,0,0
2661,Cristián Zapata,25,20,21,4,0,15,16,93.8,1,12,6,6,15,50,1
2662,Duván Zapata,12,7,1,7,4,1,6,16.7,5,13,0,13,5,22,1
2663,Davide Zappacosta,26,11,14,9,3,11,25,44.0,14,11,2,9,6,26,0
2664,Davide Zappacosta,1,0,1,0,0,0,0,,0,0,0,0,2,1,0
2665,Simone Zaza,21,14,4,10,7,1,20,5.0,19,26,1,25,8,34,0
2666,Marvin Zeegelaar,23,18,15,3,5,11,24,45.8,13,5,1,4,20,30,0
2667,Mehdi Zeffane,17,12,10,5,2,9,25,36.0,16,10,2,8,12,44,0
2668,Rafik Zekhnini,0,0,0,0,0,0,0,,0,0,0,0,0,0,0
2669,Erwin Zelazny,1,1,1,0,0,1,2,50.0,1,0,0,0,2,10,1
2670,Robin Zentner,0,0,0,0,0,0,1,0.0,1,0,0,0,1,10,2
2671,Nabil El Zhar,11,6,4,6,1,3,18,16.7,15,14,1,13,18,3,0
2672,Enzo Zidane,2,2,2,0,0,0,0,,0,0,0,0,0,1,0
2673,Luca Zidane,0,0,0,0,0,0,1,0.0,1,0,0,0,0,0,0
2674,Ron-Robert Zieler,1,1,1,0,0,1,1,100.0,0,2,0,2,1,14,5
2675,Piotr Zieliński,31,19,7,21,3,9,24,37.5,15,32,3,29,13,19,1
2676,Matthias Zimmermann,3,1,2,1,0,3,4,75.0,1,0,0,0,1,5,1
2677,Oleksandr Zinchenko,23,16,11,9,3,7,13,53.8,6,3,0,3,6,7,0
2678,Kévin Zohi,0,0,0,0,0,0,0,,0,0,0,0,0,0,0
2679,Simon Zoller,11,7,3,6,2,7,10,70.0,3,5,2,3,8,9,0
2680,Kurt Zouma,50,38,35,13,2,21,28,75.0,7,42,23,19,61,246,2
2681,Igor Zubeldia,39,29,17,16,6,14,42,33.3,28,20,5,15,32,31,0
2682,Steven Zuber,40,30,22,13,5,26,41,63.4,15,18,3,15,17,27,0
2683,Bruno Zuculini,68,49,37,28,3,20,48,41.7,28,35,8,27,38,31,0
2684,Franco Zuculini,11,8,5,5,1,5,14,35.7,9,4,0,4,5,6,1
2685,Ervin Zukanović,50,41,33,16,1,20,51,39.2,31,32,19,13,48,175,0
2686,Robert Žulj,3,3,1,2,0,1,1,100.0,0,3,0,3,0,2,0
2687,Bongani Zungu,54,37,21,26,7,24,56,42.9,32,30,5,25,38,41,2
2688,David Zurutuza,49,36,22,25,2,20,49,40.8,29,32,10,22,41,24,1
2689,Filip Đuričić,22,14,11,8,3,5,9,55.6,4,7,1,6,9,5,0
2690,Filip Đuričić,0,0,0,0,0,0,1,0.0,1,0,0,0,0,0,0
2691,Christian Rutjens,,,,,,,,,,,,,,,
