,Player,Tkl,TklW,Def 3rd,Mid 3rd,Att 3rd,TklDribblers,Att,Tkl%,Lost,Blocks,Sh,Pass,Int,Clr,Err
0,Brenden Aaronson,45,18,16,22,7,15,46,32.6,31,43,3,40,5,6,1
1,Paxten Aaronson,6,5,2,2,2,2,3,66.7,1,2,1,1,0,2,0
2,James Abankwah,1,1,0,1,0,0,0,,0,4,2,2,0,5,0
3,George Abbott,0,0,0,0,0,0,0,,0,0,0,0,1,0,0
4,Yunis Abdelhamid,82,50,47,33,2,39,52,75.0,13,65,27,38,64,116,1
5,Himad Abdelli,64,38,22,32,10,31,67,46.3,36,30,1,29,28,15,0
6,Salis Abdul Samed,46,26,18,23,5,29,52,55.8,23,38,9,29,36,26,0
7,Laurent Abergel,92,52,59,30,3,39,92,42.4,53,47,8,39,34,39,0
8,Oliver Abildgaard,10,6,6,3,1,7,16,43.8,9,7,1,6,5,17,0
9,Matthis Abline,4,2,0,3,1,0,5,0.0,5,6,1,5,1,1,0
10,Matthis Abline,1,1,0,0,1,1,1,100.0,0,1,0,1,2,1,0
11,Abner,12,9,9,2,1,7,16,43.8,9,8,2,6,8,24,0
12,Zakaria Aboukhlal,33,23,13,9,11,14,45,31.1,31,18,1,17,22,23,0
13,Tammy Abraham,17,10,4,8,5,3,16,18.8,13,10,4,6,3,14,0
14,Christian Acella,1,0,1,0,0,0,2,0.0,2,0,0,0,0,0,0
15,Francesco Acerbi,33,19,22,7,4,20,27,74.1,7,25,18,7,41,85,2
16,Álvaro Aceves,0,0,0,0,0,0,0,,0,0,0,0,0,0,0
17,Mohamed Achi,1,1,1,0,0,1,1,100.0,0,0,0,0,0,0,0
18,Marcos Acuña,57,36,34,17,6,30,42,71.4,12,16,5,11,23,36,0
19,Che Adams,17,13,7,8,2,7,12,58.3,5,13,4,9,4,22,0
20,Tyler Adams,89,46,44,35,10,50,77,64.9,27,48,8,40,35,29,0
21,Sargis Adamyan,14,7,5,3,6,7,17,41.2,10,12,0,12,4,5,0
22,Tosin Adarabioyo,30,13,22,6,2,16,23,69.6,7,20,15,5,26,140,1
23,Martin Adeline,3,3,2,1,0,3,4,75.0,1,3,1,2,3,3,0
24,Karim Adeyemi,16,11,6,6,4,8,30,26.7,22,18,1,17,7,3,0
25,Amine Adli,18,10,4,6,8,5,17,29.4,12,28,2,26,6,7,0
26,Yacine Adli,6,3,2,4,0,2,2,100.0,0,2,0,2,1,1,0
27,Michel Aebischer,12,6,3,6,3,2,18,11.1,16,14,2,12,7,9,0
28,Felix Afena-Gyan,7,3,4,1,2,2,10,20.0,8,5,1,4,1,6,0
29,Emmanuel Agbadou,71,49,53,16,2,42,65,64.6,23,30,14,16,32,107,3
30,Julen Agirrezabala,0,0,0,0,0,0,0,,0,0,0,0,0,2,0
31,Lucien Agoume,42,25,18,15,9,17,33,51.5,16,14,5,9,27,24,0
32,Felix Agu,1,0,0,1,0,0,0,,0,1,1,0,0,0,0
33,Álvaro Aguado,27,15,13,11,3,15,25,60.0,10,16,4,12,13,15,0
34,Kevin Agudelo,71,38,22,30,19,25,59,42.4,34,39,5,34,10,6,0
35,Nayef Aguerd,27,18,18,8,1,13,20,65.0,7,26,24,2,18,79,2
36,Ruben Aguilar,19,9,7,7,5,8,22,36.4,14,13,1,12,18,28,1
37,Naouirou Ahamada,3,2,3,0,0,1,3,33.3,2,2,0,2,0,0,0
38,Naouirou Ahamada,17,11,7,7,3,8,20,40.0,12,16,5,11,8,7,0
39,Amar Ahmed,1,1,0,1,0,0,1,0.0,1,0,0,0,1,0,0
40,Jean-Eudes Aholou,34,20,10,20,4,12,31,38.7,19,25,0,25,24,15,0
41,Joseph Aidoo,51,36,33,17,1,16,28,57.1,12,26,14,12,31,150,0
42,Ola Aina,17,13,5,8,4,9,15,60.0,6,12,2,10,11,26,0
43,Rayan Aït-Nouri,33,20,25,7,1,9,16,56.3,7,3,0,3,9,28,0
44,Emanuel Aiwum,55,34,36,17,2,33,47,70.2,14,28,16,12,25,52,3
45,Kristoffer Ajer,11,8,5,4,2,9,16,56.3,7,6,5,1,7,22,0
46,Ludovic Ajorque,5,4,1,4,0,3,9,33.3,6,3,1,2,2,7,0
47,Ludovic Ajorque,6,5,1,4,1,1,9,11.1,8,8,2,6,1,8,0
48,Manuel Akanji,36,25,15,18,3,23,36,63.9,13,27,9,18,16,33,1
49,Nathan Aké,26,12,15,9,2,11,15,73.3,4,20,10,10,20,48,0
50,Sergio Akieme,27,16,19,6,2,12,22,54.5,10,22,6,16,14,41,0
51,Babatunde Akinsola,1,1,0,0,1,0,0,,0,0,0,0,0,0,0
52,Maghnes Akliouche,7,4,4,3,0,2,8,25.0,6,2,0,2,3,2,0
53,Paul Akouokou,16,9,13,3,0,13,20,65.0,7,2,2,0,12,17,1
54,Jean-Daniel Akpa-Akpro,53,37,25,19,9,23,42,54.8,19,35,4,31,13,27,0
55,Kevin Akpoguma,75,44,45,27,3,32,45,71.1,13,45,16,29,24,70,1
56,David Alaba,15,11,8,4,3,9,15,60.0,6,18,9,9,14,37,1
57,Ángel Alarcón,,0,,,,,,,,,,,0,,
58,Tomás Alarcón,3,2,0,2,1,1,2,50.0,1,1,0,1,2,2,0
59,Lucas Alario,3,2,1,0,2,0,1,0.0,1,0,0,0,2,13,0
60,Jordi Alba,25,18,13,11,1,12,28,42.9,16,12,5,7,11,23,0
61,Luis Alberto,49,29,18,20,11,23,72,31.9,49,35,6,29,9,4,0
62,Raúl Albiol,25,17,17,6,2,14,18,77.8,4,17,13,4,14,111,0
63,Marc Albrighton,4,1,0,2,2,1,8,12.5,7,6,2,4,1,5,0
64,Thiago Alcántara,43,24,20,21,2,14,23,60.9,9,15,3,12,21,13,2
65,Carlos Alcaraz,10,5,2,7,1,6,22,27.3,16,14,5,9,1,11,0
66,Rubén Alcaraz,43,31,24,18,1,19,54,35.2,35,23,8,15,19,37,0
67,Omar Alderete,35,20,21,14,0,28,40,70.0,12,23,16,7,26,85,0
68,Iván Alejo,32,21,19,9,4,17,37,45.9,20,18,3,15,5,12,1
69,Doğan Alemdar,0,0,0,0,0,0,0,,0,0,0,0,0,1,1
70,Carles Aleñá,18,10,7,5,6,5,34,14.7,29,19,1,18,4,18,0
71,Trent Alexander-Arnold,57,40,32,16,9,42,80,52.5,38,25,7,18,43,41,2
72,Alejandro Alfaro,0,0,0,0,0,0,0,,0,0,0,0,0,0,0
73,Ángel Algobia,27,13,14,13,0,22,48,45.8,26,15,5,10,3,11,0
74,Mohamed Ali Cho,13,10,6,5,2,4,10,40.0,6,9,0,9,2,2,0
75,Faride Alidou,8,5,3,4,1,3,9,33.3,6,3,0,3,1,3,0
76,Alisson,0,0,0,0,0,0,3,0.0,3,3,0,3,0,20,0
77,Jim Allevinah,39,24,24,11,4,19,62,30.6,43,24,2,22,24,26,1
78,Dele Alli,0,0,0,0,0,0,0,,0,0,0,0,0,0,0
79,Domingos André Ribeiro Almeida,66,42,23,32,11,26,57,45.6,31,26,0,26,20,16,1
80,Miguel Almirón,46,30,16,19,11,18,42,42.9,24,25,2,23,10,17,0
81,Marcos Alonso,15,10,10,5,0,9,12,75.0,3,14,10,4,11,32,0
82,Mickaël Alphonse,35,23,20,11,4,20,33,60.6,13,17,5,12,35,44,1
83,Éder Álvarez Balanta,5,4,2,3,0,2,6,33.3,4,0,0,0,3,4,0
84,Carlos Álvarez,1,1,0,1,0,0,0,,0,0,0,0,0,0,0
85,Gastón Álvarez,38,30,24,9,5,23,42,54.8,19,15,5,10,15,35,0
86,Julián Álvarez,26,16,3,13,10,9,30,30.0,21,13,0,13,2,6,0
87,Agustín Álvarez Martínez,6,3,0,5,1,1,4,25.0,3,5,1,4,3,3,0
88,Yeray Álvarez,34,23,26,7,1,24,31,77.4,7,23,13,10,48,101,0
89,Ibrahim Amadou,10,7,6,3,1,7,11,63.6,4,7,3,4,10,20,0
90,Selim Amallah,15,9,7,8,0,5,8,62.5,3,2,0,2,5,2,0
91,Daniel Amartey,19,8,13,5,1,12,14,85.7,2,24,17,7,8,71,0
92,Amath,29,19,14,8,7,14,22,63.6,8,13,1,12,5,5,0
93,Jordan Amavi,3,2,3,0,0,1,3,33.3,2,3,0,3,4,7,0
94,Lukáš Ambros,1,0,1,0,0,1,4,25.0,3,1,0,1,0,2,1
95,Kelvin Amian,54,32,33,12,9,24,31,77.4,7,34,12,22,22,87,1
96,Bruno Amione,1,1,1,0,0,1,2,50.0,1,1,0,1,0,4,0
97,Bruno Amione,50,33,36,14,0,19,43,44.2,24,26,11,15,25,62,1
98,Nadiem Amiri,15,6,5,8,2,9,20,45.0,11,12,1,11,6,10,2
99,Samuel Amo-Ameyaw,0,0,0,0,0,0,1,0.0,1,0,0,0,0,0,0
100,Ethan Ampadu,66,37,33,28,5,17,41,41.5,24,48,23,25,36,98,0
101,Sofyan Amrabat,39,24,15,17,7,16,29,55.2,13,23,5,18,21,18,2
102,Ayoub Amraoui,6,5,3,3,0,2,5,40.0,3,1,0,1,4,4,0
103,Joachim Andersen,42,22,30,12,0,16,32,50.0,16,28,13,15,24,188,1
104,Elliot Anderson,11,5,5,3,3,6,12,50.0,6,11,2,9,6,2,0
105,Felipe Anderson,80,50,31,41,8,31,88,35.2,57,58,6,52,31,27,0
106,Benjamin André,128,74,51,60,17,65,121,53.7,56,50,8,42,47,60,0
107,Marcos André,4,1,1,1,2,1,2,50.0,1,4,1,3,0,0,0
108,Komnen Andrić,13,5,2,7,4,2,15,13.3,13,8,1,7,8,13,0
109,Robert Andrich,61,38,30,27,4,26,45,57.8,19,27,9,18,42,55,2
110,Angeliño,40,24,19,18,3,23,37,62.2,14,32,6,26,25,67,0
111,Fabrizio Angileri,12,9,8,3,1,10,17,58.8,7,8,3,5,7,10,0
112,Jaidon Anthony,30,17,15,9,6,8,24,33.3,16,30,3,27,10,19,0
113,Janis Antiste,1,0,1,0,0,1,1,100.0,0,0,0,0,0,0,0
114,Waldemar Anton,49,27,27,19,3,27,51,52.9,24,44,16,28,38,123,2
115,Josep Antoni Gayá,0,0,0,0,0,0,0,,0,4,2,2,1,6,0
116,José Antonio,2,1,0,0,2,0,0,,0,0,0,0,0,0,0
117,Marcos Antônio,9,6,4,5,0,9,20,45.0,11,7,2,5,11,18,0
118,Michail Antonio,14,7,1,8,5,3,12,25.0,9,13,5,8,5,9,0
119,Antony,22,9,9,9,4,8,28,28.6,20,18,0,18,11,6,0
120,Valentin Antov,6,5,3,3,0,1,5,20.0,4,5,4,1,4,14,1
121,Christopher Antwi-Adjei,23,15,7,8,8,10,29,34.5,19,17,0,17,5,16,0
122,Anuar,4,4,0,1,3,0,0,,0,5,2,3,3,3,0
123,Houssem Aouar,12,5,5,5,2,3,9,33.3,6,12,2,10,8,3,0
124,Adil Aouchiche,5,2,3,1,1,1,9,11.1,8,1,0,1,4,1,0
125,Dennis Appiah,21,11,14,7,0,10,27,37.0,17,13,5,8,10,16,0
126,Stredair Appuah,2,1,0,2,0,0,0,,0,2,0,2,1,0,0
127,Mauro Arambarri,14,6,9,4,1,3,17,17.6,14,17,5,12,14,19,0
128,Charles Aránguiz,17,7,7,10,0,12,20,60.0,8,4,0,4,7,4,0
129,Ronald Araújo,26,18,12,13,1,6,9,66.7,3,15,7,8,12,41,1
130,Cameron Archer,0,0,0,0,0,0,0,,0,0,0,0,0,0,0
131,Taïryk Arconte,1,1,0,0,1,0,3,0.0,3,1,0,1,0,2,0
132,Alphonse Areola,0,0,0,0,0,0,0,,0,0,0,0,0,0,0
133,Adu Ares,4,2,2,1,1,4,4,100.0,0,1,0,1,2,1,0
134,Joe Aribo,31,20,15,12,4,11,20,55.0,9,14,1,13,10,11,0
135,Adam Armstrong,14,9,6,5,3,3,10,30.0,7,15,3,12,5,6,0
136,Stuart Armstrong,32,21,15,13,4,14,39,35.9,25,18,0,18,10,9,2
137,Marko Arnautović,9,6,2,5,2,1,6,16.7,5,11,1,10,2,10,0
138,Maximilian Arnold,62,31,25,28,9,28,54,51.9,26,34,11,23,26,65,2
139,Mohamed El Arouch,1,1,1,0,0,0,0,,0,0,0,0,0,0,0
140,Sergio Arribas,0,0,0,0,0,0,0,,0,1,0,1,0,0,0
141,Kepa Arrizabalaga,2,2,2,0,0,2,3,66.7,1,0,0,0,1,16,2
142,Roberto Arroyo,1,1,0,1,0,1,1,100.0,0,0,0,0,0,0,0
143,Tolgay Arslan,29,18,13,15,1,14,39,35.9,25,19,0,19,12,9,1
144,Ricard Artero,3,3,2,1,0,1,1,100.0,0,2,0,2,1,3,0
145,Santiago Arzamendia,9,8,7,1,1,6,21,28.6,15,11,1,10,2,15,1
146,Takuma Asano,14,9,4,4,6,7,16,43.8,9,17,1,16,8,8,0
147,Santiago Ascacíbar,29,14,17,10,2,14,35,40.0,21,14,2,12,13,11,0
148,Sergio Asenjo,0,0,0,0,0,0,0,,0,0,0,0,0,10,2
149,Marco Asensio,16,10,8,6,2,8,19,42.1,11,8,3,5,5,4,0
150,Kristoffer Askildsen,7,3,2,3,2,4,10,40.0,6,15,4,11,11,6,0
151,Fisnik Asllani,0,0,0,0,0,0,4,0.0,4,2,0,2,3,3,0
152,Kristjan Asllani,11,5,1,8,2,7,10,70.0,3,3,1,2,6,4,0
153,Iago Aspas,8,4,0,4,4,3,22,13.6,19,10,1,9,7,23,0
154,Lorenz Assignon,6,2,4,2,0,2,4,50.0,2,6,0,6,2,9,0
155,Youcef Atal,38,22,18,15,5,23,32,71.9,9,9,0,9,14,13,0
156,Valentin Atangana Edoa,8,3,4,2,2,3,6,50.0,3,2,1,1,0,1,0
157,Pierre-Emerick Aubameyang,1,0,1,0,0,0,1,0.0,1,2,0,2,2,4,2
158,Pierre-Emerick Aubameyang,0,0,0,0,0,0,0,,0,0,0,0,0,0,0
159,Emil Audero,0,0,0,0,0,0,2,0.0,2,0,0,0,0,7,1
160,Tommaso Augello,17,14,13,2,2,9,20,45.0,11,23,7,16,17,61,1
161,Ludwig Augustinsson,1,1,1,0,0,0,0,,0,0,0,0,0,1,0
162,Ludwig Augustinsson,2,1,2,0,0,1,3,33.3,2,1,0,1,1,3,0
163,Carlos Augusto,73,38,42,23,8,33,54,61.1,21,24,6,18,24,85,1
164,Serge Aurier,64,41,41,18,5,23,33,69.7,10,34,11,23,29,75,0
165,Mathias Autret,22,10,10,10,2,7,16,43.8,9,14,2,12,12,13,0
166,Ezequiel Ávila,8,5,2,4,2,6,23,26.1,17,12,1,11,8,16,0
167,Cédric Avinel,13,7,8,5,0,8,12,66.7,4,20,13,7,15,91,1
168,Taiwo Awoniyi,17,10,2,10,5,6,12,50.0,6,18,4,14,4,20,0
169,Yasin Ayari,2,2,1,1,0,0,4,0.0,4,1,0,1,0,0,0
170,Mehmet Aydin,25,18,14,9,2,11,24,45.8,13,11,0,11,10,15,0
171,André Ayew,5,3,0,4,1,2,4,50.0,2,6,1,5,0,7,0
172,Jordan Ayew,66,41,23,20,23,21,53,39.6,32,35,4,31,15,31,0
173,Kaan Ayhan,10,4,6,4,0,7,7,100.0,0,5,4,1,5,26,1
174,Luke Ayling,66,37,42,15,9,42,85,49.4,43,34,11,23,26,52,2
175,Ayman Azhil,0,0,0,0,0,0,0,,0,0,0,0,0,0,0
176,Sardar Azmoun,6,3,1,4,1,1,7,14.3,6,4,0,4,2,14,0
177,César Azpilicueta,43,25,23,15,5,22,37,59.5,15,26,5,21,19,54,1
178,Sanoussy Ba,0,0,0,0,0,0,0,,0,0,0,0,0,0,0
179,Iddrisu Baba,31,17,15,16,0,15,32,46.9,17,18,8,10,11,39,0
180,Srđan Babić,28,18,20,8,0,15,32,46.9,17,34,22,12,29,124,1
181,Loïc Bade,27,20,23,3,1,17,30,56.7,13,21,13,8,23,77,0
182,Loïc Bade,1,1,1,0,0,0,0,,0,0,0,0,1,3,0
183,Édgar Badía,1,0,1,0,0,1,2,50.0,1,0,0,0,0,19,3
184,Benoît Badiashile,14,8,10,4,0,9,14,64.3,5,5,2,3,16,34,1
185,Benoît Badiashile,10,8,6,4,0,5,10,50.0,5,9,6,3,17,40,1
186,Alex Baena,30,17,9,15,6,15,45,33.3,30,15,3,12,7,16,0
187,Jaime Báez,4,2,3,0,1,3,6,50.0,3,0,0,0,0,2,1
188,Leon Bailey,14,6,6,7,1,5,20,25.0,15,13,0,13,6,12,0
189,Eric Bailly,13,10,6,6,1,7,7,100.0,0,15,12,3,12,18,1
190,Dénys Bain,4,3,3,1,0,1,2,50.0,1,2,1,1,2,4,0
191,Brandon Baiye,3,2,2,1,0,2,3,66.7,1,1,0,1,1,3,0
192,Stefan Bajcetic,9,6,5,3,1,8,27,29.6,19,7,0,7,9,4,0
193,Nedim Bajrami,8,4,3,3,2,4,6,66.7,2,5,0,5,7,4,0
194,Nedim Bajrami,12,7,6,2,4,5,11,45.5,6,9,1,8,7,6,0
195,Cédric Bakambu,2,1,2,0,0,2,2,100.0,0,0,0,0,0,0,0
196,Tiemoué Bakayoko,5,5,4,1,0,3,3,100.0,0,0,0,0,0,0,1
197,Mitchel Bakker,16,8,9,7,0,6,15,40.0,9,20,2,18,15,20,2
198,Ridle Baku,50,26,29,17,4,32,58,55.2,26,44,6,38,21,59,0
199,Tommaso Baldanzi,25,12,9,13,3,7,32,21.9,25,21,1,20,2,5,0
200,Alejandro Balde,42,30,22,16,4,24,41,58.5,17,25,3,22,12,17,1
201,Thierno Balde,27,14,19,4,4,18,30,60.0,12,15,3,12,23,39,0
202,Carlos Baleba,13,11,2,9,2,9,14,64.3,5,13,3,10,1,3,2
203,Mikel Balenziaga,4,4,1,2,1,4,4,100.0,0,0,0,0,1,2,0
204,Leonardo Balerdi,57,37,43,12,2,32,45,71.1,13,48,29,19,63,91,1
205,Dominic Ballard,0,0,0,0,0,0,0,,0,0,0,0,1,0,0
206,Iván Balliu,52,29,26,20,6,18,30,60.0,12,26,3,23,25,72,1
207,Fodé Ballo-Touré,14,9,7,6,1,7,10,70.0,3,11,3,8,2,3,0
208,Folarin Balogun,9,5,1,5,3,2,20,10.0,18,20,1,19,3,15,0
209,Abdoulaye Bamba,22,12,15,5,2,16,19,84.2,3,7,3,4,18,38,0
210,Jonathan Bamba,37,17,12,14,11,14,45,31.1,31,36,1,35,22,14,0
211,Patrick Bamford,9,6,0,6,3,4,20,20.0,16,12,5,7,5,13,0
212,Lameck Banda,30,20,13,14,3,15,41,36.6,26,24,2,22,8,5,0
213,Filippo Bandinelli,55,34,19,26,10,17,45,37.8,28,20,7,13,18,40,0
214,Léo Baptistão,32,20,13,16,3,13,33,39.4,20,17,2,15,19,12,0
215,Shandon Baptiste,15,9,6,6,3,7,17,41.2,10,10,2,8,7,10,0
216,Antonín Barák,0,0,0,0,0,0,0,,0,0,0,0,0,0,0
217,Antonín Barák,21,9,5,7,9,6,16,37.5,10,16,2,14,3,13,0
218,Andrea Barberis,7,2,4,3,0,5,11,45.5,6,0,0,0,8,1,0
219,Tommaso Barbieri,3,3,3,0,0,3,8,37.5,5,3,0,3,0,2,0
220,Bradley Barcola,25,16,8,10,7,8,39,20.5,31,29,0,29,19,10,0
221,Melvin Bard,96,60,61,29,6,59,89,66.3,30,35,4,31,64,40,1
222,Francesco Bardi,0,0,0,0,0,0,0,,0,0,0,0,0,0,0
223,Keidi Bare,15,8,7,5,3,7,13,53.8,6,8,2,6,11,8,0
224,Nicolò Barella,49,25,17,26,6,28,53,52.8,25,29,5,24,12,12,0
225,Kike Barja,15,9,6,5,4,8,24,33.3,16,7,0,7,4,3,0
226,Ross Barkley,16,9,7,4,5,7,13,53.8,6,7,2,5,8,6,0
227,Aymen Barkok,18,8,10,5,3,5,10,50.0,5,7,0,7,3,9,0
228,Harvey Barnes,26,14,8,14,4,14,42,33.3,28,32,1,31,8,12,0
229,Leandro Barreiro Martins,60,38,19,28,13,22,49,44.9,27,38,13,25,41,39,1
230,Enzo Barrenechea,8,3,3,4,1,3,5,60.0,2,3,0,3,2,3,0
231,Ander Barrenetxea,21,15,15,6,0,12,28,42.9,16,15,1,14,5,7,0
232,Mickaël Barreto,32,20,12,17,3,8,45,17.8,37,17,0,17,18,11,0
233,Pablo Barrios,19,10,3,10,6,8,15,53.3,7,12,2,10,9,6,1
234,Musa Barrow,21,4,10,6,5,8,14,57.1,6,25,1,24,1,7,0
235,Federico Baschirotto,40,30,35,5,0,22,36,61.1,14,45,29,16,36,192,0
236,Toma Bašić,6,4,4,1,1,3,8,37.5,5,9,0,9,7,8,0
237,Alberto Basso,0,0,0,0,0,0,0,,0,0,0,0,0,0,0
238,Gil Bastião Dias,8,6,3,4,1,3,12,25.0,9,7,0,7,2,3,0
239,Alessandro Bastoni,41,20,20,14,7,11,27,40.7,16,27,13,14,24,45,0
240,Simone Bastoni,47,24,23,19,5,15,33,45.5,18,20,5,15,8,14,0
241,Rodrigo Battaglia,12,5,7,5,0,6,14,42.9,8,16,7,9,5,18,0
242,Maximilian Bauer,31,17,18,12,1,17,34,50.0,17,25,9,16,23,79,1
243,Oliver Baumann,0,0,0,0,0,0,0,,0,0,0,0,0,15,1
244,Timo Baumgartl,11,6,5,4,2,5,18,27.8,13,12,4,8,2,14,0
245,Julian Baumgartlinger,15,4,5,6,4,6,19,31.6,13,4,2,2,4,15,0
246,Christoph Baumgartner,36,19,12,17,7,9,52,17.3,43,57,5,52,15,19,1
247,Cyrille Bayala,53,37,16,20,17,23,48,47.9,25,20,3,17,25,21,0
248,Brian Bayeye,3,0,3,0,0,1,1,100.0,0,1,1,0,1,2,0
249,Noah Joel Sarenren Bazee,0,0,0,0,0,0,1,0.0,1,1,0,1,0,0,0
250,Gavin Bazunu,1,0,1,0,0,1,1,100.0,0,0,0,0,1,24,2
251,Bebé,0,0,0,0,0,0,2,0.0,2,1,0,1,0,0,0
252,Ihlas Bebou,19,16,8,7,4,11,17,64.7,6,9,2,7,7,15,0
253,Rodrigo Becão,70,36,50,17,3,40,53,75.5,13,44,24,20,26,68,2
254,Mads Bech Sørensen,0,0,0,0,0,0,0,,0,0,0,0,1,1,0
255,Julius Beck,2,1,1,1,0,0,0,,0,0,0,0,0,0,0
256,Sheraldo Becker,15,5,1,7,7,2,11,18.2,9,13,1,12,3,7,1
257,Jan Bednarek,27,21,20,7,0,12,16,75.0,4,38,27,11,49,87,0
258,Jan Bednarek,3,3,0,3,0,1,1,100.0,0,3,1,2,2,5,0
259,Donny van de Beek,0,0,0,0,0,0,1,0.0,1,2,1,1,1,1,0
260,Asmir Begović,0,0,0,0,0,0,0,,0,0,0,0,0,1,0
261,Yanis Begraoui,2,0,1,0,1,1,2,50.0,1,0,0,0,1,0,0
262,Kevin Behrens,11,7,4,4,3,4,18,22.2,14,18,3,15,5,25,0
263,Alexis Beka Beka,16,5,6,9,1,4,15,26.7,11,9,1,8,12,6,0
264,Jérémie Bela,6,4,2,1,3,3,4,75.0,1,10,1,9,9,8,0
265,Reda Belahyane,8,6,5,3,0,3,5,60.0,2,5,1,4,2,0,0
266,Youcef Belaïli,18,10,3,9,6,8,20,40.0,12,10,1,9,5,4,0
267,Youcef Belaïli,5,2,3,2,0,2,7,28.6,5,2,0,2,1,1,0
268,Haris Belkebla,80,48,35,40,5,44,85,51.8,41,32,6,26,52,21,3
269,Stefan Bell,43,28,32,10,1,22,44,50.0,22,42,15,27,44,133,0
270,Armel Bella Kotchap,37,17,28,9,0,15,20,75.0,5,29,12,17,44,110,0
271,Raoul Bellanova,14,6,11,2,1,9,14,64.3,5,6,1,5,4,14,0
272,Karim Bellarabi,2,0,1,1,0,2,3,66.7,1,0,0,0,0,0,0
273,Jean-Ricner Bellegarde,47,25,15,21,11,11,25,44.0,14,26,3,23,26,22,0
274,Héctor Bellerín,2,0,0,2,0,2,3,66.7,1,2,0,2,3,2,0
275,Jude Bellingham,76,42,28,34,14,34,51,66.7,17,51,4,47,35,30,0
276,Jeanuël Belocian,10,7,3,5,2,5,9,55.6,4,6,3,3,6,11,0
277,Andrea Belotti,12,5,3,5,4,5,11,45.5,6,11,1,10,3,5,0
278,Fran Beltrán,34,22,15,14,5,14,55,25.5,41,29,5,24,53,35,2
279,Eliesse Ben Seghir,18,10,4,12,2,4,12,33.3,8,18,1,17,4,1,0
280,Salim Ben Seghir,0,0,0,0,0,0,0,,0,1,0,1,0,0,0
281,Wissam Ben Yedder,16,9,2,5,9,4,13,30.8,9,15,0,15,4,0,0
282,Marco Benassi,3,3,2,0,1,3,4,75.0,1,0,0,0,1,1,0
283,Marco Benassi,26,15,9,11,6,15,24,62.5,9,13,1,12,12,19,0
284,Iker Benito,4,3,0,3,1,2,4,50.0,2,0,0,0,2,4,0
285,Ismaël Bennacer,59,33,26,31,2,30,51,58.8,21,25,7,18,26,16,1
286,Saïd Benrahma,25,15,11,7,7,11,27,40.7,16,23,1,22,9,13,0
287,Ramy Bensebaini,34,21,21,10,3,26,39,66.7,13,44,14,30,36,98,1
288,Nabil Bentaleb,74,40,31,35,8,36,61,59.0,25,33,11,22,44,29,3
289,Rodrigo Bentancur,45,28,15,21,9,16,28,57.1,12,28,15,13,20,22,0
290,Daniel Bentley,1,1,1,0,0,1,1,100.0,0,0,0,0,0,0,1
291,Karim Benzema,9,5,2,4,3,2,11,18.2,9,11,0,11,2,5,0
292,Domenico Berardi,23,14,8,10,5,9,40,22.5,31,13,0,13,19,18,0
293,Yuri Berchiche,56,32,28,20,8,35,59,59.3,24,37,12,25,40,59,1
294,Álex Berenguer,58,37,17,25,16,23,60,38.3,37,37,4,33,10,6,0
295,Bartosz Bereszyński,28,18,15,11,2,17,26,65.4,9,18,4,14,21,25,0
296,Bartosz Bereszyński,3,2,1,1,1,2,2,100.0,0,4,0,4,3,3,0
297,Patrick Berg,0,0,0,0,0,0,1,0.0,1,0,0,0,1,0,0
298,Mitchell van Bergen,18,8,6,7,5,8,20,40.0,12,8,2,6,6,11,0
299,Mergim Berisha,11,6,4,3,4,4,14,28.6,10,16,1,15,0,19,0
300,Quentin Bernard,9,7,4,2,3,7,15,46.7,8,9,1,8,15,17,0
301,Paul Bernardoni,2,0,2,0,0,2,3,66.7,1,1,0,1,1,12,1
302,Juan Bernat,32,16,18,9,5,21,39,53.8,18,11,2,9,9,22,1
303,Victor Bernth Kristiansen,38,23,18,16,4,22,30,73.3,8,16,4,12,3,26,1
304,Jason Berthomier,0,0,0,0,0,0,0,,0,0,0,0,0,0,0
305,Marco Bertini,0,0,0,0,0,0,0,,0,0,0,0,0,0,0
306,Beto,16,9,0,9,7,4,17,23.5,13,18,3,15,6,30,0
307,Owen Bevan,0,0,0,0,0,0,0,,0,0,0,0,0,0,0
308,Matteo Bianchetti,32,19,21,9,2,20,32,62.5,12,31,17,14,20,111,0
309,Alessandro Bianco,5,2,2,3,0,2,3,66.7,1,1,0,1,0,0,0
310,Giulian Biancone,2,1,2,0,0,1,1,100.0,0,0,0,0,1,0,0
311,Ermin Bičakčić,8,4,6,1,1,2,6,33.3,4,4,3,1,5,14,0
312,Pedro Bigas,37,20,30,7,0,18,29,62.1,11,25,14,11,33,95,0
313,Jaka Bijol,39,23,32,7,0,16,27,59.3,11,41,25,16,29,165,0
314,El Bilal Touré,4,3,2,1,1,0,3,0.0,3,6,1,5,1,23,0
315,El Bilal Touré,0,0,0,0,0,0,0,,0,2,0,2,0,1,0
316,Philip Billing,63,36,21,33,9,11,42,26.2,31,48,8,40,31,58,1
317,Jean-Claude Billong,0,0,0,0,0,0,0,,0,1,1,0,1,0,0
318,Cristiano Biraghi,65,38,29,29,7,32,65,49.2,33,32,7,25,14,42,1
319,Samuele Birindelli,35,19,21,10,4,18,29,62.1,11,28,8,20,16,30,0
320,Veljko Birmančević,13,7,5,4,4,7,21,33.3,14,12,2,10,7,1,0
321,Tom Bischof,15,10,8,3,4,7,10,70.0,3,5,1,4,1,1,0
322,Yves Bissouma,16,13,6,6,4,2,7,28.6,5,15,6,9,12,10,0
323,Kristijan Bistrović,3,1,3,0,0,0,5,0.0,5,3,0,3,0,4,0
324,Leonardo Bittencourt,53,28,20,25,8,25,62,40.3,37,13,0,13,10,15,0
325,Marco Bizot,0,0,0,0,0,0,1,0.0,1,1,0,1,0,24,4
326,Antonio Blanco,6,4,5,1,0,4,6,66.7,2,5,0,5,1,3,0
327,Lautaro Blanco,16,9,10,4,2,9,26,34.6,17,8,1,7,2,10,1
328,Rubén Blanco,0,0,0,0,0,0,0,,0,0,0,0,0,1,0
329,Ludovic Blas,47,30,17,19,11,17,49,34.7,32,26,1,25,19,8,0
330,Janis Blaswich,0,0,0,0,0,0,0,,0,0,0,0,0,10,0
331,Miha Blažič,8,6,8,0,0,7,15,46.7,8,25,19,6,22,80,1
332,Joaquín Blázquez,0,0,0,0,0,0,0,,0,0,0,0,0,2,0
333,Alexis Blin,69,39,27,33,9,38,73,52.1,35,55,15,40,34,74,0
334,Daley Blind,2,0,2,0,0,0,1,0.0,1,4,2,2,2,6,0
335,Myron Boadu,3,3,0,2,1,1,7,14.3,6,1,0,1,0,1,0
336,Jérôme Boateng,3,0,2,1,0,2,6,33.3,4,8,5,3,6,16,0
337,Kevin-Prince Boateng,8,6,4,2,2,3,9,33.3,6,11,3,8,3,5,0
338,Antonin Bobichon,0,0,0,0,0,0,0,,0,1,0,1,0,0,0
339,Jean-Paul Boëtius,30,16,19,9,2,8,25,32.0,17,25,5,20,14,10,0
340,Jeremie Boga,9,5,3,2,4,2,5,40.0,3,6,0,6,1,1,0
341,Emil Bohinen,25,13,15,8,2,12,23,52.2,11,25,7,18,17,21,0
342,Quentin Boisgard,6,2,1,4,1,3,4,75.0,1,3,1,2,4,2,0
343,Willy Boly,13,6,8,3,2,8,13,61.5,5,13,4,9,12,45,0
344,Giacomo Bonaventura,35,23,14,15,6,24,37,64.9,13,14,0,14,16,5,1
345,Federico Bonazzoli,5,3,0,3,2,0,9,0.0,9,9,1,8,3,0,0
346,Warren Bondo,1,0,1,0,0,0,0,,0,1,0,1,0,0,0
347,Theo Bongonda,28,20,11,14,3,17,40,42.5,23,21,2,19,6,14,0
348,Kevin Bonifazi,13,8,7,6,0,6,12,50.0,6,11,8,3,12,39,0
349,Leonardo Bonucci,5,4,1,4,0,2,4,50.0,2,12,8,4,13,29,0
350,Neto Borges,75,45,45,20,10,46,75,61.3,29,45,11,34,41,62,1
351,Yvandro Borges Sanches,2,2,0,2,0,2,2,100.0,0,0,0,0,0,0,0
352,Sebastiaan Bornauw,29,17,17,10,2,16,22,72.7,6,27,12,15,31,83,1
353,Rafael Borré,25,15,4,13,8,4,17,23.5,13,10,2,8,2,9,0
354,Erik Botheim,11,7,3,4,4,6,13,46.2,7,3,0,3,0,4,0
355,Sven Botman,38,24,31,7,0,22,28,78.6,6,44,24,20,34,126,2
356,Kenji-Van Boto,3,2,2,0,1,2,4,50.0,2,0,0,0,1,3,0
357,Kouamé Botué,4,2,2,1,1,0,2,0.0,2,1,0,1,0,1,0
358,Badredine Bouanani,13,9,2,7,4,7,14,50.0,7,4,0,4,1,2,0
359,Hicham Boudaoui,67,32,31,30,6,35,53,66.0,18,34,5,29,36,16,0
360,Franci Bouebari,3,0,1,2,0,3,5,60.0,2,0,0,0,2,2,0
361,Sofiane Boufal,14,9,7,4,3,3,14,21.4,11,6,0,6,5,1,0
362,Yassine Bounou,2,1,2,0,0,1,4,25.0,3,0,0,0,2,11,1
363,Ismaëlben Boura,6,4,4,2,0,5,6,83.3,1,2,1,1,2,3,0
364,Mehdi Bourabia,41,20,13,22,6,19,41,46.3,22,39,12,27,32,57,0
365,Benjamin Bourigeaud,45,29,16,23,6,21,65,32.3,44,38,3,35,31,32,0
366,Edoardo Bove,35,18,12,15,8,16,39,41.0,23,15,1,14,10,11,0
367,Jarrod Bowen,39,16,14,11,14,16,58,27.6,42,47,9,38,36,25,0
368,Lucas Boyé,36,16,12,16,8,17,35,48.6,18,33,5,28,15,46,0
369,Jayden Braaf,5,3,2,3,0,0,0,,0,1,0,1,2,1,0
370,Domagoj Bradarić,26,19,14,8,4,7,16,43.8,9,20,5,15,21,44,0
371,Bilal Brahimi,8,5,2,5,1,1,7,14.3,6,4,0,4,4,0,0
372,Martin Braithwaite,12,2,2,4,6,5,14,35.7,9,10,0,10,5,11,0
373,Juan Brandáriz,29,16,18,9,2,14,23,60.9,9,20,7,13,15,53,0
374,Julian Brandt,29,20,6,14,9,12,43,27.9,31,23,0,23,15,9,1
375,Darko Brašanac,29,20,12,10,7,12,23,52.2,11,14,2,12,12,9,0
376,Lilian Brassier,42,30,31,8,3,23,32,71.9,9,42,19,23,53,132,1
377,Claudio Bravo,0,0,0,0,0,0,0,,0,0,0,0,2,1,1
378,Fabian Bredlow,1,1,1,0,0,1,1,100.0,0,0,0,0,0,4,2
379,James Bree,5,3,4,1,0,3,4,75.0,1,3,1,2,6,11,0
380,Josip Brekalo,2,1,0,1,1,1,4,25.0,3,1,0,1,1,1,0
381,Josip Brekalo,2,1,2,0,0,0,4,0.0,4,0,0,0,2,2,0
382,Gleison Bremer,29,20,23,5,1,19,26,73.1,7,44,22,22,42,120,2
383,Armando Broja,4,1,0,3,1,1,1,100.0,0,10,1,9,1,1,0
384,Dylan Bronn,34,18,17,16,1,20,30,66.7,10,32,20,12,20,58,1
385,David Brooks,1,0,1,0,0,0,1,0.0,1,2,0,2,2,5,0
386,John Brooks,18,12,10,8,0,13,18,72.2,5,17,12,5,10,105,0
387,Moritz Broschinski,0,0,0,0,0,0,5,0.0,5,1,0,1,0,6,0
388,Marcelo Brozović,37,22,13,22,2,11,37,29.7,26,23,7,16,22,28,0
389,Cédric Brunner,39,27,26,11,2,30,45,66.7,15,24,7,17,43,79,0
390,Lewis Brunt,0,0,0,0,0,0,0,,0,0,0,0,0,2,0
391,Jacob Bruun Larsen,4,3,0,1,3,3,4,75.0,1,3,1,2,1,0,0
392,Andreas Bruus,12,6,9,3,0,8,20,40.0,12,13,2,11,17,24,0
393,Joe Bryan,5,4,3,2,0,4,4,100.0,0,2,0,2,1,1,0
394,Lee Buchanan,14,10,2,11,1,6,12,50.0,6,5,0,5,12,21,0
395,Ante Budimir,19,9,0,12,7,2,10,20.0,8,10,0,10,5,19,0
396,Emi Buendía,52,23,20,20,12,21,74,28.4,53,20,2,18,20,17,0
397,Hugo Bueno,33,16,23,6,4,17,33,51.5,16,14,1,13,10,36,0
398,Santiago Bueno,63,38,43,19,1,24,36,66.7,12,34,22,12,31,105,2
399,Adam Buksa,1,0,0,0,1,0,3,0.0,3,0,0,0,0,0,0
400,Marius Bülter,22,11,8,7,7,12,32,37.5,20,34,1,33,10,20,0
401,Cristian Buonaiuto,25,16,8,11,6,12,26,46.2,14,11,0,11,14,7,0
402,Facundo Buonanotte,2,1,1,1,0,1,22,4.5,21,5,2,3,4,3,0
403,Alessandro Buongiorno,38,25,22,16,0,16,31,51.6,15,38,19,19,60,105,2
404,Delano Burgzorg,3,3,1,1,1,2,3,66.7,1,2,0,2,0,2,0
405,Jonathan Burkardt,3,1,0,1,2,1,4,25.0,3,6,1,5,1,1,0
406,Oliver Burke,1,0,0,0,1,0,0,,0,2,0,2,0,0,0
407,Dan Burn,60,38,29,23,8,34,67,50.7,33,42,16,26,32,120,2
408,Maxime Busi,21,16,9,11,1,13,29,44.8,16,14,6,8,14,24,0
409,Sergio Busquets,58,26,24,26,8,29,51,56.9,22,32,6,26,27,36,2
410,Aurélio Buta,33,19,15,13,5,15,27,55.6,12,18,1,17,9,34,0
411,Leonardo Buta,1,1,0,1,0,0,0,,0,0,0,0,0,0,0
412,Marcin Bułka,0,0,0,0,0,0,1,0.0,1,0,0,0,1,0,0
413,Jamie Bynoe-Gittens,8,4,2,5,1,2,7,28.6,5,1,0,1,1,2,0
414,Rémy Cabella,64,37,21,28,15,29,64,45.3,35,41,5,36,17,7,1
415,Jimmy Cabot,20,12,10,8,2,12,26,46.2,14,5,0,5,4,12,0
416,Arthur Cabral,9,2,1,4,4,4,8,50.0,4,10,1,9,1,12,0
417,Leandro Cabrera,46,24,34,12,0,28,43,65.1,15,37,23,14,43,114,2
418,Liberato Cacace,25,10,12,8,5,9,15,60.0,6,15,7,8,4,16,0
419,Anthony Caci,58,33,32,20,6,28,42,66.7,14,28,4,24,54,40,0
420,Cafú,0,0,0,0,0,0,0,,0,0,0,0,0,1,0
421,Moisés Caicedo,100,50,41,47,12,40,68,58.8,28,43,7,36,56,31,3
422,Tom Cairney,17,6,4,8,5,7,10,70.0,3,18,3,15,5,3,0
423,Jens Cajuste,46,25,25,14,7,25,48,52.1,23,30,6,24,18,22,0
424,Cala,2,1,1,1,0,1,2,50.0,1,2,1,1,1,12,0
425,Davide Calabria,71,44,31,32,8,38,61,62.3,23,22,7,15,25,34,0
426,Mattia Caldara,23,14,10,11,2,9,20,45.0,11,23,16,7,17,88,2
427,Luca Caldirola,26,14,19,4,3,13,26,50.0,13,32,18,14,25,66,1
428,Fernando Calero,46,29,27,15,4,21,34,61.8,13,31,13,18,13,52,0
429,Duje Ćaleta-Car,14,10,9,4,1,6,9,66.7,3,15,11,4,15,65,1
430,Duje Ćaleta-Car,0,0,0,0,0,0,0,,0,0,0,0,0,1,0
431,Hakan Çalhanoğlu,48,27,17,26,5,16,43,37.2,27,30,5,25,25,13,1
432,Kerim Calhanoglu,2,1,2,0,0,2,2,100.0,0,1,0,1,0,3,0
433,Daniel Caligiuri,8,5,5,3,0,4,5,80.0,1,3,2,1,3,2,0
434,Alexander Callens,3,3,2,1,0,3,4,75.0,1,3,1,2,1,9,0
435,Dominic Calvert-Lewin,4,2,1,0,3,1,5,20.0,4,5,1,4,3,18,0
436,Mahdi Camara,63,36,18,38,7,25,43,58.1,18,35,4,31,40,16,0
437,Mohamed Camara,13,10,3,7,3,5,15,33.3,10,5,1,4,10,8,0
438,Mohamed Camara,83,45,38,39,6,48,92,52.2,44,45,6,39,27,14,1
439,Ousmane Camara,1,1,0,0,1,0,0,,0,0,0,0,0,0,0
440,Ousmane Camara,10,6,5,5,0,5,12,41.7,7,4,2,2,11,15,0
441,Eduardo Camavinga,68,48,32,21,15,24,64,37.5,40,24,5,19,17,25,0
442,Nicolò Cambiaghi,30,22,11,12,7,8,27,29.6,19,19,1,18,9,8,0
443,Andrea Cambiaso,57,34,34,20,3,28,65,43.1,37,26,2,24,26,33,1
444,Axel Camblan,2,2,1,1,0,0,1,0.0,1,0,0,0,0,0,0
445,Sergio Camello,16,10,3,9,4,5,17,29.4,12,9,1,8,2,26,0
446,Chem Campbell,2,1,1,1,0,0,1,0.0,1,2,0,2,1,0,0
447,Emre Can,57,28,25,27,5,22,43,51.2,21,16,6,10,25,39,1
448,Sergio Canales,25,14,10,8,7,14,33,42.4,19,18,0,18,14,8,0
449,Matteo Cancellieri,10,4,5,3,2,5,9,55.6,4,4,0,4,1,2,0
450,João Cancelo,29,21,16,9,4,17,24,70.8,7,7,1,6,19,9,1
451,João Cancelo,23,14,9,10,4,10,23,43.5,13,14,2,12,15,22,0
452,Antonio Candreva,17,7,13,2,2,11,38,28.9,27,7,3,4,17,32,0
453,Thomas Cannon,0,0,0,0,0,0,0,,0,0,0,0,0,0,0
454,Sergi Canós,0,0,0,0,0,0,2,0.0,2,3,1,2,0,1,0
455,Ander Capa,1,1,1,0,0,1,5,20.0,4,5,0,5,0,2,0
456,Pierrick Capelle,36,21,17,15,4,22,55,40.0,33,24,3,21,15,24,0
457,Étienne Capoue,21,12,6,13,2,10,18,55.6,8,12,5,7,19,20,1
458,Gianluca Caprari,16,6,3,11,2,8,26,30.8,18,22,1,21,8,3,0
459,Francesco Caputo,3,1,0,0,3,0,3,0.0,3,0,0,0,1,3,0
460,Francesco Caputo,2,2,0,1,1,0,1,0.0,1,7,2,5,2,8,0
461,Maxence Caqueret,87,54,27,38,22,43,109,39.4,66,45,3,42,39,27,0
462,Andrea Carboni,3,2,2,0,1,2,5,40.0,3,3,2,1,3,2,1
463,Franco Carboni,1,1,1,0,0,0,2,0.0,2,3,0,3,1,0,0
464,Valentin Carboni,1,1,0,1,0,1,3,33.3,2,1,0,1,0,0,0
465,Isaac Carcelen,69,51,41,22,6,41,63,65.1,22,35,11,24,19,80,1
466,Irvin Cardona,2,0,1,1,0,0,3,0.0,3,3,0,3,2,2,0
467,Irvin Cardona,1,1,1,0,0,1,5,20.0,4,3,0,3,4,8,0
468,Igor Carioca,18,11,12,2,4,12,21,57.1,9,7,0,7,5,17,0
469,Diego Carlos,1,0,0,1,0,0,1,0.0,1,2,2,0,1,2,0
470,Juan Carlos,0,0,0,0,0,0,0,,0,0,0,0,1,7,1
471,José Carlos Lazo,0,0,0,0,0,0,0,,0,0,0,0,0,0,0
472,José Carlos Lazo,5,3,2,2,1,3,3,100.0,0,2,0,2,3,5,0
473,Carmona,16,9,7,6,3,6,16,37.5,10,14,2,12,8,9,0
474,Carmona,13,11,5,3,5,9,16,56.3,7,10,6,4,7,17,1
475,Marco Carnesecchi,1,1,1,0,0,1,2,50.0,1,0,0,0,0,11,2
476,Yannick Carrasco,35,14,21,10,4,23,54,42.6,31,23,1,22,12,19,0
477,Dani Carvajal,32,18,15,12,5,18,35,51.4,17,24,6,18,15,49,0
478,Fabio Carvalho,8,8,3,3,2,3,6,50.0,3,6,0,6,6,0,0
479,Matis Carvalho,0,0,0,0,0,0,0,,0,0,0,0,1,0,0
480,William Carvalho,43,27,18,23,2,17,44,38.6,27,27,6,21,16,22,0
481,Nicolò Casale,42,20,28,14,0,22,34,64.7,12,25,17,8,17,73,1
482,Casemiro,88,46,43,35,10,47,92,51.1,45,49,11,38,34,64,0
483,Casemiro,0,0,0,0,0,0,0,,0,0,0,0,0,1,0
484,Matty Cash,55,32,36,15,4,26,37,70.3,11,20,5,15,26,43,0
485,Tommaso Cassandro,1,1,0,1,0,0,0,,0,1,1,0,0,0,0
486,Timothy Castagne,87,44,53,27,7,41,84,48.8,43,50,13,37,43,110,0
487,Michele Castagnetti,46,21,20,24,2,18,54,33.3,36,14,4,10,15,22,0
488,Koen Casteels,0,0,0,0,0,0,0,,0,0,0,0,1,10,1
489,Valentín Castellanos,12,5,2,7,3,0,18,0.0,18,22,2,20,6,26,0
490,Jean-Charles Castelletto,43,26,29,12,2,22,36,61.1,14,35,22,13,58,90,0
491,Samu Castillejo,21,12,8,9,4,8,40,20.0,32,21,2,19,9,2,0
492,Jonny Castro,33,15,22,10,1,17,38,44.7,21,26,5,21,14,28,2
493,Gaetano Castrovilli,10,8,1,7,2,2,9,22.2,7,5,1,4,8,5,0
494,Danilo Cataldi,25,16,7,15,3,14,40,35.0,26,23,9,14,24,33,0
495,Catena,29,14,23,4,2,13,27,48.1,14,32,25,7,28,159,1
496,Yoann Cathline,19,12,7,6,6,5,12,41.7,7,10,1,9,8,16,1
497,Maximiliano Caufriez,40,24,31,8,1,20,28,71.4,8,33,18,15,34,70,0
498,Edinson Cavani,7,4,3,3,1,3,15,20.0,12,10,3,7,2,11,0
499,Dani Ceballos,43,29,13,15,15,25,64,39.1,39,23,2,21,25,6,1
500,Pietro Ceccaroni,0,0,0,0,0,0,0,,0,1,1,0,3,2,0
501,Federico Ceccherini,25,19,15,9,1,13,23,56.5,10,17,10,7,19,55,0
502,Assan Ceesay,23,18,7,8,8,9,17,52.9,8,15,2,13,3,24,0
503,Emil Ceide,5,2,5,0,0,3,5,60.0,2,3,1,2,1,0,0
504,Zeki Çelik,42,21,19,21,2,24,41,58.5,17,33,6,27,14,36,2
505,Álex Centelles,22,14,16,3,3,16,22,72.7,6,13,2,11,11,40,0
506,Fabien Centonze,58,37,30,22,6,30,42,71.4,12,24,7,17,44,55,1
507,Michele Cerofolini,0,0,0,0,0,0,0,,0,0,0,0,1,2,0
508,Franco Cervi,76,46,29,36,11,33,66,50.0,33,33,1,32,36,16,0
509,Julian Chabot,36,23,19,14,3,20,35,57.1,15,30,18,12,41,105,0
510,Florian Chabrolle,6,4,1,5,0,2,4,50.0,2,3,0,3,7,2,0
511,El Chadaille Bitshiabu,10,7,7,2,1,3,12,25.0,9,9,7,2,9,13,3
512,Fares Chaïbi,31,18,8,15,8,17,50,34.0,33,38,5,33,19,36,1
513,Nathaniel Chalobah,1,1,1,0,0,1,1,100.0,0,0,0,0,0,2,0
514,Trevoh Chalobah,31,20,22,6,3,24,35,68.6,11,17,7,10,24,56,1
515,Muhammed Cham,30,15,15,4,11,13,35,37.1,22,13,0,13,7,5,0
516,Calum Chambers,9,6,7,2,0,6,8,75.0,2,5,4,1,7,10,1
517,Timothy Chandler,2,2,2,0,0,2,2,100.0,0,1,0,1,0,3,0
518,Gaëtan Charbonnier,2,1,0,2,0,0,4,0.0,4,2,0,2,0,5,0
519,Brendan Chardonnet,45,27,27,18,0,20,38,52.6,18,40,19,21,63,86,1
520,Shea Charles,4,0,4,0,0,1,1,100.0,0,0,0,0,1,2,0
521,Xavier Chavalerin,82,50,39,30,13,27,71,38.0,44,31,8,23,41,24,0
522,Pep Chavarría,6,4,2,1,3,1,5,20.0,4,8,0,8,2,8,0
523,Ivane Chegra,8,3,6,1,1,4,11,36.4,7,0,0,0,1,0,0
524,Pape Cheikh Diop,0,0,0,0,0,0,1,0.0,1,0,0,0,0,0,0
525,Rayan Cherki,14,8,2,5,7,8,23,34.8,15,6,0,6,5,1,0
526,Ilyes Cheti,6,4,4,0,2,5,8,62.5,3,5,1,4,4,7,0
527,Lucas Chevalier,2,1,2,0,0,2,2,100.0,0,1,0,1,2,7,2
528,Fabio Chiarodia,0,0,0,0,0,0,0,,0,1,0,1,2,4,0
529,Federico Chiesa,22,11,6,6,10,5,14,35.7,9,13,1,12,0,1,0
530,Ben Chilwell,21,17,12,8,1,13,25,52.0,12,21,2,19,18,26,0
531,Vlad Chiricheș,35,20,27,7,1,16,24,66.7,8,36,23,13,22,44,0
532,Pedro Chirivella,33,22,12,15,6,17,44,38.6,27,24,1,23,20,7,0
533,Joris Chotard,64,34,37,23,4,40,78,51.3,38,40,11,29,40,42,1
534,Andreas Christensen,20,15,9,11,0,10,16,62.5,6,14,12,2,21,47,0
535,Oliver Christensen,1,0,1,0,0,0,2,0.0,2,0,0,0,0,22,2
536,Ryan Christie,34,22,10,23,1,14,50,28.0,36,16,4,12,26,20,0
537,Carney Chukwuemeka,13,7,7,6,0,3,5,60.0,2,7,0,7,6,1,0
538,Samuel Chukwueze,14,7,7,2,5,7,23,30.4,16,13,0,13,12,16,0
539,Darko Churlinov,3,2,2,1,0,2,3,66.7,1,1,0,1,0,0,0
540,Víctor Chust,9,6,7,2,0,4,7,57.1,3,8,3,5,10,53,0
541,Tolga Ciğerci,16,13,6,9,1,10,16,62.5,6,6,2,4,8,5,0
542,Yanis Cimignani,11,5,3,7,1,4,5,80.0,1,5,1,4,2,2,0
543,Daniel Ciofani,6,3,1,2,3,4,7,57.1,3,7,1,6,2,10,0
544,Tio Cipot,12,7,6,3,3,6,8,75.0,2,0,0,0,0,2,0
545,Pathé Ciss,39,29,11,23,5,15,34,44.1,19,23,10,13,22,34,0
546,Souleymane Cissé,1,1,1,0,0,1,1,100.0,0,1,1,0,1,2,0
547,Patrick Ciurria,31,18,20,10,1,17,33,51.5,16,24,2,22,7,32,0
548,Bobby Clark,0,0,0,0,0,0,0,,0,2,0,2,0,0,0
549,Alexis Claude-Maurice,3,2,2,1,0,3,3,100.0,0,0,0,0,2,1,0
550,Alexis Claude-Maurice,14,9,5,8,1,6,16,37.5,10,6,0,6,2,1,0
551,Jonathan Clauss,46,28,21,16,9,23,52,44.2,29,29,4,25,31,40,2
552,Carlos Clerc,75,51,55,16,4,31,50,62.0,19,29,7,22,28,94,1
553,Nathaniel Clyne,27,16,13,9,5,14,23,60.9,9,22,4,18,19,34,0
554,Conor Coady,14,9,8,6,0,7,15,46.7,8,21,17,4,14,88,3
555,Nicolò Cocetta,0,0,0,0,0,0,1,0.0,1,1,1,0,1,1,0
556,Marcus Coco,24,15,11,9,4,11,23,47.8,12,13,3,10,14,7,0
557,Alexandre Coeff,10,5,6,4,0,4,9,44.4,5,9,4,5,8,35,1
558,Jack Colback,18,13,12,6,0,5,8,62.5,3,3,0,3,3,9,0
559,Séamus Coleman,35,26,21,10,4,19,29,65.5,10,14,7,7,22,58,2
560,David Čolina,4,1,1,1,2,2,2,100.0,0,8,0,8,4,3,0
561,Álex Collado,26,14,13,11,2,8,13,61.5,5,12,1,11,2,4,0
562,Diego Collado,0,0,0,0,0,0,0,,0,0,0,0,0,0,0
563,Omar Colley,17,10,10,7,0,9,12,75.0,3,9,5,4,22,69,1
564,Nathan Collins,27,15,19,8,0,15,24,62.5,9,35,28,7,21,84,0
565,Lorenzo Colombo,17,9,1,9,7,6,14,42.9,8,22,0,22,2,7,0
566,Andrea Colpani,14,9,6,5,3,8,12,66.7,4,14,2,12,3,6,0
567,Levi Colwill,8,7,4,4,0,4,9,44.4,5,5,3,2,15,37,1
568,Kingsley Coman,11,8,3,5,3,7,17,41.2,10,19,1,18,2,7,0
569,Eray Cömert,35,23,24,10,1,17,33,51.5,16,23,8,15,29,76,1
570,Santi Comesaña,71,44,24,41,6,38,82,46.3,44,39,3,36,32,17,0
571,Andrea Consigli,1,0,1,0,0,0,1,0.0,1,0,0,0,0,13,3
572,Abdu Conté,25,17,14,8,3,12,22,54.5,10,13,6,7,6,25,0
573,Andrea Conti,0,0,0,0,0,0,0,,0,0,0,0,0,0,0
574,Lewis Cook,37,22,10,22,5,18,44,40.9,26,29,10,19,23,31,0
575,Steve Cook,8,4,4,4,0,5,7,71.4,2,16,11,5,12,51,0
576,Liam Cooper,38,23,27,9,2,23,36,63.9,13,16,8,8,34,57,3
577,Copete,53,28,35,16,2,26,36,72.2,10,38,17,21,44,111,2
578,Diego Coppola,25,17,15,10,0,11,24,45.8,13,20,6,14,14,38,0
579,Francis Coquelin,18,13,7,9,2,7,7,100.0,0,8,2,6,9,7,0
580,Sébastien Corchia,16,6,10,2,4,11,22,50.0,11,9,3,6,14,21,0
581,Alex Cordaz,0,0,0,0,0,0,0,,0,0,0,0,0,0,0
582,Maxwel Cornet,7,3,5,0,2,4,6,66.7,2,6,0,6,2,3,0
583,Jesús Corona,1,0,1,0,0,0,1,0.0,1,0,0,0,1,1,0
584,Ángel Correa,12,6,6,3,3,5,16,31.3,11,17,0,17,10,6,1
585,Joaquín Correa,12,7,3,6,3,4,15,26.7,11,4,1,3,3,0,0
586,Thierry Correia,71,52,46,22,3,31,54,57.4,23,25,2,23,24,54,2
587,Alessandro Cortinovis,1,0,1,0,0,0,0,,0,1,0,1,0,0,0
588,Danny da Costa,20,16,7,8,5,12,20,60.0,8,22,3,19,9,26,0
589,David Pereira da Costa,13,7,1,10,2,7,19,36.8,12,19,1,18,11,6,0
590,Diego Costa,3,1,3,0,0,2,9,22.2,7,6,1,5,2,17,0
591,Jaume Costa,50,34,26,17,7,29,51,56.9,22,13,5,8,22,44,1
592,Logan Costa,9,4,7,1,1,6,9,66.7,3,6,3,3,4,12,0
593,Nuno da Costa,45,23,14,23,8,11,46,23.9,35,21,1,20,20,15,0
594,Samu Costa,61,31,35,20,6,29,61,47.5,32,29,7,22,37,64,4
595,Benoît Costil,2,0,2,0,0,2,4,50.0,2,0,0,0,0,5,0
596,Vladimír Coufal,58,31,37,15,6,36,51,70.6,15,24,6,18,38,70,0
597,Lassana Coulibaly,84,50,42,35,7,30,73,41.1,43,35,7,28,25,33,2
598,Soumaïla Coulibaly,0,0,0,0,0,0,0,,0,0,0,0,0,0,1
599,Tanguy Coulibaly,12,9,9,1,2,5,12,41.7,7,10,0,10,3,0,0
600,Thibaut Courtois,1,0,1,0,0,1,1,100.0,0,0,0,0,3,7,1
601,Mathieu Coutadeur,23,13,13,10,0,8,28,28.6,20,19,3,16,19,21,0
602,Philippe Coutinho,19,14,8,8,3,9,15,60.0,6,11,1,10,4,2,0
603,Yan Couto,25,18,11,11,3,12,20,60.0,8,7,2,5,5,10,0
604,Conor Coventry,0,0,0,0,0,0,0,,0,0,0,0,0,0,0
605,Nicolas Cozza,38,21,27,9,2,26,38,68.4,12,11,5,6,21,35,1
606,Nicolas Cozza,3,3,1,2,0,2,3,66.7,1,3,1,2,0,0,0
607,Alessio Cragno,0,0,0,0,0,0,1,0.0,1,0,0,0,0,0,0
608,Matthew Craig,4,1,2,2,0,0,0,,0,0,0,0,0,0,0
609,Aaron Cresswell,21,11,12,7,2,12,31,38.7,19,21,11,10,27,56,0
610,Bryan Cristante,113,62,55,49,9,55,90,61.1,35,39,10,29,18,53,0
611,Domen Črnigoj,8,3,0,7,1,1,2,50.0,1,9,1,8,9,6,0
612,Juan Cruz Armada,24,14,17,4,3,13,23,56.5,10,21,8,13,13,58,0
613,Juan Cruz,1,0,0,1,0,1,3,33.3,2,1,0,1,0,0,0
614,Juan Cuadrado,50,34,34,13,3,27,65,41.5,38,15,2,13,24,32,0
615,Marc Cucurella,66,33,40,15,11,30,60,50.0,30,28,8,20,16,48,1
616,Jorge Cuenca,9,7,7,2,0,4,7,57.1,3,10,8,2,6,44,0
617,Braian Cufré,5,2,2,1,2,2,5,40.0,3,2,1,1,2,1,0
618,Mickaël Cuisance,13,10,7,5,1,5,23,21.7,18,10,0,10,5,4,0
619,Matheus Cunha,7,4,0,5,2,2,10,20.0,8,15,3,12,9,11,0
620,Matheus Cunha,4,1,1,3,0,0,3,0.0,3,4,1,3,2,3,0
621,Curro,2,0,1,1,0,1,2,50.0,1,0,0,0,0,0,0
622,Marco D'Alessandro,4,4,3,1,0,2,5,40.0,3,2,0,2,1,3,0
623,Danilo D'Ambrosio,25,17,17,7,1,15,27,55.6,12,12,4,8,10,17,0
624,Luca D'Andrea,4,0,2,1,1,1,4,25.0,3,2,0,2,1,1,0
625,Damien Da Silva,8,7,5,3,0,3,3,100.0,0,4,3,1,5,12,0
626,Moanes Dabbur,11,8,4,5,2,3,9,33.3,6,8,0,8,5,0,0
627,Andréa Dacourt,0,0,0,0,0,0,0,,0,0,0,0,0,0,0
628,Colin Dagba,32,20,17,10,5,19,26,73.1,7,18,2,16,17,19,0
629,Finn Dahmen,0,0,0,0,0,0,0,,0,0,0,0,0,3,0
630,Mahmoud Dahoud,11,9,3,4,4,7,7,100.0,0,6,2,4,7,3,0
631,Patson Daka,14,8,6,8,0,3,13,23.1,10,14,2,12,7,7,0
632,Thijs Dallinga,8,6,2,2,4,1,13,7.7,12,17,3,14,3,20,0
633,Diogo Dalot,54,41,40,13,1,33,45,73.3,12,25,7,18,37,55,2
634,Muhammed Damar,6,3,1,2,3,1,2,50.0,1,3,0,3,0,0,0
635,Mikkel Damsgaard,31,21,13,13,5,15,42,35.7,27,20,2,18,10,14,0
636,Flavius Daniliuc,57,29,37,17,3,26,47,55.3,21,30,13,17,29,76,0
637,Flavius Daniliuc,2,0,2,0,0,1,1,100.0,0,4,1,3,0,1,0
638,Danilo,18,7,7,9,2,6,25,24.0,19,26,6,20,9,19,0
639,Danilo,92,62,61,23,8,52,73,71.2,21,39,20,19,47,114,1
640,Arnaut Danjuma,2,0,1,1,0,0,0,,0,1,0,1,0,0,0
641,Arnaut Danjuma,3,3,1,0,2,1,2,50.0,1,0,0,0,0,1,1
642,Kévin Danois,1,1,0,1,0,0,0,,0,0,0,0,1,0,0
643,Kevin Danso,37,19,25,11,1,19,30,63.3,11,48,34,14,33,124,0
644,Dante,70,40,45,21,4,36,59,61.0,23,52,31,21,47,125,2
645,Márton Dárdai,17,8,9,8,0,9,18,50.0,9,14,9,5,11,45,1
646,Sergi Darder,69,38,12,43,14,29,73,39.7,44,34,2,32,24,23,0
647,Achraf Dari,21,14,15,5,1,14,20,70.0,6,16,10,6,19,65,2
648,Vladimír Darida,1,1,0,1,0,0,0,,0,1,0,1,0,0,0
649,Matteo Darmian,56,30,29,15,12,31,47,66.0,16,33,5,28,21,36,0
650,Josh Dasilva,18,9,6,6,6,6,16,37.5,10,22,6,16,5,7,1
651,David Datro Fofana,3,1,1,1,1,1,1,100.0,0,1,0,1,0,0,0
652,Juan David Cabal,10,6,7,3,0,7,12,58.3,5,8,5,3,13,12,0
653,Jonathan David,24,17,6,11,7,10,27,37.0,17,20,2,18,8,13,0
654,Alphonso Davies,45,28,25,13,7,18,39,46.2,21,28,4,24,24,24,4
655,Ben Davies,28,11,13,13,2,14,26,53.8,12,17,8,9,18,72,0
656,Tom Davies,15,9,5,9,1,7,14,50.0,7,10,1,9,4,7,1
657,Paweł Dawidowicz,48,31,28,17,3,22,31,71.0,9,14,9,5,23,71,0
658,Craig Dawson,11,7,9,2,0,5,7,71.4,2,9,6,3,6,26,0
659,Craig Dawson,9,6,6,3,0,4,7,57.1,3,31,23,8,12,74,2
660,Kevin De Bruyne,28,12,3,12,13,14,39,35.9,25,27,2,25,9,10,0
661,Charles De Ketelaere,26,12,7,14,5,13,30,43.3,17,14,2,12,4,9,0
662,Manuel De Luca,0,0,0,0,0,0,0,,0,0,0,0,0,0,0
663,Tommaso De Nipoti,1,0,0,1,0,0,0,,0,0,0,0,0,0,0
664,Rodrigo De Paul,35,21,11,18,6,18,35,51.4,17,20,3,17,8,7,0
665,Mattia De Sciglio,14,7,8,3,3,9,14,64.3,5,9,3,6,4,20,0
666,Lorenzo De Silvestri,3,2,2,0,1,3,7,42.9,4,6,5,1,3,20,0
667,Thibault De Smet,24,17,10,14,0,11,37,29.7,26,28,5,23,20,40,1
668,Koni De Winter,14,9,11,3,0,5,13,38.5,8,14,12,2,6,65,0
669,Grégoire Defrel,9,7,5,2,2,4,13,30.8,9,11,0,11,2,5,0
670,Duccio Degl'Innocenti,0,0,0,0,0,0,0,,0,0,0,0,1,0,0
671,Brecht Dejaegere,40,23,10,20,10,15,51,29.4,36,25,5,20,14,11,0
672,Romain Del Castillo,39,24,13,17,9,16,36,44.4,20,14,1,13,11,5,0
673,Alberto Del Moral,0,0,0,0,0,0,0,,0,0,0,0,0,0,0
674,Thomas Delaine,28,14,16,6,6,13,26,50.0,13,8,3,5,16,9,0
675,Thomas Delaney,4,2,0,4,0,3,5,60.0,2,3,2,1,4,3,0
676,Thomas Delaney,6,3,3,2,1,3,8,37.5,5,5,0,5,1,4,0
677,Sacha Delaye,1,0,0,0,1,1,1,100.0,0,0,0,0,0,0,0
678,Fran Delgado,0,0,0,0,0,0,0,,0,0,0,0,0,0,0
679,Andy Delort,2,0,1,1,0,1,2,50.0,1,0,0,0,1,7,0
680,Andy Delort,5,4,1,2,2,2,6,33.3,4,3,0,3,0,2,0
681,Karamoko Dembele,2,0,1,1,0,2,2,100.0,0,1,0,1,1,0,0
682,Moussa Dembélé,8,4,3,3,2,4,7,57.1,3,5,0,5,2,6,0
683,Ousmane Dembélé,19,12,4,8,7,4,15,26.7,11,10,1,9,0,2,0
684,Siriki Dembélé,3,1,2,1,0,0,1,0.0,1,1,0,1,1,1,0
685,Siriki Dembélé,10,6,4,3,3,4,12,33.3,8,2,0,2,1,2,0
686,Merih Demiral,41,29,30,11,0,26,36,72.2,10,24,7,17,24,57,1
687,Kerem Demirbay,36,18,16,17,3,18,34,52.9,16,26,6,20,16,11,0
688,Ermedin Demirović,31,14,9,12,10,9,22,40.9,13,31,4,27,14,37,0
689,Diego Demme,1,0,1,0,0,0,4,0.0,4,2,0,2,0,1,0
690,Sepp van den Berg,5,4,2,2,1,1,4,25.0,3,8,5,3,13,33,2
691,Branco van den Boomen,71,36,26,32,13,36,89,40.4,53,27,4,23,10,27,2
692,Leander Dendoncker,19,9,11,6,2,11,22,50.0,11,19,4,15,10,12,0
693,Leander Dendoncker,4,2,0,3,1,2,3,66.7,1,2,0,2,9,4,0
694,Emmanuel Dennis,17,11,5,5,7,8,18,44.4,10,13,1,12,2,6,0
695,Fabio Depaoli,48,28,25,16,7,25,44,56.8,19,32,6,26,18,33,3
696,Fabio Depaoli,5,3,2,3,0,3,4,75.0,1,1,0,1,1,4,0
697,Kastriot Dermaku,0,0,0,0,0,0,0,,0,0,0,0,0,0,0
698,Halil Dervişoğlu,0,0,0,0,0,0,1,0.0,1,0,0,0,0,0,0
699,Rémy Descamps,0,0,0,0,0,0,0,,0,0,0,0,0,0,0
700,Mikkel Desler,71,38,36,27,8,43,67,64.2,24,35,6,29,36,48,2
701,Cyriel Dessers,11,4,4,4,3,2,6,33.3,4,14,2,12,3,5,0
702,Sergiño Dest,12,6,3,5,4,3,4,75.0,1,1,0,1,4,2,0
703,Mattia Destro,1,1,0,1,0,0,0,,0,2,0,2,1,5,0
704,Gerard Deulofeu,8,5,5,1,2,5,15,33.3,10,8,1,7,2,1,0
705,Kiernan Dewsbury-Hall,53,29,14,34,5,19,47,40.4,28,55,13,42,28,21,0
706,Samuel Di Carmine,0,0,0,0,0,0,0,,0,0,0,0,0,0,0
707,Federico Di Francesco,28,16,7,11,10,9,19,47.4,10,16,0,16,8,14,0
708,Michele Di Gregorio,0,0,0,0,0,0,3,0.0,3,1,0,1,4,18,3
709,Giovanni Di Lorenzo,60,29,33,19,8,25,49,51.0,24,30,9,21,30,60,0
710,Ángel Di María,10,5,3,5,2,3,19,15.8,16,15,0,15,7,0,0
711,Boulaye Dia,12,5,3,6,3,2,7,28.6,5,10,0,10,7,27,1
712,Moussa Diaby,14,8,4,8,2,7,14,50.0,7,8,0,8,5,3,0
713,Mouctar Diakhaby,30,16,19,11,0,13,20,65.0,7,30,17,13,20,111,2
714,Mamadou Diakhon,2,0,2,0,0,0,1,0.0,1,1,0,1,1,0,0
715,Bafodé Diakité,54,35,23,24,7,32,57,56.1,25,37,8,29,17,58,0
716,Ibrahim Diakité,3,3,3,0,0,2,3,66.7,1,0,0,0,5,6,0
717,Abdou Diallo,6,5,5,1,0,1,3,33.3,2,8,5,3,8,22,0
718,Baila Diallo,1,0,1,0,0,0,0,,0,1,1,0,0,1,0
719,Habib Diallo,18,10,8,7,3,6,16,37.5,10,19,4,15,12,26,0
720,Ibrahima Diallo,25,15,14,10,1,8,14,57.1,6,11,1,10,6,11,0
721,Ismael Diallo,46,33,35,9,2,35,63,55.6,28,26,12,14,30,46,1
722,Habib Diarra,24,16,10,11,3,15,29,51.7,14,17,1,16,11,13,0
723,Mamady Diarra,2,1,2,0,0,1,2,50.0,1,2,0,2,0,0,0
724,Moussa Diarra,20,9,9,9,2,9,15,60.0,6,25,10,15,19,27,1
725,Stéphane Diarra,25,17,14,9,2,11,29,37.9,18,13,1,12,22,9,0
726,Youba Diarra,3,0,2,1,0,1,5,20.0,4,7,1,6,2,3,0
727,Rúben Dias,21,13,10,10,1,11,18,61.1,7,21,13,8,18,56,1
728,Krépin Diatta,30,21,4,17,9,13,32,40.6,19,29,1,28,17,12,0
729,Mory Diaw,0,0,0,0,0,0,4,0.0,4,0,0,0,2,13,5
730,Brahim Díaz,32,15,5,22,5,5,15,33.3,10,11,0,11,7,6,0
731,Luis Díaz,17,11,4,8,5,8,15,53.3,7,8,0,8,6,2,0
732,Justin Diehl,0,0,0,0,0,0,0,,0,0,0,0,0,0,0
733,Bamba Dieng,4,4,2,1,1,3,4,75.0,1,5,1,4,0,0,0
734,Bamba Dieng,19,10,5,12,2,3,11,27.3,8,6,0,6,2,6,0
735,Eric Dier,30,19,16,12,2,9,19,47.4,10,41,24,17,35,112,2
736,Florian Dietz,2,1,0,2,0,1,4,25.0,3,4,1,3,0,2,0
737,Lucas Digne,30,12,20,9,1,20,33,60.6,13,18,5,13,18,45,0
738,Federico Dimarco,31,25,6,18,7,9,19,47.4,10,15,4,11,18,20,0
739,Stole Dimitrievski,1,0,1,0,0,1,2,50.0,1,2,0,2,1,17,3
740,Junior Dina Ebimbe,30,19,16,14,0,16,33,48.5,17,18,5,13,11,20,0
741,Tristan Dingomé,1,1,0,1,0,0,2,0.0,2,0,0,0,0,0,0
742,Eren Dinkçi,5,5,2,1,2,2,6,33.3,4,2,0,2,0,2,0
743,Sinaly Diomande,42,24,26,15,1,31,49,63.3,18,26,13,13,49,75,1
744,Lois Diony,1,0,0,1,0,1,3,33.3,2,2,0,2,0,1,0
745,Edan Diop,13,8,3,3,7,7,15,46.7,8,7,1,6,4,1,0
746,Issa Diop,28,19,18,9,1,17,32,53.1,15,24,17,7,35,86,0
747,Sofiane Diop,23,11,12,6,5,7,20,35.0,13,14,2,12,16,5,0
748,Sofiane Diop,0,0,0,0,0,0,0,,0,0,0,0,1,0,0
749,Yehvann Diouf,2,0,2,0,0,1,3,33.3,2,0,0,0,1,13,5
750,Axel Disasi,30,20,13,13,4,13,27,48.1,14,51,31,20,56,112,2
751,Tiago Djaló,31,21,23,7,1,13,20,65.0,7,17,11,6,23,60,1
752,Djené,41,28,23,17,1,22,38,57.9,16,25,10,15,42,81,1
753,Moussa Djenepo,19,11,13,5,1,11,27,40.7,16,19,2,17,11,7,0
754,Koffi Djidji,50,25,32,17,1,18,32,56.3,14,29,14,15,34,72,0
755,Alexander Djiku,53,36,37,16,0,26,46,56.5,20,45,19,26,66,151,3
756,Berat Djimsiti,34,19,21,13,0,17,25,68.0,8,17,7,10,36,74,1
757,Moussa Djitte,1,0,0,0,1,1,2,50.0,1,0,0,0,0,1,0
758,Ouparine Djoco,0,0,0,0,0,0,0,,0,0,0,0,0,1,0
759,Marko Dmitrović,0,0,0,0,0,0,0,,0,0,0,0,0,6,0
760,Alan Do Marcolino,0,0,0,0,0,0,0,,0,0,0,0,0,1,0
761,Ben Doak,3,2,1,2,0,1,1,100.0,0,1,0,1,0,0,0
762,Ritsu Doan,61,29,19,29,13,25,55,45.5,30,40,1,39,14,12,0
763,Dodô,40,22,20,14,6,22,46,47.8,24,26,2,24,25,37,0
764,Danilho Doekhi,38,23,21,17,0,14,26,53.8,12,27,12,15,29,93,0
765,Matt Doherty,16,10,12,3,1,8,10,80.0,2,11,6,5,8,14,1
766,Matt Doherty,0,0,0,0,0,0,0,,0,2,0,2,0,0,0
767,Josh Doig,19,8,6,7,6,6,16,37.5,10,25,6,19,11,13,1
768,Jeremy Doku,25,16,6,13,6,12,24,50.0,12,10,0,10,5,2,0
769,Kasper Dolberg,1,0,0,1,0,1,3,33.3,2,0,0,0,0,5,0
770,Kasper Dolberg,7,5,1,4,2,4,6,66.7,2,6,2,4,0,5,0
771,Carlos Dominguez,1,1,0,1,0,1,2,50.0,1,1,1,0,0,7,0
772,Nicolás Domínguez,79,49,34,33,12,39,76,51.3,37,29,3,26,21,29,1
773,John Donald,20,11,9,9,2,7,14,50.0,7,14,7,7,14,23,1
774,Giulio Donati,4,1,1,1,2,3,6,50.0,3,3,1,2,4,11,0
775,Kyliane Dong,3,1,0,2,1,1,2,50.0,1,1,0,1,1,0,0
776,Jordan Dongmo,1,0,0,1,0,1,1,100.0,0,0,0,0,0,0,0
777,Gianluigi Donnarumma,1,0,1,0,0,1,2,50.0,1,0,0,0,0,12,4
778,Niklas Dorsch,21,12,8,11,2,9,16,56.3,7,9,3,6,6,9,0
779,Jodel Dossou,7,4,3,2,2,4,4,100.0,0,2,1,1,1,0,0
780,Lohann Doucet,3,0,2,0,1,3,4,75.0,1,2,0,2,2,4,0
781,Abdoulaye Doucouré,31,20,9,15,7,12,37,32.4,25,26,3,23,13,11,0
782,Cheick Doucouré,77,46,40,33,4,29,52,55.8,23,47,13,34,56,48,0
783,Siriné Doucouré,2,2,2,0,0,1,2,50.0,1,0,0,0,1,0,0
784,Désiré Doué,37,18,10,23,4,13,32,40.6,19,17,1,16,13,3,0
785,Guela Doué,0,0,0,0,0,0,0,,0,0,0,0,0,0,0
786,Ismaël Doukouré,48,24,23,21,4,20,34,58.8,14,26,8,18,27,54,0
787,Kamory Doumbia,31,16,9,14,8,12,37,32.4,25,17,1,16,13,3,0
788,Souleyman Doumbia,45,31,31,13,1,17,31,54.8,14,20,3,17,27,27,1
789,Flynn Downes,16,9,4,10,2,6,12,50.0,6,15,2,13,7,6,0
790,Kami Doyle,0,0,0,0,0,0,0,,0,0,0,0,0,0,0
791,Bartłomiej Drągowski,1,0,1,0,0,1,5,20.0,4,0,0,0,1,15,3
792,Cody Drameh,5,4,0,4,1,2,3,66.7,1,0,0,0,1,1,0
793,Dion Drena Beljo,7,6,3,2,2,2,13,15.4,11,15,2,13,1,14,0
794,Dominick Drexler,25,17,12,10,3,9,22,40.9,13,18,2,16,8,12,0
795,Domingos Duarte,26,18,21,5,0,19,26,73.1,7,29,23,6,39,145,0
796,Martin Dúbravka,0,0,0,0,0,0,1,0.0,1,0,0,0,0,1,0
797,Marvin Ducksch,8,3,2,4,2,3,16,18.8,13,13,2,11,9,41,1
798,Ondrej Duda,22,14,7,12,3,9,16,56.3,7,11,0,11,13,8,0
799,Ondrej Duda,9,8,2,5,2,4,11,36.4,7,7,1,6,2,3,0
800,Shane Duffy,0,0,0,0,0,0,0,,0,0,0,0,0,0,1
801,Rémy Dugimont,2,1,0,1,1,1,2,50.0,1,3,0,3,0,5,0
802,Denzel Dumfries,35,18,17,13,5,22,34,64.7,12,33,9,24,12,26,0
803,Alfred Duncan,18,10,0,17,1,10,21,47.6,11,9,0,9,8,6,0
804,Lewis Dunk,30,19,19,9,2,18,41,43.9,23,37,27,10,34,81,1
805,Maxime Dupé,0,0,0,0,0,0,0,,0,0,0,0,0,9,3
806,Jhon Durán,2,2,0,1,1,1,4,25.0,3,0,0,0,2,2,0
807,Pablo Durán,0,0,0,0,0,0,0,,0,2,1,1,1,2,0
808,Julien Duranville,1,1,0,1,0,1,1,100.0,0,0,0,0,0,0,0
809,Hugo Duro,15,12,2,6,7,7,17,41.2,10,11,1,10,2,7,1
810,Jean-Kevin Duverne,72,38,44,24,4,42,73,57.5,31,33,5,28,28,65,1
811,Paulo Dybala,14,4,1,8,5,8,26,30.8,18,12,1,11,8,4,0
812,Edin Džeko,3,2,0,3,0,0,4,0.0,4,15,1,14,3,25,0
813,Malcolm Ebiowei,1,1,1,0,0,0,1,0.0,1,2,0,2,0,0,0
814,Festy Ebosele,15,10,8,7,0,4,10,40.0,6,5,0,5,2,5,0
815,Enzo Ebosse,15,9,11,4,0,9,13,69.2,4,27,6,21,11,29,0
816,Tyronne Ebuehi,22,14,11,7,4,9,13,69.2,4,23,12,11,12,79,1
817,Ederson,3,1,3,0,0,1,2,50.0,1,0,0,0,1,10,2
818,Éderson,67,34,18,42,7,29,66,43.9,37,56,7,49,36,31,0
819,Odsonne Édouard,25,13,7,12,6,7,13,53.8,6,17,5,12,3,22,0
820,Samuel Edozie,17,10,6,10,1,3,8,37.5,5,7,0,7,6,6,0
821,Maximilian Eggestein,51,29,21,24,6,17,35,48.6,18,37,8,29,36,27,0
822,Lilian Egloff,12,10,4,5,3,4,6,66.7,2,2,0,2,1,1,0
823,Íñigo Eguaras,11,8,4,6,1,5,18,27.8,13,9,3,6,6,15,0
824,Kingsley Ehizibue,47,31,28,13,6,29,45,64.4,16,21,3,18,10,42,1
825,Kingsley Ehizibue,0,0,0,0,0,0,0,,0,1,0,1,2,1,0
826,Julian Eitschberger,0,0,0,0,0,0,0,,0,0,0,0,0,0,0
827,Chidera Ejuke,5,4,1,4,0,1,5,20.0,4,4,0,4,4,1,0
828,Albin Ekdal,37,20,14,20,3,19,45,42.2,26,24,2,22,26,36,0
829,Hugo Ekitike,12,4,1,10,1,4,12,33.3,8,12,0,12,9,3,0
830,Emmanuel Ekong,0,0,0,0,0,0,0,,0,0,0,0,0,0,0
831,Anthony Elanga,3,0,0,2,1,1,2,50.0,1,4,0,4,2,4,0
832,Alberth Elis,4,3,1,2,1,1,7,14.3,6,1,0,1,1,2,0
833,Mikael Ellertsson,4,2,1,3,0,0,3,0.0,3,2,1,1,2,0,0
834,Harvey Elliott,27,18,6,12,9,9,37,24.3,28,26,1,25,15,8,0
835,Elif Elmas,24,13,8,12,4,11,23,47.8,12,18,2,16,11,5,0
836,Mohamed Elneny,1,1,1,0,0,1,1,100.0,0,0,0,0,0,0,0
837,Aritz Elustondo,26,17,15,10,1,14,26,53.8,12,15,6,9,20,43,1
838,Nico Elvedi,46,24,32,12,2,27,41,65.9,14,31,16,15,35,149,3
839,Rodrigo Ely,30,21,26,4,0,18,25,72.0,7,46,33,13,31,203,1
840,Mohamed Elyounoussi,46,28,22,20,4,19,44,43.2,25,40,3,37,27,37,0
841,Adri Embarba,50,27,21,26,3,22,46,47.8,24,23,0,23,9,9,0
842,Adri Embarba,1,0,0,1,0,1,1,100.0,0,1,0,1,0,0,0
843,Breel Embolo,15,9,2,7,6,5,10,50.0,5,14,3,11,5,12,0
844,Emerson,54,33,38,12,4,27,40,67.5,13,17,3,14,18,75,0
845,Youssef En-Nesyri,16,8,3,7,6,4,14,28.6,10,6,2,4,4,16,0
846,Julio Enciso,13,4,3,6,4,8,13,61.5,5,9,0,9,4,2,0
847,Wataru Endo,70,37,30,31,9,38,85,44.7,47,44,6,38,26,63,0
848,Arne Engels,20,9,9,10,1,8,19,42.1,11,17,5,12,15,12,1
849,Christian Eriksen,22,18,10,7,5,10,33,30.3,23,23,9,14,11,20,1
850,Martin Erlic,27,16,18,8,1,10,23,43.5,13,36,23,13,31,120,1
851,Tjark Ernst,0,0,0,0,0,0,0,,0,0,0,0,0,1,0
852,Gonzalo Escalante,16,8,8,8,0,10,13,76.9,3,7,1,6,10,4,0
853,Gonzalo Escalante,36,24,15,20,1,15,29,51.7,14,18,4,14,17,26,1
854,Sergio Escudero,33,19,21,8,4,15,35,42.9,20,26,6,20,26,46,0
855,Alfonso Espino,87,56,55,20,12,48,96,50.0,48,52,11,41,48,99,3
856,Bernardo Espinosa,6,2,2,4,0,3,9,33.3,6,17,10,7,12,70,2
857,Salvatore Esposito,15,12,8,5,2,5,21,23.8,16,9,1,8,11,18,0
858,Maxime Estève,24,13,17,5,2,12,17,70.6,5,28,17,11,34,90,0
859,Pervis Estupiñán,61,31,36,19,6,35,60,58.3,25,30,8,22,37,37,1
860,Jonny Evans,13,5,12,1,0,7,11,63.6,4,15,11,4,18,51,0
861,Edu Expósito,34,20,16,15,3,13,23,56.5,10,7,0,7,12,20,0
862,Eberechi Eze,42,24,17,18,7,18,38,47.4,20,22,0,22,13,10,0
863,Kimberly Ezekwem,0,0,0,0,0,0,0,,0,1,0,1,0,0,0
864,Nicolás Ezequiel Fernández,23,12,10,7,6,9,17,52.9,8,7,0,7,5,2,1
865,Abdessamad Ezzalzouli,29,19,13,12,4,13,23,56.5,10,20,0,20,4,6,0
866,Łukasz Fabiański,2,0,2,0,0,1,2,50.0,1,1,0,1,0,10,1
867,Fabinho,65,38,18,40,7,24,62,38.7,38,38,11,27,37,40,0
868,Fábio,4,2,1,2,1,4,6,66.7,2,2,0,2,3,11,0
869,Noah Fadiga,30,21,18,9,3,14,26,53.8,12,17,7,10,26,18,0
870,Wout Faes,56,33,28,26,2,28,44,63.6,16,53,37,16,41,113,2
871,Wout Faes,1,1,1,0,0,1,2,50.0,1,6,3,3,7,19,0
872,Nicolò Fagioli,29,19,12,15,2,8,27,29.6,19,16,2,14,8,7,1
873,Ralf Fährmann,1,0,1,0,0,1,1,100.0,0,0,0,0,0,10,2
874,Romain Faivre,13,8,5,4,4,5,25,20.0,20,11,0,11,1,4,0
875,Romain Faivre,6,3,2,2,2,1,3,33.3,2,3,0,3,0,0,0
876,Radamel Falcao,4,4,1,3,0,1,8,12.5,7,5,1,4,2,10,0
877,Wladimiro Falcone,2,0,2,0,0,2,2,100.0,0,0,0,0,2,21,3
878,Fali,27,19,19,8,0,18,29,62.1,11,24,15,9,13,70,1
879,Fallou Fall,0,0,0,0,0,0,1,0.0,1,3,3,0,0,4,0
880,Mamadou Fall,0,0,0,0,0,0,0,,0,1,0,1,0,1,0
881,Davide Faraoni,34,24,19,13,2,16,41,39.0,25,30,11,19,15,37,0
882,Ansu Fati,16,9,8,4,4,5,18,27.8,13,19,0,19,5,6,0
883,Khalil Fayad,30,14,12,16,2,12,21,57.1,9,8,1,7,9,4,0
884,Cheikh Faye,0,0,0,0,0,0,0,,0,0,0,0,1,0,0
885,Federico Fazio,15,12,8,7,0,4,11,36.4,7,9,4,5,28,61,0
886,Jacopo Fazzini,31,17,20,8,3,18,34,52.9,16,15,3,12,7,19,0
887,Zouhair Feddal,4,2,1,3,0,3,4,75.0,1,9,9,0,5,27,0
888,Nabil Fekir,11,5,3,3,5,2,9,22.2,7,6,2,4,1,0,0
889,Felipe,42,23,29,13,0,24,41,58.5,17,34,13,21,36,90,0
890,Felipe,3,2,1,2,0,2,4,50.0,2,2,2,0,0,7,0
891,Luiz Felipe,34,23,23,11,0,18,34,52.9,16,43,24,19,28,106,0
892,João Félix,14,7,5,6,3,4,12,33.3,8,3,0,3,1,1,1
893,João Félix,10,7,2,3,5,1,6,16.7,5,1,0,1,3,2,0
894,Ohis Felix Uduokhai,30,20,14,13,3,15,29,51.7,14,27,14,13,29,61,1
895,Kiko Femenía,18,9,14,3,1,13,18,72.2,5,15,6,9,20,22,0
896,Evan Ferguson,6,3,1,3,2,1,7,14.3,6,11,1,10,2,6,0
897,Lewis Ferguson,44,25,16,20,8,20,40,50.0,20,22,7,15,19,25,0
898,Bruno Fernandes,68,42,24,25,19,30,71,42.3,41,37,5,32,25,40,1
899,Edimilson Fernandes,35,25,26,5,4,18,34,52.9,16,37,16,21,54,87,2
900,Aitor Fernández,1,1,1,0,0,0,1,0.0,1,0,0,0,2,17,0
901,Álex Fernández,13,7,6,4,3,4,14,28.6,10,14,1,13,8,19,0
902,Álvaro Fernández,0,0,0,0,0,0,0,,0,0,0,0,0,7,2
903,Carlos Fernández,6,4,1,3,2,1,15,6.7,14,1,0,1,1,4,0
904,Enzo Fernández,45,27,25,17,3,21,56,37.5,35,32,2,30,16,12,1
905,Federico Fernández,1,1,1,0,0,1,1,100.0,0,0,0,0,2,12,0
906,Joaquín Fernández,35,28,20,11,4,19,30,63.3,11,31,22,9,27,98,1
907,Valery Fernández,12,6,4,6,2,5,9,55.6,4,8,1,7,10,9,1
908,Fernando,0,0,0,0,0,0,2,0.0,2,2,0,2,1,20,3
909,Fernando,34,23,14,17,3,18,30,60.0,12,21,10,11,24,29,0
910,Alex Ferrari,9,5,7,2,0,4,8,50.0,4,21,10,11,19,25,0
911,Alex Ferrari,40,23,32,7,1,28,42,66.7,14,19,4,15,25,45,1
912,Salvador Ferrer,4,2,2,2,0,1,3,33.3,2,3,1,2,1,4,0
913,Jordan Ferri,55,35,32,19,4,30,89,33.7,59,22,6,16,26,21,0
914,Fidel,15,10,8,5,2,4,38,10.5,34,9,0,9,5,8,0
915,Karol Fila,0,0,0,0,0,0,0,,0,0,0,0,1,1,0
916,Vincenzo Fiorillo,0,0,0,0,0,0,0,,0,0,0,0,0,0,0
917,Roberto Firmino,17,12,2,12,3,4,22,18.2,18,16,1,15,7,2,0
918,Junior Firpo,47,25,27,15,5,24,46,52.2,22,23,7,16,24,40,0
919,Kilian Fischer,9,6,3,4,2,6,11,54.5,5,6,0,6,5,18,0
920,Mark Flekken,0,0,0,0,0,0,1,0.0,1,1,0,1,0,9,5
921,Florian Flick,12,3,7,5,0,4,14,28.6,10,9,3,6,4,18,0
922,Alexis Flips,51,30,18,17,16,27,64,42.2,37,35,5,30,24,12,0
923,Alessandro Florenzi,6,4,3,2,1,4,7,57.1,3,1,0,1,4,2,0
924,Phil Foden,16,10,9,5,2,8,19,42.1,11,25,2,23,5,12,0
925,Seko Fofana,28,13,8,18,2,15,39,38.5,24,17,4,13,19,14,0
926,Wesley Fofana,4,2,1,2,1,1,3,33.3,2,1,1,0,9,5,0
927,Wesley Fofana,30,18,19,7,4,13,26,50.0,13,17,10,7,20,33,2
928,Yahia Fofana,0,0,0,0,0,0,0,,0,0,0,0,1,4,1
929,Youssouf Fofana,81,41,31,42,8,38,74,51.4,36,50,6,44,56,32,1
930,Thomas Foket,35,22,18,11,6,17,46,37.0,29,21,7,14,33,29,2
931,José Fonte,23,17,18,4,1,10,21,47.6,11,27,14,13,25,112,2
932,Pablo Fornals,30,15,9,12,9,13,34,38.2,21,16,2,14,14,9,0
933,Emil Forsberg,16,11,1,8,7,6,20,30.0,14,25,2,23,3,7,0
934,Adam Forshaw,12,9,5,7,0,7,17,41.2,10,9,1,8,4,2,0
935,Fraser Forster,1,0,1,0,0,0,0,,0,1,0,1,0,3,1
936,Philipp Förster,31,19,11,15,5,12,40,30.0,28,22,0,22,6,6,0
937,Steven Fortes,0,0,0,0,0,0,0,,0,0,0,0,0,0,0
938,Timothy Fosu-Mensah,7,5,3,3,1,4,4,100.0,0,2,0,2,0,1,0
939,Dimitri Foulquier,31,19,17,8,6,20,28,71.4,8,19,3,16,14,40,0
940,Juan Foyth,73,48,49,22,2,41,57,71.9,16,32,11,21,20,68,0
941,Raphael Framberger,10,6,6,4,0,3,5,60.0,2,2,1,1,2,5,0
942,Tyrese Francois,0,0,0,0,0,0,1,0.0,1,0,0,0,0,1,0
943,Bartol Franjić,4,2,2,2,0,0,2,0.0,2,4,1,3,5,4,0
944,Przemysław Frankowski,77,51,37,31,9,39,80,48.8,41,38,6,32,41,42,2
945,Ryan Fraser,2,2,0,0,2,2,5,40.0,3,3,1,2,0,3,0
946,Davide Frattesi,63,36,24,29,10,25,44,56.8,19,27,6,21,16,42,0
947,Oscar Fraulo,0,0,0,0,0,0,0,,0,0,0,0,0,0,0
948,Fred,47,30,24,20,3,15,38,39.5,23,38,2,36,19,19,0
949,Ryan Fredericks,3,2,2,0,1,1,4,25.0,3,7,2,5,1,27,0
950,Iván Fresneda,48,34,31,13,4,29,47,61.7,18,32,8,24,15,60,0
951,Remo Freuler,43,23,23,15,5,19,43,44.2,24,36,9,27,29,45,0
952,Michael Frey,13,5,2,8,3,4,13,30.8,9,6,0,6,2,1,0
953,Marco Friedl,62,46,40,22,0,41,68,60.3,27,46,17,29,58,127,1
954,Marvin Friedrich,17,11,13,3,1,10,13,76.9,3,14,6,8,11,52,0
955,Jeremie Frimpong,53,27,22,26,5,23,44,52.3,21,24,3,21,16,40,0
956,Chris Führich,36,14,15,14,7,24,44,54.5,20,29,2,27,7,13,0
957,Angelo Fulgini,14,7,2,4,8,5,14,35.7,9,11,0,11,8,2,0
958,Angelo Fulgini,6,5,2,3,1,5,12,41.7,7,5,0,5,5,7,0
959,Niclas Füllkrug,9,4,0,6,3,3,13,23.1,10,13,4,9,1,24,0
960,Matteo Gabbia,17,10,12,5,0,6,8,75.0,2,8,3,5,5,29,0
961,Manolo Gabbiadini,23,15,8,9,6,9,23,39.1,14,16,2,14,6,25,0
962,Gianluca Gaetano,5,3,1,3,1,0,0,,0,1,0,1,1,0,0
963,Roberto Gagliardini,16,6,9,6,1,10,21,47.6,11,14,5,9,4,15,0
964,Adolfo Gaich,5,3,0,3,2,1,6,16.7,5,7,2,5,3,7,1
965,Cody Gakpo,26,15,4,13,9,13,38,34.2,25,13,1,12,4,2,0
966,Javi Galán,104,72,60,40,4,48,98,49.0,50,54,5,49,41,63,1
967,Iñigo Ruiz de Galarreta,54,38,27,23,4,20,52,38.5,32,26,9,17,30,19,0
968,Pablo Galdames Millán,14,10,8,3,3,5,33,15.2,28,13,2,11,10,13,0
969,Conor Gallagher,46,33,17,19,10,10,37,27.0,27,41,10,31,23,18,1
970,Antonino Gallo,56,36,35,12,9,38,57,66.7,19,37,6,31,13,71,0
971,Gauthier Gallon,2,2,2,0,0,2,4,50.0,2,0,0,0,2,17,0
972,Cristian Gamboa,42,24,27,14,1,21,31,67.7,10,20,7,13,16,34,1
973,Kévin Gameiro,20,10,6,10,4,8,28,28.6,20,10,1,9,9,0,0
974,Idrissa Gana Gueye,97,57,49,35,13,31,62,50.0,31,50,12,38,56,34,3
975,Ignatius Ganago,9,7,2,3,4,4,7,57.1,3,13,1,12,2,12,0
976,Ignatius Ganago,0,0,0,0,0,0,0,,0,0,0,0,0,1,0
977,Silvère Ganvoula M'Boussy,2,2,0,1,1,0,0,,0,0,0,0,0,3,0
978,Aleix García,37,20,9,18,10,15,33,45.5,18,24,8,16,31,35,1
979,Álvaro García,49,28,21,13,15,11,33,33.3,22,41,4,37,34,24,1
980,Borja García,10,4,7,2,1,2,9,22.2,7,3,1,2,5,6,1
981,Carlos García,0,0,0,0,0,0,0,,0,0,0,0,0,2,0
982,Dani García,46,27,17,25,4,29,47,61.7,18,21,6,15,19,21,1
983,David García,34,20,22,12,0,19,22,86.4,3,28,13,15,45,151,0
984,Eric García,24,16,16,5,3,9,20,45.0,11,23,10,13,19,36,1
985,Fran Garcia,84,54,53,23,8,55,96,57.3,41,49,8,41,44,66,0
986,Joan García,0,0,0,0,0,0,0,,0,0,0,0,0,0,0
987,Raúl García,12,8,3,4,5,5,15,33.3,10,13,1,12,6,9,0
988,Rubén García,20,11,12,4,4,7,24,29.2,17,14,1,13,12,13,0
989,Unai García,23,13,13,8,2,12,17,70.6,5,23,14,9,19,60,2
990,Alejandro Garnacho,5,2,2,0,3,1,11,9.1,10,5,0,5,5,3,0
991,James Garner,16,13,4,8,4,9,19,47.4,10,9,1,8,12,13,0
992,Felix Garreta,1,0,0,1,0,0,0,,0,1,1,0,1,4,0
993,Aleix Garrido,2,1,1,0,1,1,1,100.0,0,1,0,1,0,0,0
994,Sékou Gassama,0,0,0,0,0,0,0,,0,0,0,0,0,0,0
995,Johan Gastien,62,34,30,23,9,38,111,34.2,73,37,7,30,36,25,1
996,Federico Gatti,15,11,9,4,2,9,15,60.0,6,20,14,6,21,54,2
997,Gavi,47,31,7,30,10,21,55,38.2,34,32,5,27,18,22,0
998,Paulo Gazzaniga,0,0,0,0,0,0,1,0.0,1,0,0,0,1,9,5
999,David de Gea,0,0,0,0,0,0,1,0.0,1,0,0,0,1,15,3
1000,Dario Gebuhr,0,0,0,0,0,0,1,0.0,1,0,0,0,0,0,0
1001,Dennis Geiger,45,25,15,28,2,22,35,62.9,13,27,3,24,24,18,2
1002,Joe Gelhardt,6,2,1,3,2,3,5,60.0,2,5,0,5,0,4,0
1003,Valentin Gendrey,88,57,54,25,9,40,71,56.3,31,45,4,41,37,89,0
1004,Denis Genreau,35,13,16,12,7,13,31,41.9,18,16,1,15,8,9,0
1005,Yannick Gerhardt,29,15,10,11,8,12,30,40.0,18,26,5,21,7,24,0
1006,Valère Germain,13,11,3,5,5,4,12,33.3,8,8,0,8,6,12,0
1007,Gerson,6,4,1,4,1,3,5,60.0,2,5,0,5,2,4,0
1008,Ismaël Gharbi,0,0,0,0,0,0,2,0.0,2,2,0,2,3,0,0
1009,Paolo Ghiglione,16,11,10,3,3,10,23,43.5,13,9,4,5,4,12,0
1010,Saman Ghoddos,2,1,0,1,1,1,3,33.3,2,5,1,4,4,2,0
1011,Faouzi Ghoulam,3,3,1,1,1,3,5,60.0,2,4,2,2,4,12,1
1012,Morgan Gibbs-White,3,1,3,0,0,2,4,50.0,2,2,0,2,1,3,0
1013,Morgan Gibbs-White,26,14,7,7,12,11,33,33.3,22,23,4,19,14,15,0
1014,Niko Gießelmann,21,11,9,9,3,13,31,41.9,18,17,5,12,9,28,0
1015,Samuel Gigot,46,24,22,21,3,12,15,80.0,3,24,7,17,45,85,1
1016,Rafał Gikiewicz,2,2,2,0,0,2,3,66.7,1,0,0,0,0,15,5
1017,Bryan Gil,3,1,3,0,0,0,3,0.0,3,3,0,3,1,1,0
1018,Bryan Gil,22,11,11,7,4,10,23,43.5,13,10,0,10,8,10,0
1019,David Gil,0,0,0,0,0,0,0,,0,0,0,0,0,3,0
1020,Óscar Gil,63,37,38,16,9,32,61,52.5,29,51,18,33,31,55,1
1021,Mario Gila,3,1,3,0,0,0,1,0.0,1,0,0,0,3,3,0
1022,Billy Gilmour,5,2,2,2,1,2,8,25.0,6,5,2,3,6,5,0
1023,Álvaro Giménez,0,0,0,0,0,0,1,0.0,1,0,0,0,0,0,0
1024,Gvidas Gineitis,3,1,0,2,1,1,2,50.0,1,0,0,0,0,1,0
1025,Matthias Ginter,43,20,29,12,2,26,40,65.0,14,40,24,16,35,153,3
1026,Andrei Girotto,122,73,71,45,6,74,132,56.1,58,55,24,31,73,176,1
1027,Olivier Giroud,8,5,2,4,2,2,10,20.0,8,11,3,8,3,23,0
1028,Serge Gnabry,35,23,11,14,10,17,43,39.5,26,24,1,23,11,5,1
1029,Wilfried Gnonto,27,17,7,15,5,10,30,33.3,20,24,1,23,5,7,0
1030,Ben Godfrey,20,11,13,5,2,11,29,37.9,18,12,6,6,8,33,1
1031,Pierluigi Gollini,1,0,1,0,0,1,1,100.0,0,0,0,0,0,2,0
1032,Pierluigi Gollini,0,0,0,0,0,0,0,,0,0,0,0,0,1,0
1033,Aleksandr Golovin,62,36,19,32,11,28,72,38.9,44,28,1,27,37,10,0
1034,André Gomes,37,19,12,17,8,19,52,36.5,33,20,5,15,9,16,1
1035,Angel Gomes,41,19,12,21,8,18,49,36.7,31,22,2,20,13,11,1
1036,João Gomes,29,13,14,14,1,13,23,56.5,10,12,3,9,4,11,0
1037,Toti Gomes,15,9,11,4,0,9,13,69.2,4,16,8,8,11,51,0
1038,Dani Gómez,2,1,1,1,0,1,2,50.0,1,0,0,0,1,0,0
1039,Joe Gomez,28,21,15,11,2,11,19,57.9,8,17,11,6,24,51,2
1040,Maxi Gómez,0,0,0,0,0,0,0,,0,0,0,0,0,2,0
1041,Moi Gómez,26,17,9,14,3,15,32,46.9,17,15,3,12,10,5,1
1042,Papu Gómez,6,4,3,3,0,2,10,20.0,8,8,1,7,4,5,0
1043,Sergi Gómez,29,16,20,9,0,18,22,81.8,4,33,19,14,27,125,1
1044,Sergio Gómez,9,4,6,1,2,5,8,62.5,3,5,3,2,2,9,1
1045,Antonio Gomis,0,0,0,0,0,0,0,,0,0,0,0,0,0,0
1046,Maxime Gonalons,52,32,25,21,6,25,53,47.2,28,21,1,20,20,7,1
1047,Diego González,12,7,9,3,0,7,11,63.6,4,14,12,2,7,50,1
1048,Édgar González,28,19,18,7,3,14,27,51.9,13,12,9,3,21,120,0
1049,Giovanni González,16,8,11,2,3,9,22,40.9,13,8,2,6,7,22,0
1050,Joan Gonzàlez,48,28,20,18,10,17,51,33.3,34,37,8,29,16,28,0
1051,Nicolás González,17,10,3,10,4,5,16,31.3,11,14,0,14,4,6,0
1052,Nicolás González,27,15,11,13,3,9,25,36.0,16,21,7,14,19,16,0
1053,Oumar Gonzalez,51,28,34,13,4,23,37,62.2,14,32,11,21,52,82,0
1054,Roberto González,0,0,0,0,0,0,1,0.0,1,0,0,0,1,0,0
1055,Jacek Góralski,6,3,3,3,0,4,6,66.7,2,4,0,4,3,5,0
1056,Anthony Gordon,14,12,5,7,2,9,20,45.0,11,9,1,8,2,1,1
1057,Anthony Gordon,34,22,17,10,7,8,24,33.3,16,19,0,19,4,11,0
1058,Leon Goretzka,43,24,21,16,6,27,48,56.3,21,40,3,37,30,32,0
1059,Andoni Gorosabel,41,25,23,9,9,26,43,60.5,17,21,2,19,17,23,0
1060,Robin Gosens,34,18,15,10,9,15,25,60.0,10,16,2,14,23,15,0
1061,Mario Götze,42,25,13,22,7,14,47,29.8,33,25,0,25,13,12,0
1062,Amine Gouiri,1,1,1,0,0,0,1,0.0,1,1,0,1,0,3,0
1063,Amine Gouiri,42,25,14,16,12,14,33,42.4,19,21,0,21,12,10,0
1064,Jeffrey Gouweleeuw,42,27,19,17,6,24,49,49.0,25,41,23,18,50,141,2
1065,Jonathan Gradit,62,40,30,25,7,31,53,58.5,22,40,26,14,38,83,0
1066,José Gragera,19,9,11,6,2,6,11,54.5,5,10,4,6,7,18,0
1067,Alberto Grassi,26,21,13,13,0,15,24,62.5,9,23,12,11,27,45,0
1068,Ryan Gravenberch,17,8,4,10,3,7,13,53.8,6,9,1,8,9,10,0
1069,Andrew Gravillon,3,3,0,3,0,0,0,,0,4,2,2,9,16,0
1070,Andrew Gravillon,16,8,9,6,1,8,13,61.5,5,18,9,9,21,36,0
1071,Demarai Gray,33,24,9,14,10,17,31,54.8,14,23,3,20,13,18,0
1072,Adrian Grbić,0,0,0,0,0,0,1,0.0,1,3,0,3,0,0,0
1073,Ivo Grbić,0,0,0,0,0,0,0,,0,0,0,0,0,9,1
1074,Jack Grealish,25,16,10,12,3,13,23,56.5,10,17,3,14,7,9,0
1075,Sam Greenwood,15,7,7,8,0,8,21,38.1,13,10,2,8,1,1,0
1076,Michael Gregoritsch,19,12,6,9,4,3,21,14.3,18,23,4,19,5,10,0
1077,Dominik Greif,0,0,0,0,0,0,0,,0,0,0,0,0,0,0
1078,Leo Greiml,10,5,4,5,1,5,12,41.7,7,7,3,4,3,16,0
1079,Clément Grenier,20,8,6,12,2,10,20,50.0,10,9,1,8,6,7,0
1080,Antoine Griezmann,49,34,15,23,11,20,66,30.3,46,34,3,31,24,31,0
1081,Vincenzo Grifo,29,16,6,15,8,13,31,41.9,18,18,1,17,19,19,0
1082,Lennart Grill,0,0,0,0,0,0,1,0.0,1,0,0,0,0,1,1
1083,Christian Groß,56,25,20,34,2,29,60,48.3,31,20,5,15,23,38,1
1084,Pascal Groß,59,38,23,27,9,25,55,45.5,30,32,10,22,13,21,1
1085,Brajan Gruda,0,0,0,0,0,0,0,,0,0,0,0,0,0,0
1086,Ilia Gruev,44,27,16,25,3,18,31,58.1,13,23,6,17,22,21,1
1087,Carlos Gruezo,21,12,12,9,0,9,16,56.3,7,13,4,9,10,15,0
1088,Vicente Guaita,0,0,0,0,0,0,0,,0,0,0,0,0,9,1
1089,Andrés Guardado,41,25,17,20,4,18,43,41.9,25,14,5,9,23,29,0
1090,Sergi Guardiola,12,7,6,5,1,2,4,50.0,2,6,0,6,2,7,0
1091,Sergi Guardiola,9,7,0,6,3,3,12,25.0,9,5,0,5,3,7,0
1092,Nemanja Gudelj,43,33,22,18,3,20,33,60.6,13,39,29,10,34,102,1
1093,Gabriel Gudmundsson,19,11,7,10,2,12,22,54.5,10,11,2,9,10,20,0
1094,Gonçalo Guedes,8,6,4,3,1,5,8,62.5,3,4,0,4,1,2,0
1095,Axel Gueguin,0,0,0,0,0,0,0,,0,1,0,1,0,0,0
1096,Marc Guéhi,52,27,39,11,2,26,42,61.9,16,45,24,21,45,134,3
1097,Mattéo Guendouzi,39,18,9,21,9,14,38,36.8,24,12,5,7,21,18,0
1098,Javier Guerra,16,13,7,4,5,9,20,45.0,11,8,1,7,11,9,0
1099,Raphaël Guerreiro,36,20,13,15,8,21,34,61.8,13,21,2,19,36,23,0
1100,Axel Guessand,2,1,2,0,0,1,2,50.0,1,1,0,1,2,3,0
1101,Evann Guessand,24,16,8,13,3,6,12,50.0,6,17,1,16,9,6,0
1102,Ander Guevara,5,2,2,2,1,1,4,25.0,3,6,1,5,2,3,0
1103,Pape Gueye,37,22,13,21,3,16,33,48.5,17,21,5,16,22,10,0
1104,Pape Gueye,18,7,10,7,1,7,15,46.7,8,9,2,7,9,2,0
1105,Josuha Guilavogui,18,11,7,10,1,6,17,35.3,11,19,13,6,23,52,0
1106,Frederic Guilbert,47,29,18,23,6,25,43,58.1,18,24,3,21,43,33,1
1107,Hugo Guillamón,20,12,10,8,2,8,24,33.3,16,14,2,12,19,30,2
1108,Bruno Guimarães,78,40,27,46,5,38,65,58.5,27,28,4,24,36,22,1
1109,Serhou Guirassy,0,0,0,0,0,0,0,,0,0,0,0,0,0,0
1110,Serhou Guirassy,4,1,2,2,0,1,2,50.0,1,7,2,5,0,14,0
1111,Rafik Guitane,0,0,0,0,0,0,0,,0,0,0,0,0,1,0
1112,Péter Gulácsi,0,0,0,0,0,0,0,,0,0,0,0,0,2,0
1113,Manuel Gulde,14,8,10,4,0,2,4,50.0,2,5,1,4,19,25,0
1114,Gerard Gumbau,44,25,17,23,4,18,51,35.3,33,32,8,24,28,40,0
1115,Robert Gumny,34,24,13,15,6,11,27,40.7,16,21,7,14,26,62,1
1116,İlkay Gündoğan,30,18,7,13,10,12,34,35.3,22,18,3,15,20,13,0
1117,Christian Günter,29,21,18,9,2,13,43,30.2,30,22,4,18,16,41,0
1118,Koray Günter,10,6,1,8,1,4,7,57.1,3,24,15,9,30,46,0
1119,Koray Günter,10,8,6,4,0,6,9,66.7,3,10,5,5,11,46,0
1120,Gorka Guruzeta,24,20,6,12,6,11,24,45.8,13,23,2,21,4,8,0
1121,Malo Gusto,42,26,23,11,8,21,43,48.8,22,22,5,17,28,23,1
1122,Raúl Guti,18,12,8,9,1,8,18,44.4,10,10,3,7,8,6,0
1123,Miguel Gutiérrez,41,23,23,13,5,23,37,62.2,14,23,5,18,18,42,1
1124,Joško Gvardiol,23,17,15,8,0,9,22,40.9,13,34,17,17,34,76,1
1125,Darko Gyabi,2,2,1,1,0,0,0,,0,2,0,2,0,0,0
1126,Emmanuel Gyasi,24,15,11,10,3,9,36,25.0,27,24,6,18,8,26,0
1127,Norbert Gyömbér,32,23,25,6,1,16,24,66.7,8,33,22,11,35,92,0
1128,Christian Gytkjær,6,2,1,4,1,2,5,40.0,3,6,1,5,0,2,0
1129,Erling Haaland,3,2,0,2,1,1,5,20.0,4,12,4,8,3,14,0
1130,Nicolas Haas,27,13,16,6,5,12,24,50.0,12,16,4,12,8,27,0
1131,Janik Haberer,29,17,8,18,3,17,48,35.4,31,35,2,33,14,25,0
1132,Alexander Hack,30,18,21,9,0,19,33,57.6,14,18,5,13,24,45,1
1133,Munir El Haddadi,12,7,3,7,2,2,10,20.0,8,23,2,21,9,7,0
1134,Jaouen Hadjam,27,21,13,9,5,16,25,64.0,9,10,3,7,12,12,0
1135,Dennis Hadzikadunic,9,6,4,5,0,4,4,100.0,0,5,4,1,3,27,0
1136,André Hahn,9,5,4,4,1,8,12,66.7,4,9,2,7,4,14,0
1137,Amadou Haidara,25,11,15,10,0,13,34,38.2,21,26,6,20,26,20,0
1138,Massadio Haïdara,24,16,9,9,6,12,24,50.0,12,26,9,17,36,39,1
1139,Achraf Hakimi,54,34,19,20,15,31,59,52.5,28,34,2,32,16,19,0
1140,Lewis Hall,23,12,19,4,0,15,22,68.2,7,8,0,8,11,11,1
1141,Sébastien Haller,5,4,2,1,2,0,4,0.0,4,8,0,8,1,10,0
1142,Marcel Halstenberg,40,21,20,15,5,23,41,56.1,18,22,1,21,21,29,0
1143,Mathis Hamdi,0,0,0,0,0,0,1,0.0,1,0,0,0,1,1,0
1144,Ben Hamed Touré,4,4,2,2,0,1,5,20.0,4,2,0,2,1,4,0
1145,Romain Hamouma,8,3,3,3,2,3,6,50.0,3,8,0,8,2,2,0
1146,Saïd Hamulic,0,0,0,0,0,0,0,,0,0,0,0,0,0,0
1147,Andreas Hanche-Olsen,35,23,24,7,4,22,39,56.4,17,16,8,8,33,77,2
1148,Samir Handanović,0,0,0,0,0,0,0,,0,0,0,0,0,5,0
1149,Genki Haraguchi,16,7,7,7,2,4,16,25.0,12,13,2,11,8,6,0
1150,Genki Haraguchi,12,8,1,10,1,3,9,33.3,6,7,1,6,3,9,0
1151,Amine Harit,6,4,0,3,3,3,8,37.5,5,4,1,3,4,6,0
1152,Luke Harris,0,0,0,0,0,0,0,,0,0,0,0,0,0,0
1153,Jack Harrison,41,17,5,15,21,12,52,23.1,40,47,2,45,22,25,0
1154,Abdou Harroui,17,6,6,7,4,2,7,28.6,5,6,1,5,2,10,0
1155,Makoto Hasebe,18,12,16,2,0,7,22,31.8,15,22,9,13,17,45,0
1156,Haissem Hassan,0,0,0,0,0,0,2,0.0,2,0,0,0,1,0,0
1157,Hans Hateboer,21,13,11,8,2,11,27,40.7,16,23,4,19,12,25,0
1158,Kai Havertz,34,16,4,20,10,10,30,33.3,20,28,0,28,7,41,0
1159,Eden Hazard,0,0,0,0,0,0,2,0.0,2,1,0,1,1,0,0
1160,Thorgan Hazard,17,6,5,11,1,12,17,70.6,5,6,0,6,5,5,0
1161,Rhys Healey,0,0,0,0,0,0,0,,0,0,0,0,0,0,0
1162,Jan Paul van Hecke,8,6,3,4,1,5,5,100.0,0,8,5,3,6,9,0
1163,Jonas Hector,112,66,59,43,10,66,113,58.4,47,61,9,52,39,74,1
1164,Hwang Hee-chan,20,9,7,8,5,6,20,30.0,14,18,2,16,5,5,0
1165,Gauthier Hein,27,20,13,11,3,18,48,37.5,30,10,0,10,6,10,0
1166,Dominique Heintz,13,9,5,7,1,6,17,35.3,11,11,7,4,12,34,0
1167,Dean Henderson,0,0,0,0,0,0,0,,0,0,0,0,0,12,1
1168,Jordan Henderson,32,23,10,18,4,15,36,41.7,21,21,3,18,21,16,1
1169,Liam Henderson,13,10,6,5,2,4,21,19.0,17,10,2,8,10,10,0
1170,Jack Hendry,0,0,0,0,0,0,1,0.0,1,2,1,1,1,7,0
1171,Wayne Hennessey,1,0,1,0,0,1,1,100.0,0,0,0,0,0,2,0
1172,Benjamin Henrichs,73,46,41,29,3,43,66,65.2,23,48,4,44,35,46,0
1173,Henrique,9,4,3,2,4,6,13,46.2,7,3,1,2,5,8,0
1174,Luiz Henrique,48,34,27,15,6,20,44,45.5,24,22,0,22,14,17,0
1175,Matheus Henrique,26,12,9,11,6,12,24,50.0,12,15,4,11,12,10,0
1176,Rico Henry,57,31,20,28,9,22,41,53.7,19,29,8,21,30,84,1
1177,Thomas Henry,5,3,1,1,3,1,5,20.0,4,6,2,4,0,14,0
1178,Christophe Hérelle,10,4,7,2,1,4,13,30.8,9,16,11,5,20,48,0
1179,Mario Hermoso,22,15,14,6,2,9,30,30.0,21,19,9,10,19,85,1
1180,Javi Hernández,21,12,12,7,2,13,21,61.9,8,10,5,5,7,38,0
1181,Aridane Hernández,21,15,17,4,0,12,25,48.0,13,34,21,13,28,96,1
1182,Lucas Hernández,6,4,3,3,0,5,6,83.3,1,2,1,1,5,7,0
1183,Luis Hernández,33,21,25,7,1,22,36,61.1,14,31,24,7,31,145,0
1184,Mario Hernández,3,2,2,1,0,3,7,42.9,4,2,0,2,2,0,0
1185,Theo Hernández,43,24,27,15,1,22,38,57.9,16,34,7,27,21,35,1
1186,Jorge Herrando,0,0,0,0,0,0,0,,0,1,0,1,0,3,0
1187,Ander Herrera,18,10,8,7,3,6,18,33.3,12,12,3,9,11,12,0
1188,Sergio Herrera,2,0,2,0,0,2,2,100.0,0,1,0,1,1,6,2
1189,Yangel Herrera,26,9,9,14,3,6,15,40.0,9,14,1,13,4,12,0
1190,Patrick Herrmann,6,2,4,1,1,2,4,50.0,2,2,0,2,2,1,0
1191,Son Heung-min,24,12,7,8,9,9,30,30.0,21,23,2,21,13,6,0
1192,Aaron Hickey,38,26,27,11,0,18,32,56.3,14,18,7,11,17,32,1
1193,Isak Hien,73,36,54,19,0,38,61,62.3,23,40,17,23,31,92,1
1194,Omar El Hilali,3,2,3,0,0,1,2,50.0,1,1,0,1,1,6,0
1195,Piero Hincapié,51,34,28,20,3,25,38,65.8,13,41,20,21,31,83,1
1196,Jack Hinshelwood,1,0,1,0,0,0,0,,0,0,0,0,0,0,0
1197,Morten Hjulmand,90,52,49,40,1,37,67,55.2,30,43,11,32,72,54,0
1198,Adam Hložek,9,4,4,3,2,3,9,33.3,6,9,2,7,6,9,0
1199,Joseph Hodge,5,2,1,3,1,3,4,75.0,1,5,0,5,0,2,1
1200,Nicolas Höfler,66,35,28,35,3,27,61,44.3,34,40,13,27,58,49,0
1201,Jonas Hofmann,31,16,17,8,6,15,52,28.8,37,36,2,34,16,21,0
1202,Philipp Hofmann,18,11,0,13,5,5,12,41.7,7,20,8,12,6,48,0
1203,Rob Holding,8,5,4,4,0,3,6,50.0,3,6,5,1,3,27,1
1204,Lucas Höler,19,14,5,7,7,6,22,27.3,16,22,5,17,10,17,0
1205,Mason Holgate,11,7,8,3,0,3,11,27.3,8,7,3,4,7,28,0
1206,Emil Holm,26,15,13,8,5,16,31,51.6,15,21,6,15,9,41,0
1207,Noah Holm,6,4,2,2,2,2,5,40.0,3,0,0,0,0,5,0
1208,Gerrit Holtmann,14,7,6,7,1,12,21,57.1,9,15,1,14,2,4,0
1209,Martin Hongla,8,5,4,4,0,5,5,100.0,0,7,1,6,6,9,0
1210,Martin Hongla,18,13,13,5,0,11,21,52.4,10,15,12,3,8,46,1
1211,Franck Honorat,41,29,20,8,13,19,34,55.9,15,22,2,20,21,18,0
1212,Jannes Horn,2,1,1,1,0,1,1,100.0,0,1,0,1,3,2,0
1213,Cédric Hountondji,50,36,31,17,2,19,29,65.5,10,44,22,22,59,132,1
1214,Ilyes Housni,1,1,1,0,0,1,1,100.0,0,0,0,0,0,0,0
1215,Lukáš Hrádecký,0,0,0,0,0,0,0,,0,0,0,0,0,3,3
1216,Petko Hristov,6,4,2,4,0,5,8,62.5,3,4,2,2,4,12,0
1217,Ajdin Hrustic,2,1,1,1,0,1,2,50.0,1,2,0,2,0,2,1
1218,Timo Hübers,43,28,35,8,0,24,52,46.2,28,27,13,14,58,153,0
1219,Callum Hudson-Odoi,5,3,4,0,1,1,1,100.0,0,0,0,0,2,4,0
1220,Will Hughes,29,16,11,16,2,11,20,55.0,9,16,7,9,16,9,0
1221,Mats Hummels,62,34,38,22,2,32,55,58.2,23,30,16,14,33,100,1
1222,Adrien Hunou,39,20,17,16,6,16,45,35.6,29,35,0,35,7,7,0
1223,Denis Huseinbasic,23,9,8,11,4,10,25,40.0,15,16,2,14,4,5,0
1224,Omari Hutchinson,0,0,0,0,0,0,0,,0,0,0,0,1,0,0
1225,Elseid Hysaj,39,23,24,11,4,23,41,56.1,18,31,7,24,20,42,0
1226,Pierre Højbjerg,56,30,28,22,6,26,67,38.8,41,46,17,29,49,64,1
1227,Rasmus Højlund,4,3,0,2,2,1,6,16.7,5,9,1,8,1,5,0
1228,Iago,34,16,20,10,4,11,29,37.9,18,18,5,13,17,53,0
1229,Pablo Ibáñez,29,13,7,17,5,12,35,34.3,23,19,2,17,8,24,0
1230,Roger Ibanez,67,33,38,26,3,32,48,66.7,16,30,11,19,66,95,2
1231,Arijon Ibrahimović,1,1,1,0,0,0,0,,0,0,0,0,0,0,0
1232,Zlatan Ibrahimović,0,0,0,0,0,0,0,,0,1,1,0,0,2,0
1233,Mounaim El Idrissy,32,19,5,20,7,10,36,27.8,26,22,0,22,13,20,0
1234,Antonio Iervolino,0,0,0,0,0,0,1,0.0,1,0,0,0,0,0,0
1235,Iglesias,61,35,40,18,3,33,65,50.8,32,40,5,35,21,91,1
1236,Borja Iglesias,8,4,3,3,2,2,13,15.4,11,9,1,8,1,17,0
1237,Igor,43,29,21,18,4,20,27,74.1,7,33,14,19,25,56,2
1238,Kelechi Iheanacho,7,2,0,3,4,3,10,30.0,7,9,1,8,0,8,0
1239,Jonathan Ikone,16,8,5,6,5,5,14,35.7,9,18,1,17,4,3,0
1240,Ivan Ilić,16,10,9,7,0,6,11,54.5,5,10,1,9,8,14,0
1241,Ivan Ilić,18,7,6,11,1,10,20,50.0,10,12,3,9,5,10,0
1242,Rareş Ilie,3,3,0,1,2,2,4,50.0,2,2,0,2,1,1,0
1243,Samuel Iling-Junior,7,2,3,1,3,4,9,44.4,5,5,1,4,2,6,0
1244,Emirhan İlkhan,1,1,0,1,0,1,1,100.0,0,3,1,2,2,2,0
1245,Emirhan İlkhan,6,3,2,2,2,2,3,66.7,1,5,1,4,0,3,0
1246,Asier Illarramendi,36,18,10,22,4,16,44,36.4,28,27,8,19,18,20,0
1247,Ciro Immobile,11,5,4,4,3,6,9,66.7,3,10,2,8,1,14,0
1248,Danny Ings,9,8,0,4,5,5,14,35.7,9,8,2,6,3,5,0
1249,Danny Ings,10,5,1,6,3,1,6,16.7,5,12,1,11,1,11,0
1250,Marcus Ingvartsen,4,1,0,2,2,1,10,10.0,9,9,1,8,4,10,0
1251,Bonke Innocent,28,17,13,14,1,11,36,30.6,25,22,5,17,26,31,0
1252,Alexander Isak,18,8,4,7,7,10,28,35.7,18,21,2,19,4,8,0
1253,Alexander Isak,1,1,0,0,1,0,0,,0,0,0,0,0,2,0
1254,Isco,15,9,6,5,4,8,14,57.1,6,3,0,3,10,3,0
1255,Ismaily,41,18,16,16,9,17,32,53.1,15,25,5,20,21,39,0
1256,Ardian Ismajli,40,32,25,15,0,18,24,75.0,6,47,31,16,27,120,0
1257,Ko Itakura,29,17,18,7,4,16,30,53.3,14,41,25,16,27,95,0
1258,Hiroki Ito,40,29,24,14,2,18,35,51.4,17,38,17,21,40,94,0
1259,Junya Ito,40,20,14,15,11,13,53,24.5,40,29,1,28,8,4,1
1260,Diego Iturralde,1,0,1,0,0,0,2,0.0,2,0,0,0,0,1,0
1261,Andreas Ivan,0,0,0,0,0,0,1,0.0,1,0,0,0,0,1,0
1262,Mihailo Ivanović,0,0,0,0,0,0,0,,0,0,0,0,0,0,0
1263,Daniel Iversen,0,0,0,0,0,0,0,,0,0,0,0,0,6,1
1264,Alex Iwobi,69,37,37,28,4,33,65,50.8,32,41,2,39,25,29,0
1265,Armando Izzo,73,50,44,27,2,29,45,64.4,16,29,17,12,50,87,1
1266,Nicolas Jackson,14,11,2,10,2,2,8,25.0,6,18,2,16,2,4,0
1267,Lee Jae-sung,38,17,9,21,8,16,36,44.4,20,29,5,24,17,21,0
1268,Paul Jaeckel,24,18,11,11,2,17,35,48.6,18,11,5,6,19,44,1
1269,Mato Jajalo,0,0,0,0,0,0,1,0.0,1,0,0,0,0,2,0
1270,Kristijan Jakić,33,21,19,12,2,22,41,53.7,19,32,10,22,14,49,1
1271,Ismail Jakobs,11,5,7,3,1,5,12,41.7,7,9,1,8,9,18,0
1272,Marin Jakoliš,1,1,0,0,1,0,0,,0,0,0,0,0,0,0
1273,Daniel James,6,2,1,3,2,3,6,50.0,3,4,0,4,2,2,0
1274,Daniel James,10,6,4,5,1,4,9,44.4,5,5,1,4,1,5,0
1275,Reece James,31,20,10,18,3,15,19,78.9,4,17,2,15,12,23,0
1276,Vitaly Janelt,54,27,20,24,10,21,49,42.9,28,29,9,20,29,26,0
1277,Saidy Janko,23,15,13,8,2,12,20,60.0,8,24,10,14,11,33,1
1278,Pontus Jansson,5,3,4,1,0,3,5,60.0,2,13,9,4,9,38,0
1279,Tony Jantschke,2,1,1,1,0,1,1,100.0,0,5,3,2,0,5,0
1280,Adnan Januzaj,0,0,0,0,0,0,1,0.0,1,0,0,0,1,0,0
1281,Léo Jardim,0,0,0,0,0,0,1,0.0,1,0,0,0,0,0,1
1282,Luis Javier Suárez,17,11,5,6,6,6,26,23.1,20,13,3,10,3,10,0
1283,Luis Javier Suárez,4,1,1,2,1,1,4,25.0,3,1,0,1,3,6,0
1284,Dany Jean,0,0,0,0,0,0,1,0.0,1,1,0,1,0,0,0
1285,Julian Jeanvier,32,17,24,8,0,13,22,59.1,9,24,17,7,27,96,1
1286,Jeffinho,17,4,4,9,4,6,15,40.0,9,6,0,6,1,0,0
1287,Fredrik Jensen,15,10,8,3,4,5,10,50.0,5,12,5,7,4,12,0
1288,Mathias Jensen,71,36,29,30,12,34,97,35.1,63,54,5,49,32,24,1
1289,Moritz Jenz,14,11,8,5,1,5,8,62.5,3,16,10,6,8,53,1
1290,Jesé,2,0,0,2,0,0,1,0.0,1,3,1,2,1,2,0
1291,Gabriel Jesus,33,25,16,8,9,15,31,48.4,16,27,3,24,11,15,1
1292,Juan Jesus,16,11,9,6,1,9,12,75.0,3,18,11,7,10,29,0
1293,Raúl Jiménez,9,6,3,5,1,3,6,50.0,3,9,0,9,0,8,0
1294,Joaquín,3,3,2,1,0,1,3,33.3,2,7,2,5,4,5,0
1295,Joelinton,70,49,36,26,8,26,62,41.9,36,52,7,45,48,39,0
1296,Þórir Jóhann Helgason,2,2,1,0,1,2,3,66.7,1,3,1,2,3,3,0
1297,Ben Johnson,20,14,12,4,4,12,18,66.7,6,12,4,8,9,28,1
1298,Brennan Johnson,34,20,18,8,8,8,29,27.6,21,30,1,29,5,7,1
1299,Sam Johnstone,0,0,0,0,0,0,0,,0,0,0,0,0,5,0
1300,Paul Joly,33,21,21,10,2,19,35,54.3,16,13,2,11,24,29,2
1301,Curtis Jones,34,17,8,12,14,18,31,58.1,13,12,2,10,3,9,0
1302,Frenkie de Jong,46,26,16,21,9,17,41,41.5,24,11,1,10,35,22,1
1303,Joan Jordán,32,17,13,17,2,16,38,42.1,22,14,7,7,16,14,2
1304,Jorginho,18,13,6,10,2,5,24,20.8,19,7,2,5,9,8,0
1305,Jorginho,42,23,22,14,6,22,46,47.8,24,18,3,15,21,7,0
1306,Josan,25,20,20,5,0,14,27,51.9,13,8,0,8,7,15,1
1307,Willian José,9,6,6,3,0,4,9,44.4,5,4,0,4,1,15,0
1308,Joselu,13,11,3,4,6,4,17,23.5,13,25,4,21,8,43,0
1309,Mateo Joseph,0,0,0,0,0,0,0,,0,1,0,1,0,1,0
1310,Diogo Jota,23,15,8,8,7,12,37,32.4,25,5,0,5,3,11,0
1311,Stevan Jovetić,3,2,2,1,0,1,11,9.1,10,2,1,1,2,10,0
1312,Luka Jović,6,3,1,4,1,2,8,25.0,6,7,2,5,2,10,0
1313,Juanmi,14,10,4,7,3,7,31,22.6,24,10,0,10,4,4,0
1314,Juanpe,19,11,10,9,0,11,17,64.7,6,12,9,3,10,60,1
1315,Jubal,41,26,29,11,1,19,38,50.0,19,57,34,23,53,193,0
1316,Christopher Jullien,46,28,29,14,3,28,51,54.9,23,35,18,17,43,114,1
1317,Anthony Jung,46,27,19,20,7,31,58,53.4,27,30,6,24,22,63,0
1318,Eli Junior Kroupi,0,0,0,0,0,0,1,0.0,1,0,0,0,1,0,0
1319,Lago Junior,1,0,0,1,0,1,1,100.0,0,0,0,0,0,0,0
1320,Hamed Junior Traorè,17,11,5,9,3,6,18,33.3,12,9,0,9,2,1,0
1321,Hamed Junior Traorè,11,6,4,6,1,4,11,36.4,7,4,0,4,2,0,1
1322,Vinicius Júnior,30,21,10,12,8,14,39,35.9,25,24,1,23,6,1,0
1323,Josip Juranović,9,7,5,2,2,7,18,38.9,11,9,3,6,6,22,1
1324,James Justin,20,18,7,12,1,9,18,50.0,9,24,6,18,15,47,0
1325,Filip Jørgensen,0,0,0,0,0,0,1,0.0,1,0,0,0,0,0,0
1326,Mathias Jørgensen,17,8,9,8,0,9,21,42.9,12,19,12,7,16,39,1
1327,Ozan Kabak,51,34,27,21,3,17,30,56.7,13,35,23,12,45,83,0
1328,Issa Kaboré,33,19,10,18,5,21,32,65.6,11,11,1,10,12,21,1
1329,Abdoul Kader Bamba,0,0,0,0,0,0,2,0.0,2,3,1,2,0,1,0
1330,Pavel Kadeřábek,26,20,10,9,7,15,23,65.2,8,12,2,10,14,37,1
1331,Tino Kadewere,6,3,3,3,0,4,9,44.4,5,6,2,4,2,1,0
1332,Kaiky,5,5,5,0,0,3,7,42.9,4,18,10,8,11,28,0
1333,Florian Kainz,21,10,7,12,2,8,26,30.8,18,27,6,21,32,30,1
1334,Gaël Kakuta,0,0,0,0,0,0,0,,0,0,0,0,0,1,0
1335,Sasa Kalajdzic,0,0,0,0,0,0,0,,0,0,0,0,1,0,0
1336,Sasa Kalajdzic,3,2,0,1,2,1,3,33.3,2,1,0,1,0,0,0
1337,Arnaud Kalimuendo,15,8,3,6,6,5,20,25.0,15,15,2,13,2,9,0
1338,Yayah Kallon,14,10,5,4,5,7,12,58.3,5,10,0,10,8,5,0
1339,Gedeon Kalulu,64,34,43,14,7,30,48,62.5,18,32,3,29,28,79,2
1340,Pierre Kalulu,57,39,33,21,3,28,42,66.7,14,41,17,24,41,56,1
1341,Justin-Noël Kalumba,9,5,5,2,2,5,16,31.3,11,4,1,3,4,5,0
1342,Daichi Kamada,51,31,10,37,4,31,57,54.4,26,31,2,29,16,17,1
1343,Waren Kamanzi,16,9,9,5,2,13,19,68.4,6,8,2,6,8,9,0
1344,Bingourou Kamara,0,0,0,0,0,0,0,,0,0,0,0,0,2,0
1345,Boubacar Kamara,58,25,25,23,10,27,56,48.2,29,38,12,26,19,24,3
1346,Jakub Kamiński,36,25,15,13,8,20,40,50.0,20,37,2,35,8,15,0
1347,Marcin Kamiński,6,4,4,0,2,2,4,50.0,2,8,7,1,9,28,0
1348,Kevin Kampl,21,11,6,14,1,6,27,22.2,21,26,9,17,22,11,0
1349,Nordine Kandil,3,2,1,2,0,0,3,0.0,3,2,0,2,1,1,0
1350,Harry Kane,15,12,1,6,8,7,21,33.3,14,27,7,20,2,18,0
1351,Lee Kang-in,42,24,10,22,10,18,61,29.5,43,25,2,23,11,7,0
1352,Wilfried Kanga,5,4,2,1,2,2,4,50.0,2,14,3,11,2,13,0
1353,N'Golo Kanté,16,10,4,10,2,4,8,50.0,4,11,0,11,6,2,0
1354,Kenan Karaman,11,8,3,5,3,3,12,25.0,9,9,1,8,3,9,0
1355,Yann Karamoh,5,2,3,2,0,1,5,20.0,4,5,0,5,0,2,1
1356,Atakan Karazor,49,30,18,25,6,24,47,51.1,23,39,11,28,31,44,0
1357,Ayman Kari,0,0,0,0,0,0,0,,0,4,0,4,3,0,0
1358,Jon Karrikaburu,1,0,0,1,0,0,0,,0,2,0,2,0,0,0
1359,Rick Karsdorp,21,13,11,7,3,13,22,59.1,9,0,0,0,7,15,1
1360,Denso Kasius,12,6,7,4,1,8,10,80.0,2,6,3,3,3,6,0
1361,Thomas Kastanaras,0,0,0,0,0,0,0,,0,1,0,1,0,0,0
1362,Grigoris Kastanos,39,23,18,19,2,16,40,40.0,24,20,6,14,8,8,0
1363,Silas Katompa,25,17,5,14,6,6,20,30.0,14,17,2,15,8,1,0
1364,Moise Kean,8,6,2,5,1,3,7,42.9,4,4,0,4,5,2,0
1365,Michael Keane,7,4,5,2,0,5,8,62.5,3,12,7,5,14,55,1
1366,Neeskens Kebano,17,9,8,6,3,9,18,50.0,9,14,0,14,1,8,0
1367,Kévin Keben Biakolo,3,2,2,0,1,0,4,0.0,4,1,0,1,5,9,0
1368,Thilo Kehrer,43,24,25,14,4,21,45,46.7,24,16,6,10,34,76,1
1369,Check Keita,12,9,9,3,0,4,9,44.4,5,6,5,1,5,24,1
1370,Naby Keïta,5,4,2,3,0,1,4,25.0,3,1,0,1,2,3,0
1371,Yannik Keitel,11,7,4,6,1,3,5,60.0,2,6,3,3,13,8,0
1372,Caoimhín Kelleher,0,0,0,0,0,0,0,,0,0,0,0,0,0,0
1373,Lloyd Kelly,33,18,23,9,1,13,19,68.4,6,26,15,11,26,101,1
1374,Marc-Oliver Kempf,44,27,29,14,1,16,22,72.7,6,42,32,10,51,143,0
1375,Kenedy,6,2,3,3,0,2,4,50.0,2,2,0,2,1,0,0
1376,Jonjoe Kenny,46,34,27,16,3,24,42,57.1,18,38,9,29,46,74,0
1377,Franck Kessié,15,9,6,6,3,8,18,44.4,10,10,2,8,12,11,2
1378,Saîf-Eddine Khaoui,47,28,14,25,8,15,47,31.9,32,17,2,15,33,8,0
1379,Wahbi Khazri,26,13,13,7,6,6,25,24.0,19,17,1,16,9,20,0
1380,Rani Khedira,60,33,21,32,7,25,50,50.0,25,33,10,23,40,33,0
1381,Anthony Khelifa,0,0,0,0,0,0,0,,0,0,0,0,0,0,0
1382,Kiké,6,3,0,4,2,2,5,40.0,3,6,1,5,1,13,0
1383,Luca Kilian,22,16,14,7,1,12,21,57.1,9,16,8,8,11,48,0
1384,Max Kilman,36,20,26,9,1,16,30,53.3,14,70,42,28,19,164,1
1385,Joshua Kimmich,78,49,24,46,8,38,72,52.8,34,36,7,29,41,39,2
1386,Presnel Kimpembe,17,8,9,6,2,9,13,69.2,4,12,7,5,13,9,1
1387,Jakub Kiwior,7,5,6,1,0,5,8,62.5,3,5,3,2,6,10,0
1388,Jakub Kiwior,22,17,15,7,0,6,24,25.0,18,26,18,8,24,71,1
1389,Simon Kjær,15,8,9,6,0,7,11,63.6,4,14,11,3,9,35,1
1390,Pascal Klemens,0,0,0,0,0,0,1,0.0,1,1,0,1,1,3,0
1391,Mateusz Klich,12,8,3,4,5,7,13,53.8,6,4,0,4,0,1,0
1392,Lukas Klostermann,16,8,7,9,0,8,15,53.3,7,6,3,3,13,31,0
1393,Justin Kluivert,17,14,7,4,6,6,12,50.0,6,4,0,4,7,4,0
1394,Ansgar Knauff,36,25,22,11,3,15,34,44.1,19,19,1,18,15,26,0
1395,Robin Knoche,45,29,29,12,4,24,47,51.1,23,35,18,17,38,140,0
1396,Gregor Kobel,0,0,0,0,0,0,1,0.0,1,1,0,1,0,7,2
1397,Robin Koch,53,30,32,16,5,24,56,42.9,32,44,21,23,43,152,1
1398,Samuel Koeberlé,0,0,0,0,0,0,0,,0,0,0,0,0,0,0
1399,Rudy Kohon,4,3,4,0,0,2,2,100.0,0,1,0,1,1,2,0
1400,Dominik Kohr,59,33,23,31,5,29,61,47.5,32,46,9,37,34,26,1
1401,Koke,55,38,23,25,7,28,72,38.9,44,35,13,22,20,19,0
1402,Sead Kolašinac,52,36,24,22,6,24,37,64.9,13,19,2,17,43,35,1
1403,Luca Koleosho,2,2,0,0,2,1,2,50.0,1,1,0,1,0,0,0
1404,Randal Kolo Muani,14,10,3,3,8,1,9,11.1,8,19,2,17,3,13,0
1405,Timothée Kolodziejczak,0,0,0,0,0,0,1,0.0,1,0,0,0,1,1,0
1406,Cheick Konaté,19,12,10,7,2,13,22,59.1,9,7,1,6,13,8,1
1407,Ibrahima Konaté,38,26,25,13,0,16,27,59.3,11,12,5,7,26,61,4
1408,Geoffrey Kondogbia,40,23,19,20,1,17,25,68.0,8,9,1,8,26,12,1
1409,Ibrahima Koné,24,13,3,13,8,5,11,45.5,6,13,0,13,4,18,0
1410,Manu Koné,74,39,37,33,4,24,47,51.1,23,44,12,32,32,21,0
1411,Youssouf Koné,28,19,24,4,0,18,25,72.0,7,9,2,7,12,32,1
1412,Ezri Konsa,42,20,25,15,2,18,26,69.2,8,41,23,18,26,120,3
1413,Teun Koopmeiners,46,26,15,24,7,28,55,50.9,27,41,5,36,19,36,2
1414,Odilon Kossonou,21,14,12,7,2,8,16,50.0,8,26,11,15,24,58,1
1415,Filip Kostić,41,26,17,20,4,21,47,44.7,26,30,4,26,16,32,0
1416,Filip Kostić,2,0,1,1,0,0,0,,0,0,0,0,1,0,0
1417,Christian Kouamé,27,18,8,10,9,7,14,50.0,7,15,3,12,12,8,0
1418,Rominigue Kouamé,44,27,28,14,2,17,41,41.5,24,32,11,21,49,46,1
1419,Tomáš Koubek,0,0,0,0,0,0,0,,0,0,0,0,0,7,0
1420,Kalidou Koulibaly,45,31,34,8,3,26,40,65.0,14,30,13,17,29,77,0
1421,Jules Koundé,37,23,18,13,6,21,31,67.7,10,24,9,15,19,61,3
1422,Boubakar Kouyaté,31,18,18,11,2,19,35,54.3,16,24,14,10,34,73,1
1423,Cheikhou Kouyaté,29,21,18,8,3,9,13,69.2,4,14,2,12,10,24,0
1424,Mateo Kovačić,36,24,16,14,6,14,36,38.9,22,10,1,9,19,16,0
1425,Viktor Kovalenko,9,5,1,6,2,5,8,62.5,3,11,2,9,4,7,0
1426,Soichiro Kozuki,6,4,3,3,0,4,6,66.7,2,5,0,5,3,3,0
1427,Emil Krafth,0,0,0,0,0,0,0,,0,0,0,0,0,0,0
1428,Alex Král,34,24,10,22,2,17,37,45.9,20,31,6,25,17,53,0
1429,Andrej Kramarić,5,2,2,1,2,1,11,9.1,10,14,2,12,6,13,0
1430,Christoph Kramer,44,33,24,15,5,22,55,40.0,33,34,2,32,17,40,0
1431,Tom Krauß,112,68,39,62,11,51,100,51.0,49,39,6,33,36,35,0
1432,Rasmus Kristensen,62,35,35,21,6,42,76,55.3,34,32,14,18,35,61,0
1433,Julian Kristoffersen,0,0,0,0,0,0,0,,0,1,0,1,0,0,0
1434,Raimonds Krollis,1,1,0,0,1,0,1,0.0,1,0,0,0,0,0,0
1435,Toni Kroos,51,32,16,33,2,23,69,33.3,46,23,4,19,24,11,0
1436,Rade Krunić,40,28,18,18,4,16,50,32.0,34,31,11,20,16,21,0
1437,Max Kruse,1,1,0,1,0,0,1,0.0,1,2,1,1,0,1,0
1438,Lukas Kübler,37,25,24,9,4,18,30,60.0,12,25,11,14,29,50,0
1439,Takefusa Kubo,44,26,18,16,10,16,38,42.1,22,29,1,28,9,4,0
1440,Dejan Kulusevski,38,15,23,7,8,16,44,36.4,28,19,0,19,13,7,0
1441,Sael Kumbedi,47,27,27,13,7,20,38,52.6,18,23,7,16,10,16,0
1442,Marash Kumbulla,4,4,2,2,0,2,3,66.7,1,2,1,1,4,6,0
1443,Pierre Kunde,12,6,3,8,1,6,14,42.9,8,7,1,6,7,9,0
1444,Alou Kuol,0,0,0,0,0,0,0,,0,0,0,0,0,0,0
1445,Layvin Kurzawa,3,2,1,1,1,3,3,100.0,0,1,1,0,2,4,0
1446,Khvicha Kvaratskhelia,43,23,12,8,23,17,43,39.5,26,20,0,20,5,6,1
1447,Grejohn Kyei,16,7,2,9,5,4,13,30.8,9,14,3,11,6,22,0
1448,Daniel Kyereh,6,4,2,4,0,3,6,50.0,3,4,0,4,2,6,0
1449,Giorgos Kyriakopoulos,13,6,4,5,4,10,23,43.5,13,14,2,12,4,10,0
1450,Giorgos Kyriakopoulos,21,8,7,9,5,10,14,71.4,4,7,1,6,11,12,1
1451,César de la Hoz,37,20,17,18,2,19,37,51.4,18,26,6,20,13,37,0
1452,Luca de la Torre,28,19,11,14,3,12,32,37.5,20,22,1,21,9,6,0
1453,Rémy Labeau Lascary,4,2,4,0,0,0,0,,0,4,0,4,1,0,0
1454,Gaëtan Laborde,45,25,13,17,15,18,40,45.0,22,27,2,25,9,13,0
1455,Gaëtan Laborde,1,1,1,0,0,0,1,0.0,1,1,0,1,0,1,0
1456,Alexandre Lacazette,43,23,7,17,19,10,29,34.5,19,23,3,20,15,4,0
1457,Qazim Laçi,6,3,2,3,1,4,9,44.4,5,5,0,5,2,3,0
1458,Maxence Lacroix,22,13,15,7,0,8,16,50.0,8,22,11,11,26,85,0
1459,Alban Lafont,0,0,0,0,0,0,1,0.0,1,0,0,0,0,20,4
1460,Aïssa Laïdouni,14,7,6,8,0,5,17,29.4,12,22,4,18,9,3,0
1461,Konrad Laimer,60,31,23,30,7,30,54,55.6,24,31,4,27,18,8,0
1462,Stefan Lainer,16,8,10,5,1,10,23,43.5,13,8,1,7,14,34,1
1463,Kenny Lala,36,19,19,15,2,22,38,57.9,16,15,5,10,21,28,0
1464,Adam Lallana,9,4,6,2,1,0,7,0.0,7,6,0,6,2,1,0
1465,Vassilis Lambropoulos,10,8,7,3,0,6,9,66.7,3,5,3,2,13,41,0
1466,Érik Lamela,46,27,14,16,16,12,34,35.3,22,26,2,24,7,3,0
1467,Mohamed Lamine Bayo,3,3,0,2,1,0,12,0.0,12,3,1,2,0,1,0
1468,Sam Lammers,12,5,2,7,3,6,15,40.0,9,10,3,7,6,11,0
1469,Sam Lammers,20,10,5,9,6,7,11,63.6,4,4,1,3,3,8,0
1470,Tariq Lamptey,11,6,6,4,1,5,7,71.4,2,7,3,4,7,2,0
1471,Manuel Lanzini,2,2,1,1,0,2,6,33.3,4,2,0,2,2,0,0
1472,Aymeric Laporte,11,8,6,4,1,7,11,63.6,4,10,4,6,3,30,1
1473,Julien Laporte,22,16,18,3,1,16,22,72.7,6,33,27,6,18,108,2
1474,Cyle Larin,9,3,2,4,3,3,7,42.9,4,6,3,3,0,15,0
1475,Juan Larios,7,6,6,1,0,5,5,100.0,0,2,0,2,3,4,0
1476,Yasser Larouci,23,13,13,8,2,15,24,62.5,9,15,1,14,26,46,0
1477,Jordan Larsson,8,5,1,7,0,2,9,22.2,7,9,0,9,4,3,0
1478,Kevin Lasagna,12,6,7,3,2,6,14,42.9,8,17,1,16,5,13,0
1479,Jamaal Lascelles,1,0,1,0,0,1,1,100.0,0,3,2,1,0,17,0
1480,Juanmi Latasa,5,4,2,0,3,1,1,100.0,0,3,1,2,1,8,0
1481,Toni Lato,23,11,9,12,2,9,21,42.9,12,10,1,9,6,14,0
1482,Danny Latza,17,13,8,8,1,5,17,29.4,12,16,1,15,5,15,0
1483,Armand Lauriente,21,15,5,7,9,8,21,38.1,13,20,0,20,12,8,0
1484,Armand Lauriente,8,7,3,4,1,3,7,42.9,4,5,1,4,4,1,0
1485,Roméo Lavia,60,35,27,29,4,21,53,39.6,32,47,11,36,33,23,1
1486,Lázaro,4,3,3,0,1,3,15,20.0,12,16,1,15,2,1,0
1487,Valentino Lazaro,10,5,6,0,4,6,14,42.9,8,16,3,13,3,29,0
1488,Marko Lazetić,0,0,0,0,0,0,0,,0,0,0,0,0,0,0
1489,Darko Lazović,24,13,9,12,3,13,29,44.8,16,14,3,11,16,19,0
1490,Manuel Lazzari,33,21,13,14,6,21,36,58.3,15,20,6,14,18,36,1
1491,Théo Le Bris,31,19,17,11,3,15,33,45.5,18,21,2,19,18,31,0
1492,Julien Le Cardinal,6,4,5,0,1,4,6,66.7,2,3,0,3,2,5,0
1493,Jérémy Le Douaron,15,9,5,9,1,3,27,11.1,24,29,2,27,11,30,0
1494,Enzo Le Fée,108,64,52,40,16,43,113,38.1,70,50,5,45,34,38,1
1495,Vincent Le Goff,75,32,56,16,3,45,62,72.6,17,29,9,20,41,105,1
1496,Maxime Le Marchand,39,24,23,14,2,19,31,61.3,12,22,14,8,37,74,0
1497,Robin Le Normand,36,23,25,9,2,14,27,51.9,13,22,14,8,33,93,0
1498,Rafael Leão,8,7,2,3,3,6,14,42.9,8,9,2,7,15,8,0
1499,Paolo Lebas,0,0,0,0,0,0,0,,0,0,0,0,0,0,0
1500,Jean-Louis Leca,0,0,0,0,0,0,0,,0,0,0,0,0,0,1
1501,Benjamin Lecomte,0,0,0,0,0,0,0,,0,0,0,0,0,3,2
1502,Benjamin Lecomte,0,0,0,0,0,0,2,0.0,2,0,0,0,0,6,0
1503,Jeremías Ledesma,3,2,3,0,0,3,7,42.9,4,1,0,1,2,23,3
1504,Pierre Lees-Melou,97,55,55,37,5,57,123,46.3,66,48,13,35,52,46,1
1505,Diogo Leite,35,20,21,14,0,21,34,61.8,13,23,14,9,26,99,1
1506,Maxim Leitsch,9,7,6,3,0,4,5,80.0,1,7,4,3,18,26,1
1507,Florian Lejeune,28,17,19,8,1,17,25,68.0,8,24,16,8,15,123,0
1508,Iñigo Lekue,24,17,20,4,0,12,19,63.2,7,16,2,14,13,31,1
1509,Thomas Lemar,30,18,10,13,7,10,28,35.7,18,12,3,9,7,12,0
1510,Félix Lemaréchal,5,5,2,1,2,0,3,0.0,3,6,0,6,1,2,0
1511,Dexter Lembikisa,0,0,0,0,0,0,0,,0,0,0,0,0,0,0
1512,Mario Lemina,38,24,22,13,3,20,38,52.6,18,26,8,18,14,24,1
1513,Mario Lemina,32,21,11,14,7,12,18,66.7,6,13,5,8,11,20,0
1514,Tim Lemperle,6,4,3,1,2,3,5,60.0,2,5,0,5,1,4,0
1515,Clément Lenglet,38,23,18,15,5,16,34,47.1,18,26,11,15,18,68,2
1516,Bernd Leno,0,0,0,0,0,0,3,0.0,3,0,0,0,0,18,1
1517,Christopher Lenz,29,21,17,7,5,16,37,43.2,21,16,3,13,21,34,0
1518,Donovan Léon,0,0,0,0,0,0,0,,0,0,0,0,0,1,0
1519,Sergio León,6,4,0,4,2,3,6,50.0,3,6,0,6,0,4,0
1520,Johann Lepenant,58,34,24,27,7,32,86,37.2,54,29,5,24,28,17,3
1521,Mehdi Léris,63,46,30,24,9,23,55,41.8,32,38,6,32,27,34,0
1522,Jefferson Lerma,50,30,23,23,4,20,45,44.4,25,32,15,17,47,91,2
1523,Benjamin Leroy,0,0,0,0,0,0,2,0.0,2,0,0,0,1,16,2
1524,Léo Leroy,53,38,24,26,3,31,57,54.4,26,25,2,23,14,8,0
1525,Alexandre Letellier,0,0,0,0,0,0,0,,0,0,0,0,0,0,0
1526,Ruan Levine,2,2,1,1,0,0,0,,0,1,0,1,2,0,0
1527,Robert Lewandowski,17,11,2,5,10,7,14,50.0,7,20,0,20,2,14,0
1528,Jamie Leweling,5,3,2,2,1,3,5,60.0,2,3,0,3,1,0,0
1529,Jamal Lewis,0,0,0,0,0,0,0,,0,0,0,0,0,0,0
1530,Rico Lewis,16,9,9,5,2,6,11,54.5,5,8,4,4,6,13,1
1531,Keane Lewis-Potter,1,0,0,1,0,0,0,,0,5,1,4,0,2,0
1532,Dimitri Liénard,46,29,20,18,8,34,57,59.6,23,28,4,24,16,24,0
1533,Philipp Lienhart,29,18,19,10,0,13,27,48.1,14,29,15,14,35,97,0
1534,Matthijs de Ligt,32,23,15,16,1,15,24,62.5,9,31,20,11,23,85,0
1535,Dimitris Limnios,0,0,0,0,0,0,0,,0,0,0,0,1,0,0
1536,Victor Lindelöf,22,17,10,9,3,9,17,52.9,8,18,9,9,21,63,1
1537,Jesper Lindstrøm,26,11,15,7,4,7,22,31.8,15,25,3,22,9,9,0
1538,Karol Linetty,32,17,7,22,3,13,25,52.0,12,28,8,20,19,25,0
1539,Jesse Lingard,4,4,2,2,0,1,7,14.3,6,11,0,11,5,4,0
1540,Samuel Lino,66,43,17,37,12,26,72,36.1,46,34,0,34,18,16,0
1541,Pol Lirola,13,6,9,3,1,8,13,61.5,5,3,2,1,7,16,0
1542,Mateusz Lis,0,0,0,0,0,0,1,0.0,1,1,0,1,0,3,0
1543,Marcin Listkowski,0,0,0,0,0,0,0,,0,0,0,0,3,2,0
1544,Valentino Livramento,2,1,2,0,0,0,0,,0,0,0,0,2,3,0
1545,Dejan Ljubicic,25,14,7,14,4,13,40,32.5,27,20,1,19,8,8,1
1546,Javier Llabrés,0,0,0,0,0,0,0,,0,0,0,0,0,1,0
1547,Diego Llorente,13,10,8,5,0,4,8,50.0,4,6,2,4,15,24,2
1548,Diego Llorente,10,5,6,4,0,5,12,41.7,7,4,2,2,11,20,0
1549,Marcos Llorente,32,15,16,10,6,17,30,56.7,13,26,2,24,17,19,0
1550,Hugo Lloris,1,1,1,0,0,1,3,33.3,2,0,0,0,1,13,5
1551,Giovani Lo Celso,32,28,7,15,10,12,21,57.1,9,14,2,12,6,5,0
1552,Stanislav Lobotka,83,44,35,35,13,43,73,58.9,30,29,7,22,23,16,0
1553,Manuel Locatelli,59,33,26,23,10,30,53,56.6,23,50,22,28,27,59,0
1554,Luka Lochoshvili,45,19,30,11,4,22,31,71.0,9,31,10,21,22,89,0
1555,Bradley Locko,31,16,21,4,6,15,27,55.6,12,17,4,13,20,21,0
1556,Bradley Locko,4,3,2,1,1,2,3,66.7,1,4,0,4,2,13,0
1557,Renan Lodi,52,39,38,8,6,33,66,50.0,33,25,6,19,33,74,0
1558,Ruben Loftus-Cheek,25,14,8,14,3,12,22,54.5,10,15,2,13,12,23,0
1559,Sean Longstaff,42,21,16,20,6,20,52,38.5,32,35,8,27,16,23,0
1560,Ademola Lookman,13,5,2,6,5,3,15,20.0,12,18,0,18,4,1,0
1561,Anthony Lopes,1,0,1,0,0,1,4,25.0,3,0,0,0,3,10,0
1562,Rony Lopes,24,12,6,15,3,7,31,22.6,24,14,2,12,9,10,0
1563,David López,31,18,17,13,1,19,27,70.4,8,29,19,10,14,64,1
1564,Diego López,0,0,0,0,0,0,0,,0,0,0,0,0,0,1
1565,Diego López,2,2,1,1,0,2,15,13.3,13,9,0,9,3,5,0
1566,Maxime Lopez,42,18,26,12,4,16,56,28.6,40,24,6,18,22,21,0
1567,Pau López,0,0,0,0,0,0,1,0.0,1,0,0,0,0,5,1
1568,Unai López,32,20,10,17,5,13,37,35.1,24,12,1,11,15,6,1
1569,Dion Lopy,45,24,22,16,7,23,62,37.1,39,27,3,24,22,18,0
1570,Anthony Losilla,76,49,32,34,10,38,77,49.4,39,39,12,27,37,67,0
1571,Jordan Lotomba,65,38,33,24,8,31,48,64.6,17,38,11,27,32,53,0
1572,Matteo Lovato,17,14,14,3,0,10,25,40.0,15,8,5,3,13,33,2
1573,Dejan Lovren,25,19,20,5,0,20,29,69.0,9,20,10,10,26,70,1
1574,Sandi Lovrić,40,18,16,16,8,25,43,58.1,18,25,2,23,26,21,0
1575,Jamal Lowe,0,0,0,0,0,0,0,,0,0,0,0,0,0,0
1576,Anthony Lozano,6,4,1,4,1,1,7,14.3,6,12,1,11,3,17,0
1577,Hirving Lozano,24,13,10,6,8,9,21,42.9,12,31,0,31,15,6,0
1578,Pol Lozano,0,0,0,0,0,0,0,,0,1,0,1,0,1,0
1579,Jean Lucas,9,5,3,5,1,6,12,50.0,6,2,1,1,4,2,0
1580,Jhon Lucumí,53,37,39,13,1,24,43,55.8,19,43,26,17,35,100,1
1581,José Luis Gayà,80,46,61,16,3,43,74,58.1,31,28,9,19,23,48,0
1582,José Luis Morales,7,6,1,2,4,5,17,29.4,12,12,1,11,2,2,0
1583,José Luis Palomino,23,14,16,7,0,11,19,57.9,8,11,4,7,28,20,0
1584,Douglas Luiz,72,42,31,32,9,29,63,46.0,34,36,7,29,40,27,2
1585,Romelu Lukaku,3,1,1,0,2,2,5,40.0,3,3,1,2,0,16,0
1586,Castello Lukeba,39,23,27,8,4,21,31,67.7,10,42,24,18,75,105,1
1587,Dodi Lukebakio,18,11,7,8,3,6,27,22.2,21,23,5,18,13,17,0
1588,Saša Lukić,8,3,1,4,3,3,7,42.9,4,6,2,4,5,3,0
1589,Saša Lukić,21,14,10,10,1,9,15,60.0,6,17,7,10,13,10,0
1590,Andriy Lunin,0,0,0,0,0,0,0,,0,0,0,0,0,1,0
1591,Andrey Lunyov,0,0,0,0,0,0,0,,0,0,0,0,0,0,0
1592,Sebastiano Luperto,33,18,24,8,1,9,20,45.0,11,54,42,12,43,163,1
1593,Lyanco,24,16,15,9,0,12,18,66.7,6,30,25,5,20,65,2
1594,Charalambos Lykogiannis,16,8,5,6,5,5,13,38.5,8,9,4,5,15,30,0
1595,Youssouf M'Changama,22,11,7,12,3,7,13,53.8,6,6,0,6,15,6,1
1596,Awer Mabil,2,0,0,1,1,1,3,33.3,2,1,1,0,0,1,0
1597,Alexis Mac Allister,70,39,22,40,8,34,71,47.9,37,26,2,24,22,10,1
1598,Deiver Machado,45,26,18,20,7,21,34,61.8,13,21,4,17,21,27,0
1599,Darwin Machís,3,2,0,2,1,1,8,12.5,7,5,0,5,3,4,0
1600,James Maddison,51,26,25,19,7,19,50,38.0,31,19,1,18,13,6,1
1601,Noni Madueke,12,8,5,4,3,6,13,46.2,7,13,2,11,4,7,0
1602,Pablo Maffeo,75,46,54,16,5,45,78,57.7,33,38,11,27,26,76,0
1603,Gabriel Magalhães,48,30,29,15,4,18,27,66.7,9,49,26,23,32,125,3
1604,Lisandro Magallán,19,11,11,5,3,10,12,83.3,2,14,5,9,13,30,1
1605,Soungoutou Magassa,4,1,2,2,0,2,4,50.0,2,3,0,3,1,1,0
1606,Giulio Maggiore,20,8,11,6,3,10,21,47.6,11,19,4,15,8,10,0
1607,Giangiacomo Magnani,33,22,20,11,2,19,25,76.0,6,20,15,5,21,76,0
1608,Hugo Magnetti,43,27,18,23,2,23,63,36.5,40,21,1,20,25,12,0
1609,Yohann Magnin,89,54,37,45,7,54,106,50.9,52,50,12,38,25,46,0
1610,Harry Maguire,8,6,6,1,1,4,5,80.0,1,18,11,7,13,41,0
1611,Jon Magunacelaya,1,0,0,0,1,0,2,0.0,2,0,0,0,0,1,0
1612,Riyad Mahrez,30,14,8,13,9,13,39,33.3,26,27,1,26,9,5,0
1613,Arne Maier,31,22,17,11,3,10,18,55.6,8,21,0,21,15,22,0
1614,Mike Maignan,1,0,1,0,0,1,1,100.0,0,0,0,0,1,10,1
1615,Linton Maina,18,12,5,11,2,7,30,23.3,23,19,0,19,5,9,0
1616,Kobbie Mainoo,0,0,0,0,0,0,0,,0,1,1,0,0,0,0
1617,Ainsley Maitland-Niles,45,24,23,18,4,28,44,63.6,16,28,7,21,22,45,1
1618,Jordan Majchrzak,0,0,0,0,0,0,0,,0,0,0,0,0,0,0
1619,Lovro Majer,34,23,16,13,5,8,29,27.6,21,21,1,20,21,5,1
1620,Jean-Victor Makengo,16,13,7,7,2,5,9,55.6,4,8,2,6,9,3,0
1621,Jean-Victor Makengo,16,8,5,10,1,6,20,30.0,14,8,5,3,10,13,1
1622,Béni Makouana,1,0,0,1,0,0,2,0.0,2,3,1,2,0,1,0
1623,Nemanja Maksimović,41,30,17,18,6,19,32,59.4,13,36,14,22,34,27,0
1624,Tyrell Malacia,46,33,33,12,1,14,25,56.0,11,13,3,10,25,49,0
1625,Lorenzo Malagrida,1,0,0,0,1,1,3,33.3,2,1,0,1,0,1,0
1626,Daniel Maldini,12,5,3,4,5,4,11,36.4,7,9,0,9,1,8,0
1627,Youssef Maleh,3,1,0,3,0,0,4,0.0,4,5,0,5,1,3,0
1628,Youssef Maleh,17,8,3,7,7,6,14,42.9,8,20,1,19,5,10,0
1629,Donyell Malen,13,5,3,4,6,5,12,41.7,7,14,1,13,4,11,0
1630,Ruslan Malinovskyi,14,8,5,6,3,6,17,35.3,11,8,1,7,5,2,0
1631,Ruslan Malinovskyi,21,11,3,12,6,10,26,38.5,16,13,1,12,3,9,0
1632,Hugo Mallo,53,29,34,14,5,28,42,66.7,14,28,7,21,24,73,0
1633,Mickael Malsa,2,2,1,1,0,1,4,25.0,3,1,1,0,2,3,0
1634,Giorgi Mamardashvili,0,0,0,0,0,0,0,,0,0,0,0,1,11,4
1635,Hianga Mananga Mbock,0,0,0,0,0,0,1,0.0,1,0,0,0,0,0,0
1636,Gianluca Mancini,37,19,27,9,1,18,34,52.9,16,38,17,21,46,67,0
1637,Steve Mandanda,0,0,0,0,0,0,2,0.0,2,0,0,0,0,9,3
1638,Reinildo Mandava,66,43,46,19,1,38,49,77.6,11,27,12,15,30,59,0
1639,Aïssa Mandi,18,10,14,3,1,6,12,50.0,6,19,14,5,21,58,0
1640,Rolando Mandragora,42,24,12,22,8,23,52,44.2,29,25,3,22,16,21,0
1641,Sadio Mané,11,5,3,3,5,1,9,11.1,8,15,2,13,0,4,0
1642,Orel Mangala,28,20,16,10,2,12,29,41.4,17,21,7,14,23,15,0
1643,Thomas Mangani,32,17,14,15,3,18,47,38.3,29,22,3,19,24,22,1
1644,Vito Mannone,0,0,0,0,0,0,0,,0,0,0,0,0,4,3
1645,Javier Manquillo,3,2,2,1,0,2,2,100.0,0,1,0,1,1,1,0
1646,Myziane Maolida,8,3,2,5,1,5,12,41.7,7,1,0,1,2,0,0
1647,Myziane Maolida,1,1,1,0,0,1,2,50.0,1,0,0,0,0,1,0
1648,Faitout Maouassa,52,32,26,20,6,18,41,43.9,23,31,3,28,20,23,0
1649,Sekou Mara,14,10,5,8,1,3,9,33.3,6,11,0,11,1,5,0
1650,Marcão,2,2,1,1,0,1,1,100.0,0,3,3,0,6,14,0
1651,Solly March,53,31,16,17,20,8,28,28.6,20,34,3,31,24,32,0
1652,Agustín Marchesín,0,0,0,0,0,0,1,0.0,1,0,0,0,0,7,0
1653,Federico Marchetti,0,0,0,0,0,0,0,,0,0,0,0,0,0,0
1654,Vincent Marchetti,55,26,29,19,7,25,68,36.8,43,23,3,20,19,31,0
1655,Riccardo Marchizza,2,2,1,1,0,2,4,50.0,2,2,0,2,2,8,0
1656,Gian Marco Ferrari,23,16,11,10,2,10,17,58.8,7,29,20,9,23,81,4
1657,Emiliano Marcondes,0,0,0,0,0,0,0,,0,0,0,0,0,1,0
1658,Óscar de Marcos,67,33,34,22,11,40,76,52.6,36,42,6,36,29,59,0
1659,Alberto Marí,0,0,0,0,0,0,2,0.0,2,0,0,0,0,1,0
1660,José Mari,16,7,12,3,1,10,16,62.5,6,3,1,2,5,9,0
1661,Pablo Marí,37,19,29,7,1,17,26,65.4,9,22,14,8,31,111,3
1662,José María Giménez,43,25,28,14,1,24,35,68.6,11,37,17,20,24,138,1
1663,Mariano,1,0,0,1,0,0,0,,0,1,0,1,0,0,0
1664,Pablo Marín,10,5,5,4,1,2,7,28.6,5,1,0,1,4,2,0
1665,Răzvan Marin,44,22,22,21,1,19,40,47.5,21,29,11,18,14,33,0
1666,Diego Mariño,0,0,0,0,0,0,0,,0,0,0,0,0,0,0
1667,Guillermo Maripán,46,26,26,20,0,17,33,51.5,16,39,27,12,38,87,0
1668,Marlon,35,21,20,14,1,15,29,51.7,14,13,4,9,18,50,0
1669,Omar Marmoush,16,10,8,2,6,4,16,25.0,12,21,1,20,7,4,0
1670,Marquinhos,0,0,0,0,0,0,0,,0,0,0,0,0,0,0
1671,Marquinhos,33,25,18,12,3,18,26,69.2,8,43,27,16,23,83,2
1672,Luca Marrone,0,0,0,0,0,0,2,0.0,2,2,2,0,0,4,1
1673,Eric Martel,66,41,29,30,7,30,60,50.0,30,29,9,20,33,49,0
1674,Roger Martí,5,2,3,2,0,1,5,20.0,4,4,0,4,1,7,0
1675,Roger Martí,6,4,2,3,1,1,8,12.5,7,7,0,7,2,7,0
1676,Anthony Martial,5,3,0,2,3,1,4,25.0,3,11,2,9,1,4,0
1677,Aarón Martín,42,27,25,11,6,21,40,52.5,19,22,1,21,15,31,0
1678,Ander Martin,2,2,1,1,0,1,4,25.0,3,0,0,0,0,1,0
1679,Andrés Martín,4,2,2,1,1,3,5,60.0,2,2,0,2,1,2,0
1680,Carlos Martín,2,2,0,2,0,2,3,66.7,1,0,0,0,1,0,0
1681,Iván Martín,9,7,4,4,1,8,23,34.8,15,12,0,12,9,12,0
1682,Jonas Martin,9,7,4,5,0,5,14,35.7,9,3,1,2,7,3,0
1683,Gabriel Martinelli,31,18,13,12,6,9,22,40.9,13,24,1,23,9,14,0
1684,Arnau Martinez,69,45,41,19,9,38,85,44.7,47,44,10,34,25,54,2
1685,Emiliano Martínez,0,0,0,0,0,0,2,0.0,2,0,0,0,1,23,1
1686,Iñigo Martínez,18,8,11,7,0,6,9,66.7,3,17,11,6,18,55,0
1687,Lautaro Martínez,25,14,3,15,7,7,23,30.4,16,31,1,30,13,16,1
1688,Lisandro Martínez,54,28,33,18,3,30,43,69.8,13,51,27,24,33,103,0
1689,Lucas Martínez Quarta,80,48,44,32,4,42,61,68.9,19,41,19,22,48,78,1
1690,Roger Martínez,0,0,0,0,0,0,0,,0,0,0,0,0,0,0
1691,Gelson Martins,15,8,6,4,5,4,13,30.8,9,4,1,3,3,2,0
1692,Adam Marušić,41,30,23,14,4,25,39,64.1,14,20,6,14,38,63,1
1693,Omar Mascarell,53,26,32,19,2,31,64,48.4,33,51,19,32,45,54,1
1694,Adam Masina,10,7,7,3,0,6,15,40.0,9,11,4,7,10,28,1
1695,Jordi Masip,0,0,0,0,0,0,2,0.0,2,0,0,0,1,3,2
1696,Erhan Mašović,50,31,28,21,1,30,51,58.8,21,30,14,16,27,79,0
1697,Han-Noah Massengo,27,15,10,15,2,7,16,43.8,9,12,3,9,14,7,0
1698,Yanis Massolin,2,1,1,0,1,0,1,0.0,1,1,0,1,2,0,0
1699,Jaime Mata,13,10,4,5,4,7,22,31.8,15,7,2,5,3,6,0
1700,Pape Matar Sarr,7,6,4,2,1,4,8,50.0,4,3,2,1,6,6,0
1701,Eliot Matazo,26,12,11,13,2,11,26,42.3,15,18,4,14,15,11,1
1702,Jean-Philippe Mateta,7,1,2,4,1,1,3,33.3,2,3,1,2,3,18,0
1703,Nemanja Matić,47,27,24,19,4,19,33,57.6,14,27,7,20,25,21,1
1704,Joël Matip,14,8,12,2,0,11,23,47.8,12,8,3,5,21,45,3
1705,Henning Matriciani,43,23,28,12,3,26,60,43.3,34,28,11,17,23,57,1
1706,Chrislain Matsima,0,0,0,0,0,0,0,,0,3,3,0,2,7,0
1707,Chrislain Matsima,11,6,7,2,2,4,7,57.1,3,5,5,0,9,16,0
1708,Jean Mattéo Bahoya,7,3,1,3,3,4,7,57.1,3,4,0,4,0,0,0
1709,Azor Matusiwa,66,41,30,29,7,36,61,59.0,25,37,11,26,46,52,0
1710,Neal Maupay,11,5,3,4,4,2,4,50.0,2,8,0,8,5,0,0
1711,Aïman Maurer,2,1,1,1,0,1,10,10.0,9,1,0,1,3,5,0
1712,Stephy Mavididi,24,19,12,8,4,13,27,48.1,14,21,1,20,4,10,0
1713,Konstantinos Mavropanos,50,27,32,15,3,28,38,73.7,10,39,18,21,63,99,0
1714,Christian Mawissa,2,0,1,1,0,1,3,33.3,2,0,0,0,3,1,0
1715,Philipp Max,12,9,4,7,1,5,16,31.3,11,10,2,8,3,11,0
1716,Eric Maxim Choupo-Moting,10,7,2,6,2,1,2,50.0,1,8,0,8,0,5,0
1717,Luís Maximiano,0,0,0,0,0,0,0,,0,0,0,0,0,0,0
1718,Keke Maximilian Topp,0,0,0,0,0,0,0,,0,0,0,0,1,0,0
1719,Fernand Mayembo,8,5,6,2,0,4,9,44.4,5,2,0,2,11,36,0
1720,Borja Mayoral,9,4,7,2,0,5,31,16.1,26,18,0,18,3,10,0
1721,Ibrahim Maza,1,1,1,0,0,0,1,0.0,1,2,0,2,0,1,0
1722,Derek Mazou-Sacko,0,0,0,0,0,0,1,0.0,1,1,0,1,1,1,0
1723,Noussair Mazraoui,29,21,9,9,11,15,24,62.5,9,13,2,11,10,25,0
1724,Pasquale Mazzocchi,32,18,21,5,6,17,37,45.9,20,10,2,8,10,37,2
1725,Kevin Mbabu,3,2,2,1,0,1,3,33.3,2,2,0,2,3,3,0
1726,Noah Mbamba,0,0,0,0,0,0,0,,0,0,0,0,0,0,0
1727,Kylian Mbappé,10,4,0,5,5,5,16,31.3,11,5,0,5,5,6,0
1728,Mamadou Mbaye,10,7,7,3,0,6,8,75.0,2,10,8,2,7,50,1
1729,Chancel Mbemba,43,26,24,17,2,22,31,71.0,9,25,12,13,42,89,0
1730,Bryan Mbeumo,26,18,5,13,8,8,42,19.0,34,24,1,23,13,21,0
1731,Jason Mbock,0,0,0,0,0,0,0,,0,0,0,0,0,0,0
1732,Jean-Manuel Mbom,0,0,0,0,0,0,1,0.0,1,0,0,0,0,0,0
1733,Nathanael Mbuku,2,1,2,0,0,2,2,100.0,0,0,0,0,0,0,0
1734,Nathanael Mbuku,1,0,0,1,0,0,0,,0,0,0,0,0,0,0
1735,James McArthur,1,1,1,0,0,1,1,100.0,0,2,1,1,1,2,0
1736,Alex McCarthy,0,0,0,0,0,0,1,0.0,1,0,0,0,1,3,1
1737,John McGinn,66,36,27,29,10,34,71,47.9,37,43,4,39,24,19,0
1738,Scott McKenna,12,7,7,3,2,6,10,60.0,4,20,14,6,12,85,1
1739,Weston McKennie,30,13,5,18,7,10,29,34.5,19,22,3,19,22,26,0
1740,Weston McKennie,14,5,3,9,2,5,8,62.5,3,15,4,11,11,15,1
1741,Dwight McNeil,64,41,35,14,15,27,65,41.5,38,46,7,39,31,41,0
1742,Scott McTominay,32,19,16,10,6,13,22,59.1,9,15,6,9,14,45,1
1743,Gary Medel,25,15,16,7,2,9,16,56.3,7,17,10,7,28,34,0
1744,Facundo Medina,31,20,16,15,0,13,35,37.1,22,25,9,16,26,62,1
1745,Fernando Medrano,2,1,2,0,0,1,1,100.0,0,0,0,0,1,1,0
1746,Ben Mee,45,24,28,13,4,20,37,54.1,17,54,42,12,48,122,2
1747,Bamo Meïté,18,8,13,4,1,7,16,43.8,9,33,23,10,16,70,0
1748,Soualiho Meïté,47,31,25,15,7,22,46,47.8,24,27,6,21,27,36,0
1749,Farid El Melali,21,12,7,12,2,11,22,50.0,11,16,0,16,8,7,0
1750,Gonzalo Melero,32,16,9,18,5,11,39,28.2,28,23,2,21,7,19,1
1751,Birger Meling,24,15,9,12,3,12,25,48.0,13,18,2,16,23,26,0
1752,Memphis,1,0,0,0,1,0,1,0.0,1,0,0,0,0,0,0
1753,Memphis,1,1,1,0,0,0,1,0.0,1,0,0,0,0,0,0
1754,Houboulang Mendes,19,11,16,3,0,11,27,40.7,16,12,2,10,7,23,1
1755,Nuno Mendes,45,30,29,12,4,30,41,73.2,11,19,3,16,17,18,0
1756,Pedro Mendes,0,0,0,0,0,0,0,,0,0,0,0,0,0,1
1757,Thiago Mendes,48,27,24,21,3,30,40,75.0,10,28,8,20,47,51,4
1758,Brais Méndez,58,34,18,30,10,24,64,37.5,40,27,3,24,12,14,1
1759,Diego Méndez,0,0,0,0,0,0,0,,0,0,0,0,1,0,0
1760,Antoine Mendy,22,13,16,5,1,9,15,60.0,6,6,1,5,2,16,0
1761,Arial Mendy,4,2,3,0,1,2,2,100.0,0,2,0,2,4,4,0
1762,Batista Mendy,70,30,34,28,8,37,53,69.8,16,38,6,32,21,29,2
1763,Edouard Mendy,0,0,0,0,0,0,0,,0,0,0,0,0,3,3
1764,Ferland Mendy,21,12,14,6,1,12,20,60.0,8,7,2,5,14,16,0
1765,Nampalys Mendy,13,9,7,6,0,8,15,53.3,7,20,4,16,13,2,0
1766,Gideon Mensah,80,44,43,32,5,44,77,57.1,33,33,10,23,38,41,0
1767,Chris Mepham,45,22,37,8,0,19,30,63.3,11,40,27,13,30,152,0
1768,Jorge Meré,11,7,9,2,0,5,8,62.5,3,9,6,3,6,32,0
1769,Alex Meret,0,0,0,0,0,0,0,,0,0,0,0,0,6,1
1770,Mikel Merino,77,49,28,33,16,31,62,50.0,31,38,8,30,20,51,1
1771,Quentin Merlin,31,19,19,8,4,18,38,47.4,20,27,4,23,24,30,0
1772,Yıldırım Mert Çetin,1,0,1,0,0,0,0,,0,0,0,0,1,1,0
1773,Roque Mesa,27,15,16,10,1,12,38,31.6,26,16,4,12,13,18,0
1774,Illan Meslier,2,1,2,0,0,2,4,50.0,2,0,0,0,1,30,3
1775,Lionel Messi,26,18,1,13,12,11,27,40.7,16,11,0,11,2,0,0
1776,Junior Messias,24,18,9,9,6,5,19,26.3,14,20,4,16,7,28,0
1777,Amine Messoussa,0,0,0,0,0,0,0,,0,0,0,0,0,0,0
1778,Thomas Meunier,16,7,8,5,3,10,17,58.8,7,7,2,5,9,16,0
1779,Alexander Meyer,0,0,0,0,0,0,1,0.0,1,0,0,0,0,1,0
1780,Sven Michel,9,5,1,5,3,4,8,50.0,4,5,1,4,0,4,0
1781,Alex Mighten,0,0,0,0,0,0,1,0.0,1,0,0,0,0,0,0
1782,Tommaso Milanese,0,0,0,0,0,0,0,,0,1,1,0,0,0,0
1783,Nikola Milenković,40,25,20,17,3,18,27,66.7,9,27,14,13,22,72,0
1784,Lewis Miley,0,0,0,0,0,0,0,,0,1,0,1,0,0,0
1785,Arkadiusz Milik,12,8,2,8,2,2,8,25.0,6,10,1,9,1,14,0
1786,Arkadiusz Milik,1,1,0,0,1,0,1,0.0,1,0,0,0,0,2,0
1787,Sergej Milinković-Savić,58,35,22,23,13,24,67,35.8,43,50,12,38,28,49,0
1788,Vanja Milinković-Savić,2,1,2,0,0,2,2,100.0,0,0,0,0,1,19,1
1789,Éder Militão,46,32,25,18,3,26,33,78.8,7,67,39,28,42,104,2
1790,Luka Milivojević,13,7,7,4,2,7,10,70.0,3,13,4,9,12,10,1
1791,Luis Milla,48,30,21,18,9,19,44,43.2,25,13,1,12,32,25,1
1792,Pere Milla,31,20,18,8,5,14,41,34.1,27,18,3,15,9,19,1
1793,Enzo Millot,23,16,9,10,4,12,19,63.2,7,20,3,17,12,7,0
1794,James Milner,26,16,11,11,4,15,34,44.1,19,14,2,12,12,15,0
1795,Marko Milovanović,0,0,0,0,0,0,0,,0,0,0,0,0,0,0
1796,Kim Min-jae,55,30,32,22,1,25,29,86.2,4,36,26,10,41,123,1
1797,Yerry Mina,15,8,9,6,0,9,11,81.8,2,7,4,3,6,28,0
1798,Takumi Minamino,15,8,5,7,3,7,35,20.0,28,14,0,14,6,4,0
1799,Tyrone Mings,15,7,10,5,0,9,20,45.0,11,40,21,19,54,163,2
1800,Óscar Mingueza,37,21,27,9,1,25,32,78.1,7,10,4,6,12,25,0
1801,Rafa Mir,8,2,2,4,2,2,5,40.0,3,5,1,4,4,11,0
1802,Aleksei Miranchuk,11,5,3,4,4,3,11,27.3,8,11,0,11,2,5,0
1803,Juan Miranda,23,16,16,6,1,14,29,48.3,15,20,7,13,20,63,0
1804,Antonio Mirante,0,0,0,0,0,0,0,,0,0,0,0,0,0,0
1805,Fabio Miretti,24,11,15,6,3,12,29,41.4,17,20,1,19,4,11,0
1806,Filippo Missori,4,3,3,0,1,3,6,50.0,3,0,0,0,3,5,0
1807,Tyrick Mitchell,71,49,43,23,5,30,53,56.6,23,48,11,37,42,78,0
1808,Kaoru Mitoma,44,27,15,16,13,20,41,48.8,21,25,0,25,17,10,0
1809,Aleksandar Mitrović,14,7,8,4,2,5,12,41.7,7,22,5,17,3,20,1
1810,Stefan Mitrović,14,6,12,2,0,7,11,63.6,4,12,10,2,17,90,2
1811,Maximilian Mittelstädt,39,20,31,6,2,17,39,43.6,22,13,2,11,26,27,0
1812,Henrikh Mkhitaryan,41,26,13,22,6,14,41,34.1,27,27,4,23,21,18,0
1813,Anthony Modeste,4,4,2,0,2,2,5,40.0,3,7,0,7,2,22,0
1814,Luka Modrić,19,9,6,6,7,10,25,40.0,15,15,5,10,10,7,0
1815,Terem Moffi,12,6,0,6,6,2,12,16.7,10,3,0,3,2,5,0
1816,Terem Moffi,8,5,1,4,3,3,5,60.0,2,11,3,8,3,10,0
1817,Mostafa Mohamed,18,13,5,7,6,9,20,45.0,11,23,1,22,10,33,0
1818,Tobias Mohr,8,5,3,5,0,2,7,28.6,5,14,5,9,8,19,0
1819,Johan Mojica,13,9,9,3,1,5,9,55.6,4,8,3,5,4,14,1
1820,Johan Mojica,6,3,5,1,0,2,3,66.7,1,3,2,1,4,5,0
1821,Clinton Mola,3,1,2,1,0,1,1,100.0,0,1,1,0,1,2,0
1822,Nahuel Molina,69,43,38,18,13,39,91,42.9,52,38,7,31,18,63,1
1823,Salvatore Molina,6,5,2,4,0,4,5,80.0,1,4,2,2,1,2,0
1824,Florent Mollet,14,6,5,4,5,7,24,29.2,17,12,1,11,10,11,0
1825,Florent Mollet,4,1,0,4,0,2,7,28.6,5,7,1,6,1,1,0
1826,Jon Moncayola,55,39,24,22,9,30,76,39.5,46,37,5,32,17,32,2
1827,Monchu,50,29,20,21,9,19,46,41.3,27,28,11,17,18,22,1
1828,César Montes,17,9,10,7,0,10,18,55.6,8,19,12,7,14,101,0
1829,Daniele Montevago,1,0,0,0,1,0,1,0.0,1,2,1,1,0,1,0
1830,Gonzalo Montiel,26,15,12,14,0,15,29,51.7,14,25,7,18,19,38,0
1831,Lorenzo Montipò,1,0,1,0,0,0,3,0.0,3,1,0,1,0,26,3
1832,Martín Montoya,13,8,9,4,0,10,12,83.3,2,6,1,5,9,14,1
1833,Kieffer Moore,14,11,2,9,3,5,16,31.3,11,12,5,7,1,26,0
1834,Andrew Moran,0,0,0,0,0,0,0,,0,1,0,1,0,0,0
1835,Álvaro Morata,16,11,4,8,4,3,8,37.5,5,11,3,8,0,23,0
1836,Jon Morcillo,1,0,1,0,0,0,1,0.0,1,0,0,0,1,0,0
1837,Alberto Moreno,23,12,10,10,3,11,24,45.8,13,12,1,11,23,26,0
1838,Álex Moreno,23,14,15,5,3,13,36,36.1,23,18,3,15,7,37,2
1839,Álex Moreno,29,22,19,10,0,18,36,50.0,18,17,4,13,17,39,0
1840,Diego Moreno,4,4,2,2,0,3,8,37.5,5,7,4,3,5,21,0
1841,Gerard Moreno,11,6,0,6,5,3,6,50.0,3,6,2,4,5,10,0
1842,Marlos Moreno,2,2,2,0,0,2,3,66.7,1,1,1,0,0,0,0
1843,Tete Morente,33,21,18,13,2,15,36,41.7,21,23,3,20,25,28,0
1844,Ilaix Moriba,35,16,14,17,4,14,24,58.3,10,11,1,10,4,12,0
1845,Manu Morlanes,3,2,2,1,0,3,3,100.0,0,3,2,1,1,2,0
1846,Manu Morlanes,22,9,12,8,2,13,24,54.2,11,10,5,5,5,9,0
1847,Nikola Moro,32,21,11,15,6,14,36,38.9,22,15,2,13,8,18,0
1848,Loren Morón,2,2,0,1,1,0,0,,0,0,0,0,0,1,0
1849,Cristhian Mosquera,4,2,3,1,0,4,5,80.0,1,1,0,1,1,5,0
1850,Dany Mota,8,7,1,3,4,2,10,20.0,8,5,1,4,6,25,0
1851,Lebo Mothiba,1,0,1,0,0,0,1,0.0,1,6,1,5,0,4,0
1852,Youssoufa Moukoko,13,7,3,6,4,3,6,50.0,3,9,0,9,2,1,0
1853,Steve Mounié,13,5,1,7,5,5,14,35.7,9,18,7,11,3,20,0
1854,Mason Mount,33,19,6,16,11,14,27,51.9,13,24,6,18,8,9,0
1855,Lucas Moura,8,5,1,3,4,1,4,25.0,3,0,0,0,2,1,1
1856,Bevic Moussiti-Oko,3,1,1,1,1,1,2,50.0,1,5,3,2,2,8,0
1857,João Moutinho,51,30,24,21,6,19,46,41.3,27,22,6,16,18,20,0
1858,João Moutinho,7,1,5,1,1,3,4,75.0,1,1,1,0,0,0,0
1859,Samuel Moutoussamy,64,34,27,28,9,26,76,34.2,50,23,2,21,24,15,0
1860,Divin Mubama,1,1,1,0,0,0,0,,0,0,0,0,0,0,0
1861,Mykhailo Mudryk,11,9,2,4,5,4,13,30.8,9,7,1,6,0,3,0
1862,François Mughe,0,0,0,0,0,0,0,,0,0,0,0,0,0,0
1863,Nordi Mukiele,31,23,16,6,9,19,29,65.5,10,22,9,13,14,16,0
1864,Mert Müldür,0,0,0,0,0,0,0,,0,0,0,0,0,0,0
1865,Florian Müller,0,0,0,0,0,0,0,,0,0,0,0,0,7,4
1866,Thomas Müller,21,12,5,9,7,6,16,37.5,10,19,3,16,4,16,0
1867,Abdul Mumin,11,9,5,6,0,3,7,42.9,4,13,5,8,9,36,2
1868,Marshall Munetsi,58,27,13,31,14,20,48,41.7,28,37,11,26,26,41,1
1869,Iker Muniain,21,16,7,11,3,6,17,35.3,11,10,1,9,4,2,0
1870,Aihen Muñoz,38,23,17,17,4,22,47,46.8,25,26,5,21,9,38,0
1871,Álvaro Muñoz,2,1,1,0,1,1,1,100.0,0,0,0,0,0,1,0
1872,Iker Muñoz,1,0,0,1,0,0,3,0.0,3,2,1,1,3,8,0
1873,Pablo Muñoz,0,0,0,0,0,0,1,0.0,1,0,0,0,0,0,0
1874,Luis Muriel,9,6,2,3,4,5,16,31.3,11,9,0,9,2,2,0
1875,Jeison Murillo,22,11,16,6,0,17,26,65.4,9,22,14,8,8,39,0
1876,Vedat Muriqi,12,7,4,7,1,3,13,23.1,10,19,7,12,12,73,0
1877,Jacob Murphy,15,7,3,8,4,8,20,40.0,12,17,0,17,7,3,0
1878,Nicola Murru,24,14,15,8,1,7,13,53.8,6,17,7,10,10,21,0
1879,Yunus Musah,48,35,17,23,8,20,30,66.7,10,20,1,19,11,16,2
1880,Jamal Musiala,34,23,9,16,9,13,35,37.1,22,30,3,27,19,3,0
1881,Juan Musso,1,1,1,0,0,1,1,100.0,0,0,0,0,0,11,1
1882,Marlon Mustapha,2,2,0,2,0,0,0,,0,4,0,4,0,0,0
1883,Yvon Mvogo,0,0,0,0,0,0,0,,0,0,0,0,2,6,3
1884,Enock Mwepu,10,5,1,6,3,3,4,75.0,1,3,1,2,1,1,0
1885,Francisco Mwepu,1,0,0,1,0,0,0,,0,0,0,0,0,0,0
1886,Vitaliy Mykolenko,58,34,36,19,3,28,51,54.9,23,50,16,34,46,99,0
1887,Joakim Mæhle,32,18,12,7,13,22,39,56.4,17,29,6,23,24,26,0
1888,Obite N'Dicka,25,18,10,11,4,18,32,56.3,14,47,19,28,31,150,0
1889,Nathan N'Goumou,3,2,2,1,0,1,1,100.0,0,2,0,2,2,0,0
1890,Nathan N'Goumou,11,5,5,5,1,7,13,53.8,6,9,0,9,1,4,0
1891,Stanley N'Soki,22,13,14,7,1,12,22,54.5,10,22,5,17,24,34,0
1892,Herculano Nabian,0,0,0,0,0,0,0,,0,0,0,0,0,0,0
1893,Nacho,24,16,17,5,2,12,29,41.4,17,11,6,5,18,37,0
1894,Nikolas Nartey,11,6,7,3,1,5,9,55.6,4,9,0,9,4,12,0
1895,Juanjo Narváez,1,1,1,0,0,1,1,100.0,0,2,0,2,0,0,0
1896,Matija Nastasić,10,8,7,1,2,3,6,50.0,3,11,4,7,18,43,1
1897,Roberto Navarro,5,4,4,0,1,1,2,50.0,1,7,0,7,2,2,0
1898,Jesús Navas,19,12,8,3,8,11,22,50.0,11,18,7,11,22,52,1
1899,Keylor Navas,0,0,0,0,0,0,0,,0,0,0,0,1,11,2
1900,Michel Ndary Adopo,7,2,4,2,1,1,3,33.3,2,2,2,0,1,4,0
1901,Youssouf Ndayishimiye,13,9,8,5,0,6,11,54.5,5,8,5,3,12,22,1
1902,Papa Ndiaga Yade,10,6,6,2,2,7,22,31.8,15,10,2,8,8,10,0
1903,Wilfred Ndidi,61,42,34,24,3,17,43,39.5,26,32,14,18,38,48,3
1904,Tanguy Ndombele,14,8,4,8,2,4,7,57.1,3,10,1,9,7,7,1
1905,Álvaro Negredo,5,4,1,2,2,2,2,100.0,0,4,1,3,0,8,0
1906,Reiss Nelson,4,1,2,1,1,2,4,50.0,2,3,0,3,0,4,0
1907,Ilija Nestorovski,7,3,2,1,4,5,11,45.5,6,6,1,5,2,10,0
1908,Neto,3,1,3,0,0,3,3,100.0,0,0,0,0,0,10,3
1909,Pedro Neto,11,6,4,2,5,7,17,41.2,10,5,1,4,4,4,0
1910,Luca Netz,25,13,19,3,3,19,32,59.4,13,5,1,4,6,27,0
1911,Manuel Neuer,0,0,0,0,0,0,0,,0,0,0,0,0,4,1
1912,Florian Neuhaus,19,9,9,5,5,8,27,29.6,19,20,3,17,12,5,0
1913,Rúben Neves,79,43,31,33,15,32,76,42.1,44,59,22,37,50,85,1
1914,Neymar,22,14,6,9,7,9,19,47.4,10,7,1,6,4,1,1
1915,Jessic Ngankam,14,9,7,4,3,6,14,42.9,8,6,1,5,1,4,0
1916,Cyril Ngonge,7,3,2,2,3,3,11,27.3,8,7,0,7,6,4,0
1917,Moussa Niakhate,18,9,15,3,0,11,22,50.0,11,18,8,10,19,60,0
1918,Ibrahima Niane,6,2,1,4,1,1,6,16.7,5,8,2,6,1,9,0
1919,M'Baye Niang,13,7,1,8,4,3,13,23.1,10,22,1,21,1,20,0
1920,Tanguy Nianzou,20,15,10,9,1,8,11,72.7,3,8,5,3,16,44,3
1921,Rasmus Nicolaisen,48,21,34,14,0,29,46,63.0,17,58,45,13,50,152,0
1922,Hans Nicolussi Caviglia,15,6,5,8,2,9,15,60.0,6,9,0,9,7,7,1
1923,Florian Niederlechner,10,5,5,4,1,4,7,57.1,3,16,2,14,1,9,0
1924,Florian Niederlechner,9,7,2,4,3,2,8,25.0,6,7,0,7,3,10,0
1925,Saúl Ñíguez,42,27,18,18,6,22,37,59.5,15,27,5,22,15,29,0
1926,Dimitris Nikolaou,45,32,31,10,4,25,37,67.6,12,41,26,15,27,82,0
1927,Fernando Niño,0,0,0,0,0,0,0,,0,0,0,0,0,0,0
1928,Justin Njinmah,0,0,0,0,0,0,0,,0,0,0,0,0,0,0
1929,Eddie Nketiah,13,9,6,2,5,2,10,20.0,8,7,1,6,1,7,0
1930,Christopher Nkunku,6,4,2,1,3,1,6,16.7,5,8,3,5,8,11,0
1931,Felix Nmecha,41,24,11,23,7,16,34,47.1,18,26,10,16,25,31,0
1932,Lukas Nmecha,5,3,0,2,3,3,3,100.0,0,5,1,4,3,4,0
1933,Arnaud Nordin,26,14,10,12,4,12,28,42.9,16,19,1,18,14,7,0
1934,Riad Nouri,21,12,7,10,4,12,29,41.4,17,8,1,7,15,11,0
1935,Hugo Novoa,8,2,1,3,4,4,7,57.1,3,4,0,4,1,0,0
1936,Samuel Ntanda,0,0,0,0,0,0,0,,0,0,0,0,0,0,0
1937,Randy Nteka,15,10,7,6,2,2,11,18.2,9,15,3,12,4,9,0
1938,Randy Nteka,4,2,2,2,0,1,1,100.0,0,2,0,2,2,3,0
1939,Alexander Nübel,0,0,0,0,0,0,1,0.0,1,0,0,0,1,10,3
1940,Matheus Nunes,67,43,36,22,9,28,61,45.9,33,35,4,31,16,35,2
1941,Darwin Núñez,11,5,2,4,5,4,17,23.5,13,10,0,10,3,13,0
1942,Unai Núñez,47,35,29,15,3,18,34,52.9,16,27,17,10,72,135,1
1943,Bram Nuytinck,7,4,3,4,0,4,8,50.0,4,6,6,0,5,22,0
1944,Bram Nuytinck,54,38,33,21,0,23,34,67.6,11,36,21,15,23,84,0
1945,Ethan Nwaneri,0,0,0,0,0,0,0,,0,1,0,1,0,0,0
1946,Gerzino Nyamsi,28,20,14,12,2,10,12,83.3,2,19,11,8,10,63,1
1947,Ørjan Nyland,0,0,0,0,0,0,0,,0,0,0,0,0,0,0
1948,M'Bala Nzola,12,5,0,6,6,3,9,33.3,6,20,6,14,7,21,0
1949,Christian Nørgaard,52,30,21,29,2,18,48,37.5,30,32,9,23,34,41,2
1950,Lewis O'Brien,16,9,4,11,1,6,12,50.0,6,13,2,11,5,9,0
1951,Pedro Obiang,26,17,12,12,2,10,18,55.6,8,12,2,10,8,15,0
1952,Jan Oblak,0,0,0,0,0,0,0,,0,0,0,0,1,8,0
1953,Brian Ocampo,18,15,12,5,1,8,21,38.1,13,13,0,13,3,3,0
1954,Lucas Ocampos,22,14,9,9,4,8,31,25.8,23,17,2,15,8,5,0
1955,Guillermo Ochoa,0,0,0,0,0,0,2,0.0,2,0,0,0,0,9,1
1956,Wilson Odobert,20,14,10,7,3,9,25,36.0,16,11,0,11,15,5,0
1957,Álvaro Odriozola,0,0,0,0,0,0,0,,0,0,0,0,0,0,0
1958,Tim Oermann,2,1,2,0,0,1,1,100.0,0,3,2,1,1,8,1
1959,Odeluga Offiah,1,1,1,0,0,0,2,0.0,2,0,0,0,0,1,0
1960,Angelo Ogbonna,11,4,7,4,0,5,10,50.0,5,11,7,4,17,74,1
1961,Florent Ogier,33,16,20,12,1,22,39,56.4,17,22,13,9,18,64,1
1962,Marios Oikonomou,3,2,3,0,0,1,3,33.3,2,5,4,1,4,13,0
1963,David Okereke,12,8,4,5,3,3,16,18.8,13,23,3,20,10,12,0
1964,Caleb Okoli,21,17,14,6,1,10,25,40.0,15,10,5,5,30,44,3
1965,Olasagasti,4,4,1,2,1,1,2,50.0,1,2,0,2,0,1,0
1966,Lucas Olaza,24,14,12,10,2,17,26,65.4,9,20,8,12,14,34,0
1967,Finn Ole Becker,10,2,4,6,0,4,7,57.1,3,4,0,4,5,8,0
1968,Mathias Olesen,10,5,4,4,2,5,8,62.5,3,6,1,5,2,3,0
1969,Michael Olise,58,34,28,26,4,25,60,41.7,35,46,1,45,26,17,0
1970,Brian Oliván,47,27,30,12,5,17,26,65.4,9,26,6,20,22,67,0
1971,Lucas Oliveira Rosa,39,18,23,10,6,12,20,60.0,8,12,2,10,15,24,0
1972,Mathías Olivera,39,23,16,16,7,22,43,51.2,21,28,2,26,22,26,0
1973,Dani Olmo,15,9,1,10,4,6,14,42.9,8,15,0,15,6,6,0
1974,Jan Olschowsky,0,0,0,0,0,0,1,0.0,1,1,0,1,0,1,0
1975,Robin Olsen,0,0,0,0,0,0,2,0.0,2,0,0,0,0,1,0
1976,Warmed Omari,20,11,14,6,0,14,28,50.0,14,13,7,6,17,43,1
1977,Jonas Omlin,1,0,1,0,0,0,0,,0,0,0,0,0,8,1
1978,Jonas Omlin,1,1,1,0,0,1,3,33.3,2,1,0,1,0,9,1
1979,Ado Onaiwu,11,6,4,4,3,5,13,38.5,8,5,1,4,2,5,0
1980,Amadou Onana,72,43,24,42,6,30,42,71.4,12,25,6,19,37,39,0
1981,André Onana,0,0,0,0,0,0,1,0.0,1,0,0,0,0,5,0
1982,Jean Onana,28,17,8,17,3,10,22,45.5,12,15,5,10,18,20,0
1983,Karim Onisiwo,19,12,3,10,6,4,21,19.0,17,19,0,19,2,7,0
1984,Josh Onomah,1,0,1,0,0,0,0,,0,1,0,1,0,0,0
1985,Paul Onuachu,3,2,1,1,1,1,3,33.3,2,4,1,3,0,4,0
1986,Frank Onyeka,19,14,11,7,1,10,25,40.0,15,16,3,13,10,16,0
1987,Loïs Openda,11,9,2,6,3,2,13,15.4,11,9,0,9,2,6,0
1988,Willi Orban,51,30,33,18,0,26,43,60.5,17,42,24,18,39,129,1
1989,Ivan Ordets,31,19,21,9,1,16,28,57.1,12,34,17,17,57,139,0
1990,Divock Origi,10,5,4,3,3,5,10,50.0,5,6,2,4,0,13,0
1991,Aimar Oroz,26,14,8,10,8,8,30,26.7,22,24,1,23,24,6,0
1992,Mislav Oršić,1,1,1,0,0,0,0,,0,0,0,0,0,0,0
1993,Riccardo Orsolini,30,19,15,10,5,17,41,41.5,24,29,3,26,8,18,0
1994,Stefan Ortega,0,0,0,0,0,0,0,,0,0,0,0,0,0,0
1995,Pedro Ortiz,0,0,0,0,0,0,0,,0,0,0,0,0,0,0
1996,Jordi Osei-Tutu,23,18,13,5,5,12,23,52.2,11,12,5,7,10,8,0
1997,Victor Osimhen,10,6,1,2,7,0,7,0.0,7,6,1,5,6,29,0
1998,Patrick Osterhage,20,17,8,10,2,11,16,68.8,5,17,6,11,12,25,0
1999,Paulo Otávio,72,46,46,17,9,44,66,66.7,22,42,6,36,30,70,1
2000,Dango Ouattara,28,15,20,6,2,13,32,40.6,19,20,3,17,13,29,1
2001,Dango Ouattara,41,26,20,11,10,15,28,53.6,13,24,6,18,19,21,0
2002,Remi Oudin,25,13,9,12,4,10,23,43.5,13,16,2,14,29,23,0
2003,Zinédine Ould Khaled,1,1,0,1,0,0,1,0.0,1,0,0,0,2,0,0
2004,Azzedine Ounahi,2,1,1,1,0,0,2,0.0,2,1,0,1,0,0,0
2005,Azzedine Ounahi,19,8,5,13,1,10,20,50.0,10,8,0,8,15,4,1
2006,Adam Ounas,0,0,0,0,0,0,0,,0,0,0,0,1,0,0
2007,Adam Ounas,20,11,4,10,6,8,13,61.5,5,16,0,16,7,5,0
2008,Thomas Ouwejan,20,8,13,5,2,6,10,60.0,4,17,4,13,13,27,0
2009,Reece Oxford,1,1,1,0,0,0,0,,0,4,3,1,1,5,0
2010,Alex Oxlade-Chamberlain,5,4,1,2,2,1,5,20.0,4,5,2,3,1,4,0
2011,Mikel Oyarzabal,13,7,5,3,5,5,19,26.3,14,14,4,10,3,5,0
2012,Salih Özcan,31,18,10,16,5,16,39,41.0,23,24,2,22,28,19,1
2013,Cenk Özkacar,27,20,17,10,0,14,19,73.7,5,14,2,12,12,47,4
2014,David Ozoh,0,0,0,0,0,0,0,,0,0,0,0,0,0,0
2015,Levin Öztunalı,0,0,0,0,0,0,1,0.0,1,0,0,0,0,0,0
2016,Fernando Pacheco,0,0,0,0,0,0,0,,0,0,0,0,0,1,0
2017,Fernando Pacheco,0,0,0,0,0,0,1,0.0,1,0,0,0,1,11,0
2018,Jon Pacheco,16,10,10,6,0,6,10,60.0,4,9,6,3,12,37,1
2019,Gonçalo Paciência,8,5,0,5,3,2,7,28.6,5,9,1,8,0,4,0
2020,Simone Pafundi,8,5,1,5,2,2,4,50.0,2,0,0,0,1,0,0
2021,Exequiel Palacios,59,36,20,33,6,29,48,60.4,19,29,2,27,33,28,0
2022,Helibelton Palacios,38,20,21,15,2,19,26,73.1,7,26,12,14,20,55,0
2023,Ante Palaversa,1,1,1,0,0,0,0,,0,0,0,0,1,0,0
2024,Isaac Palazón Camacho,45,30,11,23,11,24,66,36.4,42,42,3,39,17,30,0
2025,João Palhinha,148,83,59,65,24,71,135,52.6,64,48,5,43,46,61,2
2026,Nicolas Pallois,69,44,51,16,2,42,70,60.0,28,35,18,17,30,131,2
2027,Cole Palmer,5,1,0,3,2,3,5,60.0,2,2,1,1,1,2,0
2028,Erik Palmer-Brown,42,27,31,10,1,18,33,54.5,15,56,29,27,26,166,1
2029,Emerson Palmieri,26,14,9,15,2,12,24,50.0,12,17,4,13,15,36,0
2030,Miloš Pantović,4,2,4,0,0,3,5,60.0,2,3,0,3,0,5,0
2031,Flavio Paoletti,2,2,0,2,0,1,5,20.0,4,1,0,1,5,9,0
2032,Antonios Papadopoulos,0,0,0,0,0,0,0,,0,0,0,0,1,0,0
2033,Lucas Paquetá,71,53,23,36,12,27,68,39.7,41,41,4,37,16,31,0
2034,Lucas Paquetá,5,4,0,5,0,1,3,33.3,2,2,0,2,1,3,0
2035,Aitor Paredes,7,6,4,2,1,6,11,54.5,5,11,7,4,14,26,0
2036,Kevin Paredes,13,9,6,3,4,9,12,75.0,3,7,0,7,6,8,0
2037,Leandro Paredes,19,13,7,11,1,10,22,45.5,12,8,0,8,17,22,0
2038,Leandro Paredes,1,1,1,0,0,1,1,100.0,0,2,1,1,1,0,0
2039,Daniel Parejo,71,40,32,23,16,30,75,40.0,45,40,12,28,29,31,2
2040,Fabiano Parisi,65,35,37,21,7,30,72,41.7,42,51,16,35,41,91,0
2041,Moises Parra Gutierrez,1,0,0,1,0,0,0,,0,0,0,0,0,0,0
2042,Raúl Parra,4,2,4,0,0,4,9,44.4,5,5,3,2,1,9,0
2043,Thomas Partey,70,40,20,35,15,25,52,48.1,27,26,5,21,28,41,1
2044,Marco Pašalić,0,0,0,0,0,0,0,,0,0,0,0,0,0,0
2045,Mario Pašalić,22,10,6,14,2,6,23,26.1,17,22,4,18,21,13,0
2046,Pascu,0,0,0,0,0,0,0,,0,0,0,0,0,0,0
2047,Felix Passlack,4,3,0,4,0,1,1,100.0,0,1,1,0,0,1,0
2048,Javier Pastore,0,0,0,0,0,0,0,,0,0,0,0,0,0,0
2049,Patric,17,11,12,3,2,11,16,68.8,5,17,12,5,11,53,1
2050,Rui Patrício,1,1,1,0,0,1,1,100.0,0,0,0,0,2,6,3
2051,Nathan Patterson,49,24,32,13,4,29,54,53.7,25,24,4,20,15,45,0
2052,Paulinho,0,0,0,0,0,0,0,,0,1,0,1,0,2,0
2053,Gabriel Paulista,17,9,13,4,0,13,19,68.4,6,22,14,8,32,79,2
2054,Benjamin Pavard,70,41,36,26,8,36,48,75.0,12,35,16,19,44,83,0
2055,Jiří Pavlenka,1,0,1,0,0,1,5,20.0,4,1,0,1,3,21,1
2056,Dimitri Payet,6,4,2,2,2,3,11,27.3,8,4,0,4,0,4,0
2057,Ben Pearson,7,3,3,3,1,1,3,33.3,2,4,0,4,2,6,0
2058,Kristian Pedersen,5,4,4,1,0,0,2,0.0,2,3,0,3,6,17,0
2059,Mads Pedersen,44,23,31,11,2,22,33,66.7,11,32,9,23,20,41,1
2060,Alfonso Pedraza,35,26,20,10,5,19,29,65.5,10,19,1,18,18,31,0
2061,Pedri,39,22,15,17,7,13,45,28.9,32,27,0,27,13,8,1
2062,Pedro,35,24,14,10,11,11,30,36.7,19,18,2,16,6,4,1
2063,Adrià Pedrosa,5,1,5,0,0,4,7,57.1,3,1,1,0,5,3,0
2064,Jordan Pefok,15,7,3,4,8,2,17,11.8,15,17,5,12,4,15,0
2065,Gianluca Pegolo,0,0,0,0,0,0,1,0.0,1,0,0,0,0,1,0
2066,Dženan Pejčinović,0,0,0,0,0,0,0,,0,0,0,0,0,0,0
2067,Peter Pekarík,4,3,4,0,0,4,6,66.7,2,6,2,4,4,7,0
2068,Pietro Pellegri,6,2,1,3,2,2,3,66.7,1,5,1,4,0,4,0
2069,Lorenzo Pellegrini,52,29,24,24,4,22,48,45.8,26,27,4,23,26,22,0
2070,Luca Pellegrini,1,0,0,1,0,1,4,25.0,3,3,0,3,7,4,0
2071,Luca Pellegrini,13,8,10,3,0,8,8,100.0,0,8,2,6,7,11,1
2072,Théo Pellenard,1,0,1,0,0,1,1,100.0,0,3,1,2,2,2,0
2073,Facundo Pellistri,1,1,0,1,0,0,0,,0,0,0,0,0,3,0
2074,Timothee Pembele,5,5,3,1,1,2,4,50.0,2,2,0,2,4,2,0
2075,Iñaki Peña,0,0,0,0,0,0,0,,0,0,0,0,0,0,1
2076,Rubén Peña,32,18,10,18,4,20,41,48.8,21,23,8,15,17,31,0
2077,Patrick Pentz,0,0,0,0,0,0,0,,0,0,0,0,0,1,0
2078,Nicolas Pépé,25,13,14,5,6,11,25,44.0,14,17,0,17,3,1,0
2079,Ricardo Pepi,1,1,1,0,0,1,1,100.0,0,1,0,1,0,1,0
2080,Pepín,28,19,10,11,7,9,27,33.3,18,14,3,11,13,17,0
2081,Alberto Perea,2,0,2,0,0,0,0,,0,2,0,2,0,0,0
2082,Juan Perea,5,4,0,2,3,2,4,50.0,2,2,1,1,1,3,0
2083,Andreas Pereira,18,9,3,6,9,8,34,23.5,26,21,3,18,6,8,0
2084,Brayann Pereira,6,5,5,1,0,1,5,20.0,4,2,2,0,2,8,1
2085,Danilo Pereira,32,17,15,14,3,19,26,73.1,7,26,19,7,36,59,1
2086,Mathias Pereira Lage,20,7,5,14,1,11,29,37.9,18,10,1,9,14,12,0
2087,Ricardo Pereira,11,7,8,3,0,7,17,41.2,10,8,2,6,4,20,0
2088,Roberto Pereyra,36,20,21,12,3,16,44,36.4,28,20,5,15,16,28,0
2089,Ayoze Pérez,11,8,5,4,2,8,19,42.1,11,6,0,6,2,3,0
2090,Ayoze Pérez,31,15,9,16,6,10,40,25.0,30,22,0,22,13,5,0
2091,Carles Pérez,39,23,12,17,10,22,66,33.3,44,29,3,26,6,9,0
2092,Francisco Perez,1,1,1,0,0,0,3,0.0,3,0,0,0,0,1,0
2093,Kike Pérez,67,33,30,32,5,25,68,36.8,43,26,7,19,20,28,0
2094,Lucas Pérez,3,2,2,1,0,1,3,33.3,2,2,0,2,1,3,0
2095,Luis Pérez,44,24,26,12,6,27,38,71.1,11,13,4,9,16,29,0
2096,Nehuén Pérez,77,40,54,20,3,39,55,70.9,16,53,23,30,35,106,1
2097,Simone Perilli,0,0,0,0,0,0,0,,0,0,0,0,0,0,0
2098,Mattia Perin,0,0,0,0,0,0,0,,0,0,0,0,0,0,0
2099,Samuele Perisan,0,0,0,0,0,0,0,,0,0,0,0,0,2,0
2100,Ivan Perišić,42,24,25,10,7,27,47,57.4,20,29,7,22,22,49,1
2101,Romain Perraud,54,33,23,23,8,28,52,53.8,24,24,6,18,20,42,0
2102,Gaëtan Perrin,17,8,5,6,6,8,30,26.7,22,15,0,15,10,9,0
2103,Lucas Perrin,44,27,28,14,2,25,49,51.0,24,13,5,8,36,53,0
2104,Máximo Perrone,0,0,0,0,0,0,0,,0,1,0,1,0,0,0
2105,Matteo Pessina,57,36,28,21,8,26,62,41.9,36,50,15,35,37,33,1
2106,Andrea Petagna,7,5,2,3,2,3,6,50.0,3,16,4,12,3,18,0
2107,Nils Petersen,6,4,0,3,3,2,5,40.0,3,11,2,9,1,6,0
2108,Lukas Petkov,5,1,4,1,0,2,3,66.7,1,4,1,3,1,0,0
2109,Cameron Peupion,0,0,0,0,0,0,0,,0,0,0,0,0,0,0
2110,Germán Pezzella,41,28,32,9,0,26,38,68.4,12,32,15,17,50,129,1
2111,Giuseppe Pezzella,21,9,16,2,3,9,16,56.3,7,11,3,8,8,31,1
2112,Luca Pfeiffer,1,1,1,0,0,0,1,0.0,1,4,0,4,1,5,0
2113,Maximilian Philipp,2,1,1,1,0,1,1,100.0,0,1,0,1,0,0,0
2114,Maximilian Philipp,6,5,3,2,1,1,9,11.1,8,7,1,6,3,4,0
2115,Kalvin Phillips,6,4,3,3,0,2,10,20.0,8,7,3,4,5,10,0
2116,Nathaniel Phillips,2,1,0,2,0,2,2,100.0,0,0,0,0,2,1,0
2117,Krzysztof Piątek,18,11,3,9,6,5,21,23.8,16,17,4,13,2,39,0
2118,Roberto Piccoli,1,0,1,0,0,0,2,0.0,2,2,0,2,0,2,0
2119,Roberto Piccoli,1,1,1,0,0,0,3,0.0,3,4,1,3,1,9,0
2120,Charles Pickel,55,23,25,26,4,32,57,56.1,25,37,5,32,24,36,1
2121,Jordan Pickford,0,0,0,0,0,0,1,0.0,1,0,0,0,4,15,3
2122,Amos Pieper,46,28,25,19,2,24,40,60.0,16,23,11,12,30,94,1
2123,Ronaël Pierre-Gabriel,17,9,12,4,1,5,11,45.5,6,5,2,3,9,11,0
2124,Ronaël Pierre-Gabriel,25,18,11,12,2,15,17,88.2,2,16,3,13,9,22,0
2125,Andrea Pinamonti,10,7,0,5,5,3,7,42.9,4,19,2,17,2,11,0
2126,Ethan Pinnock,52,28,33,12,7,18,24,75.0,6,41,31,10,35,215,2
2127,Yeremi Pino,62,38,25,20,17,21,56,37.5,35,41,4,37,15,36,0
2128,Gerard Piqué,5,4,1,4,0,4,4,100.0,0,2,1,1,2,19,0
2129,Lorenzo Pirola,33,29,18,14,1,19,27,70.4,8,50,35,15,30,85,1
2130,Niccolò Pisilli,0,0,0,0,0,0,0,,0,0,0,0,0,0,0
2131,Marko Pjaca,4,3,3,1,0,3,5,60.0,2,3,0,3,3,3,0
2132,Óscar Plano,40,25,9,17,14,12,37,32.4,25,26,2,24,29,23,0
2133,Gonzalo Plata,66,35,31,24,11,23,70,32.9,47,40,0,40,12,10,1
2134,Marvin Plattenhardt,43,33,24,15,4,29,47,61.7,18,25,11,14,15,82,0
2135,Alassane Pléa,16,8,5,7,4,8,26,30.8,18,23,3,20,12,14,0
2136,Tommaso Pobega,27,16,8,15,4,13,20,65.0,7,12,4,8,9,11,0
2137,Daniel Podence,27,17,13,9,5,6,32,18.8,26,19,0,19,7,6,0
2138,Paul Pogba,0,0,0,0,0,0,1,0.0,1,0,0,0,0,2,0
2139,Joel Pohjanpalo,0,0,0,0,0,0,0,,0,0,0,0,0,0,0
2140,Matteo Politano,18,9,9,5,4,11,25,44.0,14,6,0,6,7,7,0
2141,Sebastian Polter,4,3,0,4,0,1,4,25.0,3,4,0,4,1,6,0
2142,Ezequiel Ponce,9,7,0,6,3,0,7,0.0,7,6,1,5,1,13,0
2143,Julien Ponceau,28,19,10,14,4,10,32,31.3,22,27,3,24,14,12,0
2144,Marin Pongračić,16,14,8,7,1,5,7,71.4,2,4,3,1,16,31,0
2145,Nick Pope,1,0,1,0,0,1,3,33.3,2,0,0,0,0,27,2
2146,Łukasz Poręba,5,4,2,1,2,2,3,66.7,1,3,0,3,4,2,0
2147,Jackson Porozo,32,20,24,7,1,13,31,41.9,18,24,17,7,33,75,0
2148,Pedro Porro,25,16,8,15,2,14,39,35.9,25,25,2,23,15,24,1
2149,Francisco Portillo,13,6,4,5,4,3,16,18.8,13,7,1,6,7,8,0
2150,Portu,28,21,14,10,4,18,42,42.9,24,23,3,20,17,20,1
2151,Stefan Posch,81,43,41,29,11,44,75,58.7,31,44,15,29,35,69,0
2152,Stefan Posch,0,0,0,0,0,0,0,,0,0,0,0,0,0,0
2153,Yussuf Poulsen,6,4,1,4,1,2,5,40.0,3,3,1,2,0,5,0
2154,José Pozo,2,2,0,2,0,0,0,,0,0,0,0,1,1,0
2155,Manuel Pozo,0,0,0,0,0,0,0,,0,2,0,2,2,0,0
2156,Alejandro Pozo Pozo,37,19,17,17,3,27,53,50.9,26,30,5,25,26,45,1
2157,Dennis Praet,12,9,5,6,1,6,11,54.5,5,12,2,10,5,6,0
2158,Abdón Prats,1,0,1,0,0,0,0,,0,5,0,5,0,2,0
2159,Sanjin Prcić,27,12,6,16,5,19,31,61.3,12,22,7,15,25,22,0
2160,Isaac Price,0,0,0,0,0,0,1,0.0,1,1,1,0,0,0,0
2161,Grischa Prömel,27,19,14,11,2,9,25,36.0,16,22,4,18,8,23,0
2162,Ivan Provedel,1,0,1,0,0,0,0,,0,0,0,0,0,15,1
2163,Javi Puado,20,11,12,5,3,12,28,42.9,16,12,2,10,10,14,0
2164,Mehdi Puch Herrantz,2,2,0,1,1,1,2,50.0,1,1,0,1,3,0,0
2165,Tymoteusz Puchacz,1,0,1,0,0,0,0,,0,0,0,0,0,1,0
2166,Arnau Puigmal,22,14,10,7,5,12,17,70.6,5,7,0,7,11,6,0
2167,Christian Pulisic,11,6,3,6,2,3,5,60.0,2,8,1,7,4,4,0
2168,Ignacio Pussetto,6,3,2,3,1,3,4,75.0,1,4,0,4,0,3,0
2169,Niklas Pyyhtiä,1,0,0,1,0,0,1,0.0,1,1,1,0,1,4,0
2170,Fabio Quagliarella,2,1,1,1,0,1,7,14.3,6,5,1,4,0,9,0
2171,Giacomo Quagliata,10,8,7,1,2,5,11,45.5,6,7,2,5,11,8,0
2172,Eduardo Quaresma,5,3,3,2,0,1,3,33.3,2,3,2,1,0,3,0
2173,Joshua Quarshie,0,0,0,0,0,0,0,,0,0,0,0,0,0,0
2174,Ghjuvanni Quilichini,0,0,0,0,0,0,0,,0,0,0,0,0,1,0
2175,Domingos Quina,3,2,2,1,0,1,3,33.3,2,5,0,5,3,1,0
2176,Rubén Quintanilla,0,0,0,0,0,0,0,,0,1,0,1,0,0,0
2177,Adrien Rabiot,65,35,31,23,11,30,57,52.6,27,37,7,30,26,44,1
2178,Nemanja Radonjić,2,1,2,0,0,0,4,0.0,4,3,0,3,2,4,0
2179,Ivan Radovanović,12,4,8,4,0,4,10,40.0,6,9,3,6,7,9,1
2180,Ionuț Radu,0,0,0,0,0,0,0,,0,0,0,0,0,1,3
2181,Ionuț Radu,0,0,0,0,0,0,0,,0,0,0,0,0,3,3
2182,Ștefan Radu,0,0,0,0,0,0,0,,0,0,0,0,0,0,0
2183,Antonio Raillo,34,21,23,11,0,10,15,66.7,5,38,29,9,31,158,1
2184,Antonio Raimondo,0,0,0,0,0,0,0,,0,0,0,0,0,1,0
2185,Predrag Rajković,0,0,0,0,0,0,2,0.0,2,0,0,0,0,16,1
2186,Ivan Rakitić,37,26,10,18,9,19,40,47.5,21,21,1,20,27,20,0
2187,Diant Ramaj,0,0,0,0,0,0,0,,0,0,0,0,0,1,0
2188,Largie Ramazani,15,9,6,3,6,8,27,29.6,19,11,0,11,15,10,0
2189,Simon Ramet,0,0,0,0,0,0,0,,0,0,0,0,0,0,0
2190,Adil Rami,19,14,13,5,1,17,32,53.1,15,23,16,7,25,75,3
2191,Chris Ramos,12,9,2,7,3,4,11,36.4,7,8,3,5,1,19,0
2192,Sergio Ramos,34,26,14,18,2,23,44,52.3,21,29,13,16,34,93,3
2193,Aaron Ramsdale,1,1,1,0,0,1,1,100.0,0,0,0,0,0,20,6
2194,Aaron Ramsey,47,25,18,19,10,16,39,41.0,23,25,4,21,17,18,1
2195,Jacob Ramsey,69,39,23,35,11,32,69,46.4,37,48,8,40,23,34,0
2196,Luca Ranieri,9,4,6,3,0,6,9,66.7,3,5,3,2,11,15,1
2197,Andrea Ranocchia,3,1,1,2,0,3,4,75.0,1,5,5,0,0,7,0
2198,Filippo Ranocchia,11,6,5,4,2,4,12,33.3,8,5,1,4,4,7,0
2199,Lilian Raolisoa,11,9,6,3,2,7,10,70.0,3,3,1,2,3,5,0
2200,Raphinha,29,19,10,7,12,11,31,35.5,20,33,1,32,14,11,1
2201,Nicolai Rapp,3,1,3,0,0,0,3,0.0,3,0,0,0,0,1,0
2202,Elba Rashani,39,26,13,19,7,13,39,33.3,26,27,2,25,21,19,0
2203,Marcus Rashford,20,10,7,8,5,9,24,37.5,15,31,4,27,7,14,0
2204,Giacomo Raspadori,0,0,0,0,0,0,0,,0,0,0,0,0,0,0
2205,Giacomo Raspadori,10,8,0,6,4,4,10,40.0,6,9,0,9,4,4,0
2206,Rafael Ratão,52,36,29,16,7,27,73,37.0,46,34,0,34,21,7,0
2207,David Raum,39,25,23,12,4,17,29,58.6,12,24,6,18,16,26,1
2208,Nicola Ravaglia,0,0,0,0,0,0,1,0.0,1,0,0,0,0,7,0
2209,Rayan Raveloson,38,23,21,16,1,23,33,69.7,10,43,12,31,39,70,0
2210,David Raya,0,0,0,0,0,0,2,0.0,2,1,0,1,1,10,3
2211,Tim Ream,30,16,15,12,3,13,26,50.0,13,45,24,21,41,116,3
2212,Ante Rebić,10,8,1,3,6,3,11,27.3,8,6,1,5,1,5,0
2213,Arkadiusz Reca,44,28,22,12,10,19,32,59.4,13,21,5,16,24,54,0
2214,Nathan Redmond,0,0,0,0,0,0,0,,0,0,0,0,0,0,0
2215,Harrison Reed,44,27,17,21,6,16,51,31.4,35,54,12,42,19,36,0
2216,Sergio Reguilón,7,5,5,2,0,5,7,71.4,2,3,0,3,2,4,0
2217,Bobby Reid,42,24,14,14,14,16,36,44.4,20,25,3,22,20,28,1
2218,Pepe Reina,0,0,0,0,0,0,1,0.0,1,0,0,0,1,4,4
2219,Jeff Reine-Adélaïde,3,2,2,1,0,1,2,50.0,1,2,0,2,2,1,0
2220,Jeff Reine-Adélaïde,8,5,1,5,2,5,9,55.6,4,4,0,4,6,0,0
2221,Reinier,12,10,7,3,2,2,8,25.0,6,6,0,6,5,4,0
2222,Rocco Reitz,0,0,0,0,0,0,0,,0,0,0,0,0,0,0
2223,Karim Rekik,11,5,8,3,0,4,5,80.0,1,12,5,7,10,24,0
2224,Álex Remiro,1,1,1,0,0,1,3,33.3,2,0,0,0,0,17,3
2225,Panagiotis Retsos,5,4,2,2,1,3,3,100.0,0,4,1,3,2,3,0
2226,Marco Reus,30,17,12,14,4,7,24,29.2,17,12,4,8,8,8,0
2227,Alejandro Revuelta Montero,0,0,0,0,0,0,0,,0,0,0,0,0,1,0
2228,Elvis Rexhbeçaj,51,30,18,24,9,29,59,49.2,30,39,12,27,17,40,0
2229,Gio Reyna,14,7,2,5,7,5,10,50.0,5,8,2,6,3,5,0
2230,Chadi Riad,0,0,0,0,0,0,0,,0,0,0,0,0,0,0
2231,Nico Ribaudo,18,13,5,9,4,11,30,36.7,19,19,1,18,5,1,0
2232,Alexsandro Ribeiro,32,18,24,7,1,19,28,67.9,9,11,2,9,25,59,1
2233,Franck Ribéry,0,0,0,0,0,0,0,,0,1,0,1,0,0,0
2234,Samuele Ricci,32,21,17,10,5,18,23,78.3,5,20,5,15,17,29,1
2235,Declan Rice,79,38,44,31,4,31,50,62.0,19,45,15,30,63,58,0
2236,Chris Richards,9,6,8,1,0,5,7,71.4,2,10,1,9,8,31,0
2237,Richarlison,21,16,13,5,3,12,27,44.4,15,14,1,13,5,10,0
2238,Marco Richter,43,23,18,17,8,19,48,39.6,29,29,2,27,24,25,0
2239,Diego Rico,35,21,17,11,7,12,27,44.4,15,18,5,13,20,51,1
2240,Jaïro Riedewald,2,1,2,0,0,0,1,0.0,1,2,0,2,0,4,0
2241,Manuel Riemann,3,2,3,0,0,3,5,60.0,2,1,0,1,5,23,7
2242,Tomás Rincón,56,27,22,26,8,29,61,47.5,32,37,7,30,30,18,0
2243,Rémy Riou,1,0,1,0,0,1,1,100.0,0,0,0,0,0,3,0
2244,Renaud Ripart,40,23,14,20,6,19,52,36.5,33,29,2,27,7,5,0
2245,Rodrigo Riquelme,20,8,8,8,4,9,35,25.7,26,16,0,16,11,5,0
2246,Matt Ritchie,1,1,0,1,0,1,3,33.3,2,0,0,0,1,0,0
2247,Sergi Roberto,22,15,12,6,4,7,18,38.9,11,15,7,8,11,16,0
2248,Lucas Robertone,50,28,20,21,9,28,64,43.8,36,45,7,38,46,46,1
2249,Andrew Robertson,38,21,12,16,10,21,41,51.2,20,32,5,27,18,50,3
2250,Antonee Robinson,62,38,43,15,4,44,65,67.7,21,49,13,36,53,83,3
2251,Joel Robles,0,0,0,0,0,0,1,0.0,1,0,0,0,0,2,1
2252,Joel Roca,2,2,2,0,0,2,5,40.0,3,1,1,0,0,1,0
2253,Marc Roca,66,40,27,34,5,20,65,30.8,45,34,10,24,23,24,2
2254,Enzo Roco,33,13,23,10,0,15,24,62.5,9,22,15,7,17,63,1
2255,Marek Rodák,0,0,0,0,0,0,0,,0,0,0,0,0,1,1
2256,Sebastian Rode,38,24,7,28,3,14,45,31.1,31,18,2,16,16,12,0
2257,Joe Rodon,11,7,9,2,0,4,10,40.0,6,16,12,4,9,54,1
2258,Rodri,67,41,28,28,11,26,53,49.1,27,40,14,26,33,43,1
2259,Rodri,16,11,5,9,2,8,17,47.1,9,10,0,10,13,2,0
2260,Rodrigo,24,10,2,15,7,8,19,42.1,11,16,4,12,6,21,1
2261,Ángel Rodríguez,1,1,0,1,0,0,2,0.0,2,3,0,3,1,1,0
2262,Óscar Rodríguez Arnaiz,32,25,12,15,5,13,28,46.4,15,16,2,14,24,15,0
2263,Dani Rodríguez,42,23,18,22,2,21,46,45.7,25,31,8,23,21,14,0
2264,Guido Rodríguez,115,75,59,50,6,54,101,53.5,47,58,14,44,42,76,1
2265,Miguel Rodríguez,7,5,4,3,0,4,11,36.4,7,6,0,6,1,3,0
2266,Pablo Rodríguez,2,1,2,0,0,0,2,0.0,2,3,0,3,0,0,0
2267,Ricardo Rodríguez,54,33,30,17,7,28,42,66.7,14,30,15,15,38,61,0
2268,Rodrygo,17,10,3,7,7,4,23,17.4,19,23,0,23,8,5,0
2269,Mads Roerslev,22,12,19,3,0,16,33,48.5,17,14,5,9,9,38,0
2270,Agustín Rogel,18,9,13,5,0,11,17,64.7,6,15,8,7,11,74,1
2271,Rogério,37,21,22,8,7,17,35,48.6,18,32,9,23,37,70,0
2272,Merlin Röhl,1,0,1,0,0,0,0,,0,0,0,0,0,1,0
2273,Tony Rölke,0,0,0,0,0,0,0,,0,1,0,1,0,1,0
2274,Filippo Romagna,0,0,0,0,0,0,0,,0,1,1,0,0,2,0
2275,Alessio Romagnoli,33,15,19,14,0,11,22,50.0,11,33,26,7,38,108,0
2276,Simone Romagnoli,6,5,3,3,0,2,2,100.0,0,4,1,3,1,11,0
2277,Leo Román,0,0,0,0,0,0,0,,0,0,0,0,0,0,0
2278,Cristian Romero,68,36,42,24,2,29,46,63.0,17,40,18,22,44,102,3
2279,Iván Romero,0,0,0,0,0,0,0,,0,0,0,0,0,0,0
2280,Luka Romero,0,0,0,0,0,0,3,0.0,3,4,0,4,3,1,0
2281,Oriol Romeu,1,0,0,1,0,0,0,,0,1,0,1,1,1,0
2282,Oriol Romeu,70,38,36,26,8,26,51,51.0,25,48,10,38,37,54,0
2283,Cristiano Ronaldo,2,2,1,0,1,1,2,50.0,1,0,0,0,1,9,0
2284,Connor Ronan,0,0,0,0,0,0,0,,0,0,0,0,0,0,0
2285,Salomón Rondón,0,0,0,0,0,0,0,,0,1,1,0,0,0,0
2286,Valentin Rongier,93,59,33,47,13,41,77,53.2,36,50,11,39,54,38,1
2287,Marten de Roon,77,39,37,35,5,37,81,45.7,44,37,4,33,36,58,0
2288,Pablo Rosario,46,26,22,20,4,18,34,52.9,16,15,5,10,23,32,1
2289,Francesco Rossi,0,0,0,0,0,0,0,,0,0,0,0,0,0,0
2290,Tom Rothe,1,1,0,1,0,1,1,100.0,0,0,0,0,1,2,0
2291,Joe Rothwell,20,13,7,12,1,7,21,33.3,14,14,3,11,9,7,0
2292,Anthony Rouault,66,37,54,10,2,30,58,51.7,28,52,26,26,56,126,4
2293,Jérôme Roussillon,0,0,0,0,0,0,0,,0,0,0,0,0,0,0
2294,Jérôme Roussillon,16,9,6,8,2,8,12,66.7,4,7,2,5,4,22,0
2295,Nicolò Rovella,45,29,22,21,2,13,36,36.1,23,20,1,19,40,17,0
2296,Nicolò Rovella,1,1,0,1,0,1,1,100.0,0,0,0,0,0,0,0
2297,Amir Rrahmani,33,18,20,13,0,17,26,65.4,9,36,20,16,14,79,1
2298,Ruan,38,26,25,12,1,19,29,65.5,10,29,17,12,24,80,3
2299,Rubén,30,15,18,9,3,20,29,69.0,9,14,4,10,18,18,0
2300,Antonio Rüdiger,18,16,12,5,1,14,23,60.9,9,23,13,10,19,74,0
2301,Sebastian Rudy,26,12,10,16,0,13,27,48.1,14,27,7,20,11,13,0
2302,Daniele Rugani,7,0,6,1,0,4,4,100.0,0,7,5,2,7,32,0
2303,Matteo Ruggeri,17,12,5,9,3,8,16,50.0,8,14,3,11,12,16,0
2304,Mário Rui,34,22,17,13,4,20,41,48.8,21,17,4,13,15,24,1
2305,Aitor Ruibal,47,29,35,9,3,31,58,53.4,27,17,2,15,24,41,0
2306,Kays Ruiz,1,1,1,0,0,0,1,0.0,1,2,1,1,3,0,0
2307,Fabián Ruiz Peña,62,28,25,30,7,43,79,54.4,36,24,1,23,18,23,1
2308,Víctor Ruiz,5,3,3,2,0,3,3,100.0,0,10,7,3,6,34,0
2309,Gerónimo Rulli,0,0,0,0,0,0,0,,0,1,0,1,1,6,2
2310,Alessandro Russo,0,0,0,0,0,0,0,,0,0,0,0,0,1,1
2311,Franco Russo,2,1,2,0,0,0,1,0.0,1,5,0,5,3,5,0
2312,Georginio Rutter,10,9,5,3,2,5,8,62.5,3,5,0,5,3,3,0
2313,Georginio Rutter,7,4,1,4,2,1,3,33.3,2,10,2,8,5,6,0
2314,Julian Ryerson,28,17,17,10,1,15,25,60.0,10,15,3,12,12,19,0
2315,Julian Ryerson,27,15,17,7,3,19,37,51.4,18,13,2,11,8,28,0
2316,Frederik Rønnow,0,0,0,0,0,0,5,0.0,5,0,0,0,0,9,1
2317,José Sá,1,0,1,0,0,1,1,100.0,0,0,0,0,0,10,6
2318,Youssouf Sabaly,45,23,29,14,2,22,33,66.7,11,35,8,27,19,52,1
2319,Halid Šabanović,8,6,7,1,0,6,8,75.0,2,8,2,6,8,12,0
2320,Abdelhamid Sabiri,18,7,5,9,4,4,13,30.8,9,18,4,14,2,5,0
2321,Marcel Sabitzer,12,8,3,8,1,2,11,18.2,9,6,2,4,8,11,0
2322,Marcel Sabitzer,27,14,11,10,6,10,17,58.8,7,3,0,3,10,9,0
2323,Falaye Sacko,46,25,25,15,6,32,51,62.7,19,43,14,29,33,75,1
2324,Umar Sadiq,0,0,0,0,0,0,1,0.0,1,2,0,2,0,3,0
2325,Umar Sadiq,1,1,0,0,1,0,1,0.0,1,2,0,2,0,0,0
2326,Alexis Saelemaekers,31,20,12,16,3,19,41,46.3,22,13,1,12,19,11,0
2327,Wesley Saïd,4,1,1,2,1,2,6,33.3,4,4,0,4,1,2,0
2328,Allan Saint-Maximin,10,3,3,6,1,2,11,18.2,9,4,0,4,5,2,0
2329,Théo Sainte-Luce,13,11,8,5,0,7,14,50.0,7,7,2,5,10,11,0
2330,Samuel Sáiz,2,2,0,2,0,1,2,50.0,1,3,0,3,0,1,1
2331,Bukayo Saka,63,34,22,15,26,20,44,45.5,24,38,0,38,14,19,0
2332,Hamza Sakhi,44,22,22,17,5,22,42,52.4,20,16,1,15,25,9,0
2333,Mamadou Sakho,9,5,4,5,0,3,5,60.0,2,17,12,5,8,35,1
2334,Jacopo Sala,1,0,1,0,0,0,2,0.0,2,2,0,2,1,2,0
2335,Ibrahim Salah,8,1,5,3,0,2,15,13.3,13,3,0,3,2,0,0
2336,Mohamed Salah,21,12,4,5,12,10,26,38.5,16,21,0,21,6,4,0
2337,Amine Salama,11,9,3,7,1,2,12,16.7,10,8,2,6,10,2,0
2338,Kike Salas,1,1,1,0,0,0,0,,0,4,3,1,5,23,0
2339,William Saliba,34,20,23,9,2,15,18,83.3,3,13,10,3,19,85,4
2340,Dikeni-Rafid Salifou,0,0,0,0,0,0,0,,0,0,0,0,0,0,0
2341,Mohammed Salisu,52,29,34,16,2,24,34,70.6,10,56,25,31,30,122,1
2342,Roland Sallai,11,8,4,3,4,4,10,40.0,6,7,1,6,2,11,0
2343,Yoann Salmier,51,29,34,12,5,21,35,60.0,14,34,19,15,39,124,0
2344,Salvi,13,8,5,5,3,2,8,25.0,6,0,0,0,2,2,0
2345,Lazar Samardzic,33,16,9,20,4,17,43,39.5,26,13,0,13,11,16,0
2346,Diadie Samassékou,1,0,0,1,0,0,1,0.0,1,0,0,0,0,0,0
2347,Mama Samba Baldé,46,21,14,21,11,13,28,46.4,15,30,3,27,10,13,0
2348,Brice Samba,1,0,1,0,0,1,2,50.0,1,1,0,1,0,12,2
2349,Albert Sambi Lokonga,1,1,0,0,1,0,2,0.0,2,1,0,1,5,2,0
2350,Albert Sambi Lokonga,13,10,7,4,2,8,12,66.7,4,8,3,5,7,10,0
2351,Junior Sambia,12,5,7,4,1,6,10,60.0,4,9,3,6,8,16,1
2352,Fede San Emeterio,41,22,23,16,2,22,46,47.8,24,34,14,20,17,28,0
2353,Antonio Sanabria,11,5,3,3,5,1,7,14.3,6,9,2,7,4,7,0
2354,Leandro Sanca,1,1,0,0,1,1,1,100.0,0,0,0,0,0,0,0
2355,Oihan Sancet,27,16,2,19,6,11,37,29.7,26,10,0,10,4,9,1
2356,Renato Sanches,8,1,1,3,4,5,14,35.7,9,13,3,10,9,4,0
2357,Alexis Sánchez,27,17,5,16,6,3,24,12.5,21,14,0,14,5,6,0
2358,Antonio Sánchez,19,8,13,4,2,10,34,29.4,24,18,0,18,22,14,1
2359,Davinson Sánchez,24,11,17,6,1,14,20,70.0,6,16,10,6,12,41,0
2360,Iván Sánchez,20,14,8,8,4,10,27,37.0,17,14,1,13,8,4,0
2361,Javi Sánchez,43,26,27,15,1,17,26,65.4,9,32,22,10,46,116,0
2362,Manu Sánchez,51,35,35,9,7,33,63,52.4,30,33,5,28,14,51,0
2363,Robert Sánchez,1,0,1,0,0,0,0,,0,0,0,0,3,9,2
2364,Jadon Sancho,16,10,7,5,4,8,28,28.6,20,25,2,23,7,6,0
2365,Alex Sandro,35,20,16,16,3,15,22,68.2,7,27,10,17,15,64,1
2366,Leroy Sané,38,30,11,19,8,18,36,50.0,18,11,1,10,3,1,2
2367,Sidi Sané,1,1,1,0,0,1,1,100.0,0,0,0,0,0,0,0
2368,Morgan Sanson,2,1,1,1,0,1,1,100.0,0,0,0,0,0,0,0
2369,Morgan Sanson,36,25,10,16,10,17,56,30.4,39,21,1,20,22,9,0
2370,Nicola Sansone,12,4,6,4,2,5,10,50.0,5,0,0,0,0,4,0
2371,Baptiste Santamaria,41,22,13,23,5,21,41,51.2,20,21,5,16,21,23,0
2372,Riccardo Saponara,10,5,3,6,1,5,9,55.6,4,7,1,6,5,9,1
2373,Pablo Sarabia,12,6,4,5,3,6,15,40.0,9,7,0,7,2,4,0
2374,Pablo Sarabia,5,4,2,2,1,1,7,14.3,6,3,0,3,2,0,0
2375,Jeremy Sarmiento,6,3,4,1,1,2,5,40.0,3,2,0,2,1,0,0
2376,Amin Sarr,9,6,1,4,4,1,4,25.0,3,2,0,2,0,4,0
2377,Bouna Sarr,0,0,0,0,0,0,0,,0,0,0,0,0,0,0
2378,Malang Sarr,6,3,5,1,0,1,5,20.0,4,11,7,4,15,29,2
2379,Mamadou Sarr,0,0,0,0,0,0,0,,0,0,0,0,0,0,0
2380,Mouhamadou Sarr,0,0,0,0,0,0,0,,0,0,0,0,0,2,0
2381,Martin Satriano,13,8,5,6,2,6,14,42.9,8,5,0,5,3,22,0
2382,Téji Savanier,46,30,16,19,11,23,70,32.9,47,30,2,28,30,12,1
2383,Esteban Saveljich,0,0,0,0,0,0,0,,0,0,0,0,0,0,0
2384,Stefan Savić,39,26,29,7,3,26,39,66.7,13,17,8,9,33,67,2
2385,Joe Scally,31,20,25,5,1,24,31,77.4,7,17,6,11,8,61,0
2386,Giorgio Scalvini,54,29,30,18,6,29,55,52.7,26,36,13,23,56,57,2
2387,Gianluca Scamacca,10,5,1,3,6,2,2,100.0,0,3,0,3,4,5,0
2388,Gustavo Scarpa,5,2,3,1,1,2,5,40.0,3,4,0,4,0,3,0
2389,Kevin Schade,12,8,7,2,3,5,10,50.0,5,7,0,7,4,6,0
2390,Kevin Schade,6,4,3,2,1,3,5,60.0,2,0,0,0,0,2,0
2391,András Schäfer,21,9,7,12,2,6,14,42.9,8,12,2,10,4,11,0
2392,Fabian Schär,47,22,31,13,3,24,39,61.5,15,34,19,15,52,139,0
2393,Derry Scherhant,7,6,3,3,1,4,8,50.0,4,3,0,3,0,5,0
2394,Patrik Schick,0,0,0,0,0,0,1,0.0,1,4,1,3,1,7,0
2395,Kingsley Schindler,23,12,13,8,2,18,28,64.3,10,14,2,12,15,24,0
2396,Xaver Schlager,41,24,13,26,2,20,43,46.5,23,19,2,17,17,23,0
2397,Keven Schlotterbeck,0,0,0,0,0,0,0,,0,1,1,0,2,2,0
2398,Keven Schlotterbeck,17,9,12,5,0,9,11,81.8,2,11,5,6,14,49,0
2399,Nico Schlotterbeck,59,34,34,24,1,37,53,69.8,16,38,21,17,32,71,1
2400,Jeffrey Schlupp,66,46,28,29,9,22,43,51.2,21,39,8,31,23,38,0
2401,Kasper Schmeichel,1,0,1,0,0,1,4,25.0,3,1,0,1,1,11,1
2402,Jonathan Schmid,1,1,1,0,0,0,0,,0,1,0,1,1,1,1
2403,Romano Schmid,24,15,5,13,6,10,22,45.5,12,21,3,18,7,12,0
2404,Kenneth Schmidt,6,3,4,2,0,5,6,83.3,1,4,2,2,0,2,0
2405,Niklas Schmidt,25,10,12,11,2,13,28,46.4,15,10,0,10,5,12,0
2406,Benno Schmitz,64,42,31,28,5,42,82,51.2,40,34,4,30,26,57,0
2407,Jerdy Schouten,63,38,28,33,2,27,49,55.1,22,40,17,23,40,43,1
2408,Perr Schuurs,51,25,29,17,5,14,26,53.8,12,28,16,12,28,102,0
2409,Marvin Schwäbe,1,0,1,0,0,1,1,100.0,0,0,0,0,2,8,2
2410,Alexander Schwolow,0,0,0,0,0,0,2,0.0,2,0,0,0,1,6,3
2411,Manuel Sebastián,7,4,3,3,1,5,8,62.5,3,0,0,0,0,2,0
2412,Demba Seck,5,2,3,2,0,2,3,66.7,1,3,1,2,1,1,0
2413,Haris Seferović,6,3,1,4,1,3,8,37.5,5,7,1,6,1,6,1
2414,Telasco Segovia,0,0,0,0,0,0,0,,0,0,0,0,0,0,0
2415,Jacopo Segre,0,0,0,0,0,0,0,,0,0,0,0,0,0,0
2416,Paul Seguin,17,8,9,4,4,8,18,44.4,10,6,0,6,6,7,0
2417,Alidu Seidu,52,31,35,14,3,31,51,60.8,20,28,14,14,52,50,2
2418,Davie Selke,2,1,1,1,0,0,1,0.0,1,3,1,2,1,5,0
2419,Davie Selke,0,0,0,0,0,0,4,0.0,4,4,1,3,0,11,0
2420,Matz Sels,4,3,4,0,0,4,4,100.0,0,0,0,0,4,23,0
2421,Nélson Semedo,71,42,48,19,4,33,64,51.6,31,42,15,27,29,83,2
2422,Vivaldo Semedo,0,0,0,0,0,0,0,,0,1,0,1,0,1,0
2423,Antoine Semenyo,1,0,0,0,1,1,6,16.7,5,10,1,9,2,4,0
2424,Marvin Senaya,0,0,0,0,0,0,1,0.0,1,1,0,1,0,1,0
2425,Marcos Senesi,50,35,28,22,0,23,44,52.3,21,38,20,18,43,146,2
2426,Stefano Sensi,41,26,25,13,3,18,48,37.5,30,13,3,10,20,4,0
2427,Jaime Seoane,10,4,3,4,3,2,8,25.0,6,7,3,4,1,2,0
2428,Luigi Sepe,0,0,0,0,0,0,1,0.0,1,0,0,0,0,0,0
2429,Suat Serdar,51,23,14,30,7,20,41,48.8,21,48,12,36,29,24,0
2430,Leonardo Sernicola,45,33,25,13,7,29,43,67.4,14,23,6,17,38,55,0
2431,Ryan Sessegnon,16,11,9,7,0,6,12,50.0,6,8,1,7,6,17,1
2432,Stephan El Shaarawy,21,9,8,10,3,6,22,27.3,16,11,1,10,15,11,0
2433,Eniss Shabani,0,0,0,0,0,0,0,,0,0,0,0,0,0,0
2434,Luke Shaw,55,36,31,22,2,32,46,69.6,14,51,17,34,36,55,2
2435,Jonjo Shelvey,1,0,1,0,0,0,1,0.0,1,1,0,1,0,0,0
2436,Jonjo Shelvey,2,1,0,1,1,1,9,11.1,8,7,2,5,5,10,1
2437,Eldor Shomurodov,5,5,3,1,1,2,11,18.2,9,5,1,4,3,4,0
2438,Eldor Shomurodov,1,0,1,0,0,0,2,0.0,2,1,0,1,1,0,0
2439,Kaj Sierhuis,3,3,1,0,2,0,5,0.0,5,3,1,2,1,2,0
2440,Vincent Sierro,19,11,9,9,1,11,29,37.9,18,12,3,9,4,11,1
2441,Kiliann Sildillia,33,20,10,19,4,18,30,60.0,12,24,9,15,21,47,1
2442,André Silva,12,6,2,5,5,3,8,37.5,5,11,1,10,3,3,0
2443,Bernardo Silva,44,23,11,25,8,18,45,40.0,27,23,6,17,16,6,0
2444,Caio Henrique Oliveira Silva,74,51,42,28,4,44,76,57.9,32,28,8,20,26,68,1
2445,David Silva,36,21,11,18,7,11,19,57.9,8,17,2,15,15,16,0
2446,Rui Silva,4,1,4,0,0,4,4,100.0,0,0,0,0,0,12,1
2447,Thiago Silva,41,27,24,17,0,21,31,67.7,10,38,29,9,34,111,3
2448,Marco Silvestri,2,1,2,0,0,2,3,66.7,1,0,0,0,1,15,1
2449,Abdallah Sima,22,13,4,15,3,7,19,36.8,12,8,0,8,4,19,0
2450,Mohamed Simakan,21,14,12,5,4,14,21,66.7,7,21,4,17,16,55,0
2451,Giovanni Simeone,12,3,3,5,4,3,8,37.5,5,2,1,1,1,4,0
2452,Ellis Simms,0,0,0,0,0,0,0,,0,0,0,0,0,1,0
2453,Simo,3,1,3,0,0,2,3,66.7,1,5,4,1,0,3,0
2454,Moses Simon,18,9,6,7,5,7,15,46.7,8,14,1,13,11,3,0
2455,Unai Simón,2,0,2,0,0,1,1,100.0,0,1,0,1,0,9,3
2456,Lassine Sinayoko,33,15,14,12,7,21,40,52.5,19,12,0,12,18,17,0
2457,Wilfried Singo,27,17,14,10,3,12,19,63.2,7,15,2,13,12,33,1
2458,Luis Sinisterra,21,14,8,9,4,11,18,61.1,7,11,1,10,8,2,0
2459,Daley Sinkgraven,10,7,7,3,0,7,9,77.8,2,8,4,4,5,7,0
2460,Tobias Sippel,0,0,0,0,0,0,0,,0,0,0,0,0,1,1
2461,Hugo Siquet,2,2,2,0,0,2,2,100.0,0,1,0,1,0,0,0
2462,Salvatore Sirigu,0,0,0,0,0,0,0,,0,0,0,0,0,1,0
2463,Ibrahima Sissoko,40,22,18,17,5,22,42,52.4,20,20,6,14,10,19,0
2464,Moussa Sissoko,26,16,16,7,3,12,18,66.7,6,22,5,17,16,17,0
2465,Tim Skarke,1,1,0,0,1,0,0,,0,1,0,1,0,0,0
2466,Tim Skarke,13,7,3,8,2,8,11,72.7,3,5,0,5,0,4,0
2467,Ellyes Skhiri,79,44,29,42,8,26,66,39.4,40,52,12,40,56,48,0
2468,Oliver Skipp,34,17,18,15,1,16,33,48.5,17,17,8,9,17,19,1
2469,Leo Skiri Østigård,4,1,3,1,0,1,1,100.0,0,3,3,0,6,18,1
2470,Łukasz Skorupski,2,1,2,0,0,1,2,50.0,1,0,0,0,0,19,2
2471,Robert Skov,22,11,14,7,1,10,26,38.5,16,22,8,14,8,20,2
2472,Milan Škriniar,29,18,14,11,4,18,32,56.3,14,18,13,5,13,46,3
2473,Naatan Skyttä,0,0,0,0,0,0,0,,0,0,0,0,1,0,0
2474,Islam Slimani,5,3,2,2,1,0,3,0.0,3,2,0,2,1,11,0
2475,Chris Smalling,26,15,16,10,0,13,21,61.9,8,51,36,15,43,123,0
2476,Adam Smith,49,29,27,19,3,29,60,48.3,31,30,13,17,25,81,1
2477,Emile Smith Rowe,1,1,1,0,0,1,3,33.3,2,1,0,1,0,2,0
2478,Hrvoje Smolčić,8,7,6,2,0,5,10,50.0,5,11,4,7,6,38,0
2479,Cédric Soares,0,0,0,0,0,0,1,0.0,1,1,0,1,0,1,0
2480,Cédric Soares,8,5,4,3,1,3,3,100.0,0,3,1,2,1,5,0
2481,Danilo Soares,72,46,42,23,7,43,72,59.7,29,29,6,23,30,56,1
2482,Eduard Sobol,19,10,10,6,3,9,13,69.2,4,10,1,9,8,19,0
2483,Rubén Sobrino,55,37,29,17,9,23,56,41.1,33,33,3,30,24,20,1
2484,Alex Sola,18,9,14,3,1,7,10,70.0,3,7,2,5,7,10,0
2485,Dominic Solanke,15,9,8,3,4,5,22,22.7,17,26,7,19,6,46,0
2486,Augusto Solari,10,6,6,3,1,3,11,27.3,8,5,0,5,4,3,0
2487,Ola Solbakken,2,2,1,1,0,2,7,28.6,5,2,0,2,2,8,0
2488,Nikola Soldo,15,9,8,7,0,7,11,63.6,4,7,6,1,7,28,0
2489,Carlos Soler,2,0,0,1,1,2,3,66.7,1,1,0,1,0,2,0
2490,Carlos Soler,20,12,6,10,4,10,19,52.6,9,12,4,8,4,6,0
2491,François-Joseph Sollacaro,0,0,0,0,0,0,0,,0,0,0,0,0,2,2
2492,Manor Solomon,20,12,12,6,2,9,16,56.3,7,8,0,8,5,3,0
2493,Yann Sommer,1,0,1,0,0,1,1,100.0,0,0,0,0,0,8,0
2494,Yann Sommer,0,0,0,0,0,0,0,,0,0,0,0,1,5,1
2495,Brandon Soppy,1,1,0,1,0,0,0,,0,4,0,4,1,1,0
2496,Brandon Soppy,8,5,4,4,0,3,9,33.3,6,10,0,10,3,7,0
2497,David Soria,0,0,0,0,0,0,1,0.0,1,0,0,0,1,20,4
2498,Roberto Soriano,31,16,9,16,6,13,25,52.0,12,23,2,21,6,14,0
2499,Borna Sosa,27,21,18,8,1,21,32,65.6,11,20,5,15,19,37,0
2500,Joaquin Sosa,6,2,5,1,0,4,18,22.2,14,5,3,2,6,31,0
2501,Hugo Sotelo,0,0,0,0,0,0,0,,0,0,0,0,0,0,0
2502,Florian Sotoca,39,19,11,17,11,15,40,37.5,25,41,2,39,29,51,0
2503,Riccardo Sottil,4,3,2,0,2,2,5,40.0,3,2,0,2,0,0,0
2504,Tomáš Souček,77,37,41,29,7,28,58,48.3,30,42,17,25,53,71,3
2505,Matìas Soulé,7,4,3,2,2,5,7,71.4,2,7,1,6,3,3,0
2506,Moussa Soumano,2,2,0,1,1,0,6,0.0,6,2,0,2,0,0,0
2507,Adama Soumaoro,25,17,11,12,2,5,7,71.4,2,18,13,5,15,75,1
2508,Boubakary Soumaré,57,34,29,26,2,23,44,52.3,21,15,4,11,33,27,1
2509,Arnaud Souquet,22,16,13,7,2,11,14,78.6,3,8,3,5,4,4,0
2510,Dyego Sousa,10,6,5,4,1,4,5,80.0,1,4,2,2,1,14,0
2511,Harry Souttar,15,9,10,5,0,7,18,38.9,11,16,12,4,12,45,0
2512,Vinicius Souza,99,66,41,45,13,33,59,55.9,26,31,14,17,48,50,1
2513,Djibril Sow,41,25,13,25,3,22,44,50.0,22,22,4,18,28,23,0
2514,Çağlar Söyüncü,14,9,10,4,0,7,10,70.0,3,9,8,1,7,30,0
2515,Kevin Spadanuda,29,18,15,9,5,12,33,36.4,21,18,0,18,11,5,0
2516,Djed Spence,0,0,0,0,0,0,0,,0,0,0,0,0,0,0
2517,Djed Spence,14,6,8,2,4,11,18,61.1,7,10,3,7,4,15,0
2518,Stijn Spierings,95,67,37,49,9,43,101,42.6,58,49,11,38,53,44,0
2519,Leonardo Spinazzola,15,8,7,6,2,8,23,34.8,15,13,3,10,9,25,0
2520,Marco Sportiello,1,0,1,0,0,1,3,33.3,2,0,0,0,0,2,0
2521,Jack Stacey,5,4,3,1,1,2,5,40.0,3,3,1,2,5,15,0
2522,Anton Stach,27,21,10,15,2,16,38,42.1,22,28,2,26,41,25,0
2523,Kostas Stafylidis,27,16,13,8,6,10,24,41.7,14,21,8,13,20,31,1
2524,Jens Stage,34,17,15,18,1,10,37,27.0,27,34,11,23,16,37,0
2525,Veit Stange,1,1,1,0,0,1,1,100.0,0,0,0,0,0,0,0
2526,Josip Stanišić,19,11,14,2,3,12,17,70.6,5,9,1,8,7,11,3
2527,Junior Stanislas,0,0,0,0,0,0,0,,0,2,1,1,0,0,0
2528,Jay Stansfield,0,0,0,0,0,0,2,0.0,2,4,1,3,1,1,0
2529,Niklas Stark,56,36,29,24,3,27,42,64.3,15,24,13,11,37,110,0
2530,Jason Steele,0,0,0,0,0,0,1,0.0,1,0,0,0,0,6,1
2531,Calvin Stengs,2,2,1,0,1,1,2,50.0,1,0,0,0,0,0,0
2532,Pascal Stenzel,12,8,8,4,0,5,9,55.6,4,9,2,7,5,6,0
2533,Jack Stephens,2,2,2,0,0,1,1,100.0,0,1,1,0,1,2,0
2534,Jack Stephens,15,11,10,4,1,6,10,60.0,4,23,16,7,16,53,0
2535,Raheem Sterling,18,10,5,4,9,8,14,57.1,6,17,0,17,2,5,0
2536,Angelo Stiller,26,12,9,13,4,8,12,66.7,4,12,2,10,10,14,0
2537,Lars Stindl,24,14,4,17,3,10,28,35.7,18,24,5,19,11,19,0
2538,Kevin Stöger,84,45,38,32,14,31,94,33.0,63,27,4,23,26,21,1
2539,Petar Stojanović,42,22,28,10,4,26,43,60.5,17,17,5,12,11,55,0
2540,John Stones,23,13,11,8,4,7,10,70.0,3,17,10,7,9,40,0
2541,Jørgen Strand Larsen,15,7,3,5,7,7,30,23.3,23,14,5,9,3,24,0
2542,Tony Strata,4,3,4,0,0,4,5,80.0,1,2,0,2,1,7,0
2543,Gabriel Strefezza,50,24,18,20,12,27,53,50.9,26,36,3,33,16,15,0
2544,Dávid Strelec,2,2,0,1,1,2,2,100.0,0,0,0,0,0,0,0
2545,Pascal Struijk,84,57,43,31,10,49,75,65.3,26,32,12,20,32,70,1
2546,Cristhian Stuani,13,6,2,7,4,5,14,35.7,9,10,0,10,2,5,0
2547,Damián Suárez,49,33,23,19,7,26,48,54.2,22,40,0,40,15,36,0
2548,Denis Suárez,26,20,12,12,2,13,45,28.9,32,11,1,10,5,4,0
2549,Mario Suárez,0,0,0,0,0,0,0,,0,1,0,1,0,0,0
2550,Gabriel Suazo,38,22,20,15,3,29,63,46.0,34,21,5,16,22,24,1
2551,Isaac Success,8,4,2,5,1,3,8,37.5,5,13,2,11,4,18,0
2552,Niklas Süle,25,19,18,3,4,14,23,60.9,9,28,19,9,17,53,0
2553,Ibrahim Sulemana,19,13,10,7,2,6,12,50.0,6,8,2,6,14,15,0
2554,Kamaldeen Sulemana,15,9,4,7,4,4,14,28.6,10,16,0,16,6,6,0
2555,Kamaldeen Sulemana,6,3,1,4,1,1,5,20.0,4,2,0,2,4,2,0
2556,Crysencio Summerville,30,20,14,14,2,11,23,47.8,12,20,2,18,13,11,0
2557,Ivan Šunjić,38,20,16,21,1,16,24,66.7,8,17,5,12,13,19,1
2558,Sam Surridge,5,0,1,3,1,1,4,25.0,3,5,2,3,0,7,0
2559,Suso,16,10,5,7,4,10,22,45.5,12,7,1,6,2,3,0
2560,Yuito Suzuki,0,0,0,0,0,0,0,,0,3,0,3,0,0,0
2561,Mattias Svanberg,25,16,8,16,1,10,30,33.3,20,27,5,22,21,25,1
2562,Mile Svilar,0,0,0,0,0,0,0,,0,0,0,0,0,1,0
2563,Williot Swedberg,3,1,1,0,2,0,0,,0,2,0,2,0,1,0
2564,Issiaga Sylla,28,16,19,8,1,15,31,48.4,16,19,3,16,32,35,0
2565,Issiaga Sylla,28,15,14,9,5,15,34,44.1,19,15,5,10,38,38,0
2566,Wojciech Szczęsny,1,0,1,0,0,0,1,0.0,1,0,0,0,0,7,0
2567,Dominik Szoboszlai,45,28,12,20,13,17,42,40.5,25,43,2,41,17,27,0
2568,Alexander Sørloth,18,9,3,6,9,7,14,50.0,7,15,1,14,2,26,1
2569,Alexander Sørloth,0,0,0,0,0,0,0,,0,0,0,0,0,0,0
2570,Nicolás Tagliafico,91,53,36,41,14,50,78,64.1,28,45,11,34,57,47,0
2571,Jonathan Tah,25,12,21,4,0,12,18,66.7,6,30,18,12,40,118,0
2572,Benjamin Tahirovic,8,5,5,2,1,4,12,33.3,8,9,4,5,3,3,0
2573,Waniss Taibi,9,5,4,4,1,2,4,50.0,2,1,0,1,2,2,0
2574,Flavien Tait,30,15,8,17,5,19,42,45.2,23,16,4,12,20,12,0
2575,Montassar Talbi,53,25,40,13,0,22,35,62.9,13,55,34,21,40,190,3
2576,Thibault Tamas,0,0,0,0,0,0,0,,0,0,0,0,1,0,0
2577,Adrien Tameze,51,30,21,26,4,28,63,44.4,35,51,14,37,37,55,2
2578,Japhet Tanganga,3,2,3,0,0,1,5,20.0,4,1,0,1,2,8,0
2579,Renato Tapia,47,25,21,21,5,18,37,48.6,19,29,11,18,19,37,0
2580,Edmond Tapsoba,51,30,35,12,4,30,42,71.4,12,40,17,23,36,109,1
2581,Florian Tardieu,31,20,19,12,0,12,31,38.7,19,19,4,15,23,15,0
2582,Matt Targett,13,10,8,3,2,9,24,37.5,15,8,3,5,9,16,0
2583,James Tarkowski,51,26,36,13,2,20,39,51.3,19,99,78,21,51,201,3
2584,Ciprian Tătărușanu,0,0,0,0,0,0,0,,0,0,0,0,1,2,0
2585,Niklas Tauer,2,1,2,0,0,1,3,33.3,2,2,1,1,2,4,0
2586,Nuno Tavares,56,30,19,24,13,28,56,50.0,28,32,4,28,15,25,0
2587,Marcus Tavernier,33,22,19,11,3,11,33,33.3,22,25,4,21,9,23,0
2588,Enzo Tchato,26,17,14,11,1,13,22,59.1,9,17,2,15,7,33,0
2589,Aurélien Tchouaméni,64,40,23,36,5,23,38,60.5,15,20,6,14,49,50,0
2590,Mathys Tel,2,2,0,1,1,1,1,100.0,0,5,1,4,0,2,0
2591,Semir Telalovic,0,0,0,0,0,0,0,,0,0,0,0,0,0,0
2592,Alex Telles,21,13,15,6,0,13,25,52.0,12,17,5,12,20,38,0
2593,Marc-André ter Stegen,0,0,0,0,0,0,0,,0,0,0,0,1,7,3
2594,Simon Terodde,15,8,4,7,4,3,14,21.4,11,6,2,4,6,9,0
2595,Filippo Terracciano,20,13,11,7,2,15,20,75.0,5,7,4,3,10,14,0
2596,Pietro Terracciano,2,1,2,0,0,2,3,66.7,1,0,0,0,1,14,0
2597,Ramón Terrats,15,10,3,8,4,9,17,52.9,8,11,4,7,8,6,2
2598,Ramón Terrats,4,2,1,3,0,2,6,33.3,4,6,2,4,3,3,1
2599,Martin Terrier,25,11,7,9,9,13,24,54.2,11,15,2,13,14,6,0
2600,Aleksa Terzić,16,9,9,4,3,11,21,52.4,10,13,4,9,5,16,0
2601,Tetê,14,8,5,7,2,6,21,28.6,15,9,0,9,2,3,0
2602,Tetê,21,10,8,5,8,10,19,52.6,9,9,0,9,13,2,0
2603,Kenny Tete,83,46,41,29,13,38,51,74.5,13,48,17,31,52,81,1
2604,Florian Thauvin,2,1,0,2,0,2,13,15.4,11,5,0,5,2,2,0
2605,Arthur Theate,29,19,17,8,4,17,30,56.7,13,26,14,12,30,114,3
2606,Malick Thiaw,31,26,22,9,0,11,20,55.0,9,11,5,6,12,65,1
2607,Malick Thiaw,3,1,2,1,0,1,2,50.0,1,4,3,1,9,24,1
2608,Jan Thielmann,9,8,3,4,2,2,11,18.2,9,16,3,13,9,7,0
2609,Sada Thioub,19,10,9,8,2,8,17,47.1,9,13,0,13,7,5,1
2610,Luke Thomas,23,19,15,5,3,15,32,46.9,17,20,4,16,27,35,0
2611,Adrien Thomasson,19,9,8,6,5,9,30,30.0,21,18,0,18,3,2,0
2612,Adrien Thomasson,24,17,8,11,5,12,45,26.7,33,25,2,23,4,17,0
2613,Morten Thorsby,22,10,9,11,2,13,21,61.9,8,11,5,6,3,20,0
2614,Kristian Thorstvedt,16,7,4,9,3,6,17,35.3,11,19,5,14,14,13,0
2615,Khéphren Thuram,51,25,22,23,6,19,43,44.2,24,33,13,20,38,34,0
2616,Marcus Thuram,14,7,3,6,5,6,13,46.2,7,20,3,17,6,22,0
2617,Alexis Tibidi,1,1,1,0,0,0,0,,0,0,0,0,0,0,0
2618,Youri Tielemans,66,39,27,30,9,23,62,37.1,39,35,8,27,28,24,1
2619,Kieran Tierney,20,11,9,9,2,12,16,75.0,4,8,2,6,11,25,0
2620,Steffen Tigges,12,7,1,8,3,4,14,28.6,10,13,2,11,8,17,0
2621,Jean-Clair Todibo,76,48,54,19,3,41,56,73.2,15,41,19,22,41,110,2
2622,Harry Toffolo,17,8,10,4,3,10,14,71.4,4,16,8,8,10,33,0
2623,Umut Tohumcu,10,5,4,5,1,3,9,33.3,6,4,0,4,2,8,0
2624,Karl Toko Ekambi,3,1,1,1,1,3,9,33.3,6,5,0,5,9,3,0
2625,Karl Toko Ekambi,9,9,2,4,3,4,15,26.7,11,12,2,10,9,6,0
2626,Corentin Tolisso,44,27,16,23,5,25,66,37.9,41,25,5,20,24,23,1
2627,Jeremy Toljan,36,23,17,14,5,22,33,66.7,11,31,14,17,18,60,1
2628,Rafael Tolói,69,44,37,32,0,35,64,54.7,29,42,18,24,57,88,1
2629,Raúl de Tomás,3,2,0,1,2,2,6,33.3,4,4,0,4,0,6,0
2630,Tiago Tomás,10,4,2,4,4,8,13,61.5,5,9,2,7,1,5,0
2631,Takehiro Tomiyasu,27,18,12,10,5,13,18,72.2,5,7,0,7,14,15,1
2632,James Tomkins,4,2,2,1,1,1,3,33.3,2,3,2,1,5,19,0
2633,Fikayo Tomori,70,34,44,25,1,22,34,64.7,12,46,25,21,29,88,1
2634,Sandro Tonali,64,41,35,24,5,27,44,61.4,17,34,9,25,25,26,1
2635,Lorenzo Tonelli,0,0,0,0,0,0,1,0.0,1,0,0,0,0,0,0
2636,Ivan Toney,23,13,4,9,10,7,23,30.4,16,24,9,15,14,36,0
2637,Pablo Torre,2,1,0,1,1,2,4,50.0,2,1,0,1,2,1,0
2638,David Torres,1,1,0,1,0,1,1,100.0,0,4,2,2,3,8,0
2639,Ferrán Torres,13,7,4,5,4,5,20,25.0,15,11,2,9,3,5,0
2640,Óliver Torres,39,23,12,13,14,18,59,30.5,41,26,5,21,10,10,0
2641,Pau Torres,43,25,25,13,5,23,36,63.9,13,36,27,9,13,146,3
2642,Roberto Torres,0,0,0,0,0,0,0,,0,0,0,0,0,0,0
2643,Lucas Torró,48,32,28,15,5,18,42,42.9,24,24,3,21,42,64,1
2644,Nabil Touaizi,0,0,0,0,0,0,0,,0,0,0,0,0,0,0
2645,Almamy Touré,13,7,7,5,1,5,9,55.6,4,9,2,7,10,8,0
2646,Birama Touré,80,47,35,35,10,34,93,36.6,59,54,9,45,67,49,0
2647,Mohamed Toure,0,0,0,0,0,0,0,,0,0,0,0,0,0,0
2648,Souleymane Touré,2,1,1,1,0,1,2,50.0,1,1,0,1,0,5,0
2649,Souleymane Touré,29,13,19,9,1,16,20,80.0,4,32,12,20,26,56,1
2650,Lucas Tousart,73,38,35,28,10,27,60,45.0,33,42,6,36,48,75,1
2651,Yoann Touzghar,3,2,0,2,1,0,1,0.0,1,0,0,0,0,1,0
2652,Adama Traoré,14,7,7,4,3,4,9,44.4,5,8,1,7,3,17,0
2653,Bertrand Traoré,1,1,1,0,0,1,4,25.0,3,5,0,5,2,0,0
2654,Boubacar Traoré,12,5,4,5,3,3,7,42.9,4,4,2,2,7,1,0
2655,Charles Traore,8,5,5,2,1,5,7,71.4,2,9,2,7,10,12,0
2656,Hamari Traoré,48,32,26,15,7,28,52,53.8,24,33,7,26,38,64,0
2657,Kevin Trapp,1,1,1,0,0,0,2,0.0,2,2,0,2,0,10,0
2658,Mark Travers,0,0,0,0,0,0,0,,0,1,0,1,0,6,0
2659,Óscar Trejo,48,32,12,23,13,9,44,20.5,35,31,3,28,8,8,1
2660,Manu Trigueros,20,14,9,5,6,9,22,40.9,13,9,2,7,5,4,0
2661,Christopher Trimmel,31,16,16,12,3,20,31,64.5,11,14,1,13,25,48,0
2662,Théo Trinker,0,0,0,0,0,0,0,,0,0,0,0,0,0,0
2663,Kieran Trippier,71,49,36,27,8,46,90,51.1,44,45,15,30,43,84,2
2664,William Troost-Ekong,11,3,7,4,0,6,7,85.7,1,7,4,3,6,10,0
2665,Leandro Trossard,12,7,4,2,6,6,18,33.3,12,18,0,18,6,3,1
2666,Leandro Trossard,10,6,7,1,2,1,8,12.5,7,17,0,17,6,1,0
2667,Adrien Truffert,62,32,36,17,9,31,46,67.4,15,32,8,24,22,55,0
2668,Frank Tsadjout,10,8,3,6,1,3,9,33.3,6,7,1,6,8,9,0
2669,Kostas Tsimikas,14,9,10,2,2,10,16,62.5,6,8,1,7,12,15,0
2670,Theocharis Tsingaras,0,0,0,0,0,0,0,,0,0,0,0,0,0,0
2671,Viktor Tsyhankov,8,8,5,1,2,1,14,7.1,13,13,2,11,7,12,0
2672,Alessandro Tuia,10,6,6,4,0,3,9,33.3,6,3,1,2,15,29,0
2673,Martin Turk,0,0,0,0,0,0,0,,0,0,0,0,0,1,0
2674,Beñat Turrientes,3,3,3,0,0,1,5,20.0,4,2,0,2,0,3,0
2675,Tuta,53,35,27,19,7,33,57,57.9,24,47,14,33,49,134,2
2676,Destiny Udogie,71,45,42,24,5,34,59,57.6,25,34,6,28,36,25,0
2677,Ike Ugbo,5,2,2,2,1,3,11,27.3,8,8,2,6,2,4,0
2678,Lesley Ugochukwu,36,19,13,20,3,16,24,66.7,8,24,10,14,21,16,0
2679,Samir Ujkani,0,0,0,0,0,0,0,,0,0,0,0,0,0,0
2680,Sven Ulreich,1,1,1,0,0,1,1,100.0,0,0,0,0,0,0,1
2681,Lauren Ulrich,1,1,0,0,1,0,0,,0,0,0,0,0,0,0
2682,Samuel Umtiti,52,34,25,25,2,18,26,69.2,8,26,14,12,26,79,0
2683,Enes Ünal,26,14,5,19,2,7,25,28.0,18,19,2,17,6,35,0
2684,Deniz Undav,7,4,2,2,3,2,8,25.0,6,4,1,3,0,1,0
2685,Cengiz Ünder,37,19,15,13,9,13,34,38.2,21,18,2,16,18,13,0
2686,Dayot Upamecano,65,37,43,22,0,28,45,62.2,17,26,6,20,27,71,4
2687,Filip Uremović,38,23,29,8,1,14,22,63.6,8,18,13,5,36,88,2
2688,Oscar Ureña,4,2,2,2,0,2,3,66.7,1,2,0,2,1,0,0
2689,Jere Uronen,8,5,4,4,0,7,12,58.3,5,6,2,4,7,5,0
2690,Jere Uronen,14,10,6,6,2,6,10,60.0,4,5,2,3,8,13,0
2691,Mark Uth,0,0,0,0,0,0,0,,0,0,0,0,0,0,0
2692,Josha Vagnoman,26,15,12,11,3,15,27,55.6,12,20,2,18,8,29,1
2693,Diego Valencia,8,5,4,2,2,2,9,22.2,7,10,1,9,1,2,0
2694,Óscar Valentín,92,51,29,50,13,46,121,38.0,75,60,9,51,44,30,0
2695,Emanuele Valeri,54,27,29,21,4,29,69,42.0,40,17,3,14,22,44,1
2696,Yan Valery,0,0,0,0,0,0,0,,0,1,0,1,0,3,0
2697,Yan Valery,54,39,28,20,6,20,37,54.1,17,35,15,20,34,82,0
2698,Martin Valjent,35,27,22,12,1,19,28,67.9,9,39,21,18,29,137,0
2699,Jesús Vallejo,0,0,0,0,0,0,0,,0,0,0,0,0,0,0
2700,Manu Vallejo,4,1,1,2,1,1,6,16.7,5,2,0,2,1,3,0
2701,Mattia Valoti,17,10,7,9,1,5,16,31.3,11,13,3,10,3,6,0
2702,Federico Valverde,31,20,14,11,6,13,26,50.0,13,31,4,27,17,15,0
2703,Virgil van Dijk,27,14,13,11,3,8,19,42.1,11,24,16,8,31,138,3
2704,Vanderson,84,48,36,34,14,44,75,58.7,31,36,9,27,48,36,1
2705,Raphaël Varane,24,9,18,6,0,7,17,41.2,10,24,17,7,11,91,0
2706,Jamie Vardy,9,5,4,2,3,1,8,12.5,7,17,3,14,2,30,0
2707,Ruben Vargas,15,7,6,7,2,5,11,45.5,6,8,2,6,6,16,1
2708,Johan Vásquez,41,26,34,7,0,18,39,46.2,21,27,20,7,45,93,1
2709,Jesus Vazquez,13,8,9,1,3,6,11,54.5,5,4,0,4,1,8,0
2710,Kevin Vázquez,13,8,5,7,1,8,12,66.7,4,4,1,3,2,8,0
2711,Lucas Vázquez,34,23,22,10,2,20,28,71.4,8,10,0,10,7,13,0
2712,Matías Vecino,47,27,13,23,11,23,48,47.9,25,33,10,23,16,39,1
2713,Gabriel Veiga,43,19,14,25,4,16,52,30.8,36,30,3,27,21,6,0
2714,Renato Veiga,9,6,4,3,2,7,9,77.8,2,20,6,14,7,29,1
2715,Miloš Veljković,30,19,17,13,0,18,29,62.1,11,32,16,16,33,103,0
2716,Miguel Veloso,33,10,20,12,1,16,26,61.5,10,26,6,20,6,14,0
2717,Joël Veltman,62,32,44,14,4,37,57,64.9,20,27,8,19,19,51,0
2718,Micky van de Ven,45,30,26,18,1,28,39,71.8,11,42,24,18,26,108,2
2719,Unai Vencedor Paris,3,1,0,3,0,1,6,16.7,5,5,0,5,1,1,0
2720,Lorenzo Venuti,18,7,6,11,1,11,18,61.1,7,7,2,5,5,17,2
2721,Daniele Verde,4,4,3,0,1,3,7,42.9,4,6,0,6,8,4,0
2722,Simone Verdi,15,10,7,5,3,6,17,35.3,11,8,1,7,0,2,0
2723,Gonzalo Verdú,10,5,8,2,0,4,8,50.0,4,8,6,2,10,33,0
2724,Jordan Veretout,56,35,17,32,7,25,53,47.2,28,22,7,15,36,40,2
2725,Marco Verratti,76,49,34,36,6,38,89,42.7,51,42,6,36,27,11,3
2726,Valerio Verre,14,7,6,5,3,8,17,47.1,9,9,1,8,9,3,0
2727,Mikel Vesga,57,35,21,31,5,25,68,36.8,43,39,8,31,36,39,3
2728,Guglielmo Vicario,1,1,1,0,0,1,2,50.0,1,0,0,0,0,15,2
2729,João Victor,19,11,9,7,3,12,22,54.5,10,11,1,10,15,30,0
2730,Aleix Vidal,11,5,6,3,2,4,22,18.2,18,21,2,19,15,14,0
2731,Clément Vidal,25,15,14,11,0,18,38,47.4,20,27,16,11,27,73,1
2732,Nacho Vidal,27,14,16,6,5,17,32,53.1,15,17,4,13,19,33,1
2733,Gabriel Vidovic,0,0,0,0,0,0,0,,0,0,0,0,0,0,0
2734,Fabio Vieira,6,4,3,0,3,3,5,60.0,2,5,0,5,4,2,0
2735,Ronaldo Vieira,1,0,0,1,0,1,1,100.0,0,0,0,0,0,2,0
2736,Ronaldo Vieira,18,10,4,12,2,10,13,76.9,3,15,5,10,13,10,2
2737,Emanuel Vignato,4,4,2,2,0,2,4,50.0,2,2,0,2,3,0,0
2738,Emanuel Vignato,2,0,2,0,0,0,0,,0,0,0,0,0,1,0
2739,Samuele Vignato,0,0,0,0,0,0,0,,0,1,0,1,0,0,0
2740,Tonny Vilhena,44,22,16,23,5,20,50,40.0,30,17,7,10,18,21,0
2741,Toni Villa,6,3,2,3,1,4,9,44.4,5,0,0,0,0,0,0
2742,Toni Villa,25,18,9,11,5,10,23,43.5,13,8,0,8,8,3,0
2743,Asier Villalibre,0,0,0,0,0,0,0,,0,0,0,0,0,1,0
2744,Gonzalo Villar,13,7,4,8,1,7,15,46.7,8,11,3,8,4,9,1
2745,Gonzalo Villar,10,5,1,6,3,6,14,42.9,8,9,2,7,6,5,0
2746,Iván Villar,0,0,0,0,0,0,1,0.0,1,0,0,0,0,7,0
2747,Matías Viña,19,11,9,8,2,14,30,46.7,16,13,1,12,4,22,0
2748,Matías Viña,3,1,1,1,1,1,3,33.3,2,5,1,4,2,5,0
2749,Rúben Vinagre,2,2,1,1,0,1,2,50.0,1,0,0,0,0,1,0
2750,Carlos Vinícius,4,1,0,2,2,0,4,0.0,4,7,0,7,0,10,0
2751,Alan Virginius,3,2,1,1,1,0,4,0.0,4,0,0,0,2,1,0
2752,Mattia Viti,4,2,1,1,2,2,5,40.0,3,9,3,6,8,22,0
2753,Vitinha,15,7,0,6,9,3,11,27.3,8,3,0,3,2,6,0
2754,Vitinha,58,25,21,27,10,27,83,32.5,56,27,4,23,25,15,0
2755,Daniel Vivian,57,32,36,16,5,36,45,80.0,9,27,14,13,24,90,3
2756,Dušan Vlahović,11,6,0,7,4,4,10,40.0,6,10,3,7,3,8,1
2757,Nikola Vlašić,32,21,9,16,7,15,34,44.1,19,25,2,23,10,14,0
2758,Joel Voelkerling Persson,1,1,0,0,1,0,1,0.0,1,1,0,1,0,0,0
2759,Kevin Vogt,15,10,10,5,0,9,22,40.9,13,18,11,7,26,67,0
2760,Mërgim Vojvoda,22,12,15,6,1,12,24,50.0,12,14,2,12,10,31,1
2761,Kevin Volland,8,4,1,5,2,2,8,25.0,6,8,0,8,2,0,0
2762,Cristian Volpato,3,2,1,1,1,0,2,0.0,2,2,0,2,2,0,0
2763,Lukáš Vorlický,0,0,0,0,0,0,0,,0,0,0,0,1,0,0
2764,Aster Vranckx,3,2,0,2,1,2,7,28.6,5,3,1,2,2,1,0
2765,Aster Vranckx,0,0,0,0,0,0,0,,0,0,0,0,0,1,0
2766,Stefan de Vrij,28,18,19,9,0,8,14,57.1,6,18,10,8,40,80,0
2767,Robert Wagner,0,0,0,0,0,0,0,,0,2,0,2,0,2,0
2768,Elye Wahi,9,3,2,3,4,5,14,35.7,9,14,2,12,3,5,0
2769,Walace,82,39,42,31,9,41,90,45.6,49,47,12,35,51,51,1
2770,Theo Walcott,13,6,8,4,1,8,27,29.6,19,8,1,7,9,7,0
2771,Luca Waldschmidt,5,2,2,1,2,2,10,20.0,8,6,0,6,3,5,0
2772,Kyle Walker,13,9,8,5,0,4,24,16.7,20,12,2,10,18,22,0
2773,Kyle Walker-Peters,61,32,34,24,3,22,43,51.2,21,47,8,39,27,52,0
2774,Sebastian Walukiewicz,9,6,7,2,0,4,6,66.7,2,10,9,1,7,30,0
2775,Aaron Wan-Bissaka,40,25,20,17,3,23,25,92.0,2,24,8,16,22,41,0
2776,Paul Wanner,3,1,1,2,0,1,1,100.0,0,0,0,0,0,1,0
2777,Danny Ward,1,1,1,0,0,1,3,33.3,2,0,0,0,0,14,2
2778,Joel Ward,50,36,30,11,9,30,41,73.2,11,32,16,16,25,80,1
2779,James Ward-Prowse,65,37,31,27,7,21,61,34.4,40,30,10,20,55,48,0
2780,Ollie Watkins,19,13,3,13,3,10,27,37.0,17,21,4,17,10,39,0
2781,Timothy Weah,24,14,13,9,2,16,29,55.2,13,17,3,14,23,18,0
2782,Adam Webster,22,12,10,9,3,11,19,57.9,8,30,19,11,19,55,4
2783,Wout Weghorst,11,5,6,1,4,2,9,22.2,7,7,2,5,7,9,0
2784,Julian Weigl,43,16,21,21,1,23,41,56.1,18,23,2,21,18,32,0
2785,Nelson Weiper,2,0,0,0,2,1,3,33.3,2,2,0,2,0,1,0
2786,Mitchell Weiser,71,43,38,24,9,38,75,50.7,37,50,7,43,28,38,1
2787,Noah Weißhaupt,11,6,3,7,1,2,7,28.6,5,4,0,4,6,8,0
2788,Shon Weissman,2,1,1,1,0,0,4,0.0,4,8,0,8,1,7,0
2789,Danny Welbeck,15,7,0,7,8,4,11,36.4,7,24,2,22,5,20,0
2790,Marcel Wenig,0,0,0,0,0,0,0,,0,0,0,0,0,0,0
2791,Axel Werner,0,0,0,0,0,0,1,0.0,1,0,0,0,0,0,0
2792,Timo Werner,10,5,4,3,3,4,12,33.3,8,12,0,12,7,5,0
2793,Ben White,60,31,23,30,7,42,70,60.0,28,47,11,36,22,79,1
2794,Harvey White,0,0,0,0,0,0,1,0.0,1,0,0,0,0,0,0
2795,Joseph Whitworth,0,0,0,0,0,0,0,,0,0,0,0,0,1,0
2796,Silvan Widmer,26,17,15,10,1,20,39,51.3,19,22,8,14,31,28,0
2797,Mateusz Wieteska,41,23,28,13,0,19,33,57.6,14,44,28,16,56,97,4
2798,Georginio Wijnaldum,4,3,1,3,0,0,2,0.0,2,7,1,6,2,3,0
2799,Iñaki Williams,22,16,5,14,3,9,24,37.5,15,18,3,15,7,34,0
2800,Neco Williams,72,47,49,17,6,38,71,53.5,33,33,8,25,33,48,0
2801,Nico Williams,31,16,10,15,6,19,41,46.3,22,40,2,38,8,14,1
2802,Willian,13,8,8,3,2,7,25,28.0,18,13,0,13,9,9,0
2803,Joe Willock,51,30,13,26,12,25,58,43.1,33,54,8,46,25,17,0
2804,Callum Wilson,9,3,0,8,1,0,3,0.0,3,8,0,8,1,5,0
2805,Harry Wilson,21,13,9,9,3,8,18,44.4,10,17,2,15,6,14,0
2806,Patrick Wimmer,39,26,18,11,10,12,38,31.6,26,27,2,25,15,15,0
2807,Jonas Wind,14,6,2,7,5,5,10,50.0,5,14,4,10,1,10,0
2808,Harry Winks,27,12,7,18,2,14,43,32.6,29,14,8,6,24,24,0
2809,Frederik Winther,2,2,1,1,0,0,2,0.0,2,1,1,0,0,7,0
2810,Florian Wirtz,18,10,9,7,2,8,16,50.0,8,15,1,14,1,6,0
2811,Przemysław Wiśniewski,13,6,7,6,0,6,18,33.3,12,16,8,8,11,66,0
2812,Yoane Wissa,17,12,4,7,6,6,13,46.2,7,10,0,10,6,15,0
2813,Axel Witsel,36,22,22,11,3,17,31,54.8,14,20,11,9,23,76,0
2814,Maximilian Wöber,25,18,9,15,1,16,24,66.7,8,32,14,18,27,67,1
2815,Hannes Wolf,11,8,4,5,2,5,13,38.5,8,3,0,3,3,9,0
2816,Marius Wolf,25,18,9,12,4,16,29,55.2,13,40,10,30,18,22,1
2817,Jeong Woo-yeong,7,3,4,2,1,2,5,40.0,3,7,1,6,1,7,0
2818,Chris Wood,5,4,0,3,2,3,5,60.0,2,2,2,0,1,7,0
2819,Chris Wood,0,0,0,0,0,0,1,0.0,1,2,1,1,1,2,0
2820,Christopher Wooh,16,7,8,8,0,9,11,81.8,2,11,5,6,6,49,0
2821,Christopher Wooh,0,0,0,0,0,0,1,0.0,1,0,0,0,0,1,0
2822,Joe Worrall,53,25,39,12,2,25,35,71.4,10,33,23,10,26,111,1
2823,Xeka,10,3,6,3,1,7,16,43.8,9,11,2,9,6,8,0
2824,Granit Xhaka,34,27,11,18,5,16,41,39.0,25,28,10,18,15,45,1
2825,Lamine Yamal,0,0,0,0,0,0,0,,0,0,0,0,0,0,0
2826,Jawad El Yamiq,17,11,10,7,0,6,11,54.5,5,27,19,8,37,101,0
2827,Ryan Yates,38,19,19,16,3,14,22,63.6,8,26,8,18,10,44,0
2828,Yusuf Yazıcı,0,0,0,0,0,0,0,,0,2,0,2,0,1,0
2829,Kelvin Yeboah,6,4,2,4,0,2,5,40.0,3,7,0,7,1,2,0
2830,Gerard Yepes,5,3,2,3,0,1,3,33.3,2,3,0,3,4,3,0
2831,Darlin Yongwa,13,11,7,5,1,4,15,26.7,11,13,1,12,5,11,0
2832,Leny Yoro,11,5,8,3,0,4,9,44.4,5,6,1,5,18,27,1
2833,Maya Yoshida,34,22,19,13,2,18,29,62.1,11,40,29,11,46,132,2
2834,Ashley Young,50,27,34,15,1,37,50,74.0,13,25,11,14,21,65,0
2835,Mohamed Youssouf,72,44,41,24,7,38,61,62.3,23,32,8,24,65,70,0
2836,Illia Zabarnyi,4,2,4,0,0,3,7,42.9,4,7,2,5,3,14,0
2837,Mattia Zaccagni,42,28,16,18,8,14,38,36.8,24,37,3,34,21,10,1
2838,Dan-Axel Zagadou,14,9,10,4,0,5,14,35.7,9,19,16,3,21,81,1
2839,Wilfried Zaha,32,20,12,12,8,8,21,38.1,13,21,1,20,16,9,0
2840,Warren Zaïre-Emery,17,10,5,10,2,8,29,27.6,21,11,0,11,12,17,0
2841,Denis Zakaria,9,5,5,2,2,2,8,25.0,6,4,1,3,3,10,0
2842,Denis Zakaria,6,3,1,4,1,2,2,100.0,0,2,0,2,2,1,0
2843,Rodrigo Zalazar,16,8,5,9,2,9,24,37.5,15,16,1,15,7,13,0
2844,Joseba Zaldúa,15,8,10,4,1,7,10,70.0,3,4,2,2,11,22,0
2845,Nicola Zalewski,45,26,25,15,5,22,71,31.0,49,27,1,26,31,23,0
2846,Andre-Frank Zambo Anguissa,53,32,16,29,8,16,64,25.0,48,50,4,46,49,25,0
2847,Oliver Zandén,2,1,1,0,1,2,5,40.0,3,0,0,0,1,7,0
2848,Luca Zanimacchia,21,13,11,6,4,8,21,38.1,13,9,0,9,9,5,0
2849,Nicolò Zaniolo,7,5,2,4,1,2,7,28.6,5,11,0,11,2,0,0
2850,Alessandro Zanoli,22,14,14,6,2,8,17,47.1,9,19,15,4,12,39,0
2851,Alessandro Zanoli,1,0,0,1,0,0,0,,0,0,0,0,0,1,0
2852,Mattia Zanotti,0,0,0,0,0,0,1,0.0,1,2,0,2,0,0,0
2853,Duván Zapata,8,4,1,3,4,3,5,60.0,2,6,2,4,4,17,1
2854,Davide Zappacosta,34,18,17,12,5,15,22,68.2,7,23,2,21,9,16,0
2855,Oier Zarraga,14,9,5,7,2,8,20,40.0,12,7,0,7,10,5,0
2856,Akim Zedadka,35,21,21,10,4,18,32,56.3,14,17,3,14,23,51,1
2857,Akim Zedadka,1,1,1,0,0,0,2,0.0,2,3,0,3,2,6,0
2858,Karim Zedadka,0,0,0,0,0,0,0,,0,0,0,0,0,1,0
2859,Deyovaisio Zeefuik,1,1,0,1,0,0,0,,0,0,0,0,0,0,0
2860,Marvin Zeegelaar,8,4,6,2,0,3,4,75.0,1,2,0,2,3,5,0
2861,Mehdi Zeffane,12,7,5,7,0,4,21,19.0,17,14,6,8,22,12,0
2862,Aaron Zehnter,0,0,0,0,0,0,1,0.0,1,0,0,0,1,0,0
2863,Jordan Zemura,39,24,24,14,1,23,44,52.3,21,31,9,22,16,32,0
2864,Arber Zeneli,9,3,3,3,3,5,12,41.7,7,8,0,8,2,2,0
2865,Robin Zentner,0,0,0,0,0,0,4,0.0,4,0,0,0,0,17,1
2866,Alessio Zerbin,10,5,4,5,1,4,8,50.0,4,2,0,2,2,2,0
2867,Michael Zetterer,0,0,0,0,0,0,0,,0,0,0,0,0,1,0
2868,Nathan Zeze,3,2,2,1,0,1,1,100.0,0,0,0,0,0,1,0
2869,Edon Zhegrova,18,12,6,7,5,12,20,60.0,8,9,0,9,2,2,0
2870,Piotr Zieliński,17,10,1,11,5,12,25,48.0,13,16,5,11,14,7,0
2871,David Zima,9,5,5,4,0,3,4,75.0,1,7,2,5,9,11,2
2872,Oleksandr Zinchenko,40,18,14,17,9,21,40,52.5,19,20,2,18,22,38,2
2873,Joshua Zirkzee,4,2,1,1,2,2,7,28.6,5,4,1,3,4,4,0
2874,Hakim Ziyech,20,12,12,5,3,4,9,44.4,5,8,0,8,5,5,1
2875,Jeroen Zoet,1,1,1,0,0,1,1,100.0,0,0,0,0,0,1,0
2876,Simon Zoller,11,4,2,8,1,4,12,33.3,8,14,1,13,6,21,0
2877,Nadir Zortea,10,5,3,7,0,3,4,75.0,1,4,0,4,0,4,0
2878,Nadir Zortea,15,8,12,2,1,9,14,64.3,5,10,4,6,4,21,0
2879,Tanguy Zoukrou,14,7,8,6,0,10,14,71.4,4,18,11,7,2,24,0
2880,Kurt Zouma,9,4,4,5,0,5,8,62.5,3,17,14,3,30,120,1
2881,Petar Zovko,1,0,1,0,0,1,1,100.0,0,0,0,0,0,0,0
2882,Igor Zubeldia,35,18,28,7,0,25,35,71.4,10,23,17,6,21,93,0
2883,Martín Zubimendi,59,33,23,30,6,24,45,53.3,21,44,17,27,37,55,4
2884,Szymon Żurkowski,0,0,0,0,0,0,0,,0,0,0,0,0,0,0
2885,Szymon Żurkowski,9,3,4,4,1,2,15,13.3,13,9,2,7,4,6,0
2886,Martin Ødegaard,36,23,12,14,10,14,47,29.8,33,20,5,15,6,12,1
2887,Milan Đurić,2,1,1,0,1,1,3,33.3,2,7,4,3,1,24,0
2888,Filip Đuričić,43,22,18,20,5,14,32,43.8,18,19,6,13,7,8,0
